-42.1005,-20.77017,61,33,0,-28
-42.0978,-20.77017,65,27,5,-38
-42.09511,-20.77017,65,27,5,-38
-42.09219,-20.77017,66,30,5,-36
-42.08949,-20.77017,61,30,5,-31
-42.08657,-20.77017,56,35,0,-21
-42.08387,-20.77017,59,28,5,-31
-42.08118,-20.77017,61,31,5,-30
-42.07825,-20.77017,64,34,5,-30
-42.07556,-20.77017,69,39,5,-30
-42.07286,-20.77017,60,39,0,-21
-42.06994,-20.77017,56,35,0,-21
-42.06724,-20.77017,56,32,5,-24
-42.06455,-20.77017,56,38,5,-18
-42.06163,-20.77017,55,36,5,-19
-42.05893,-20.77017,63,27,5,-36
-42.05601,-20.77017,57,32,5,-25
-42.05331,-20.77017,60,40,5,-20
-42.05061,-20.77017,60,23,5,-37
-42.04769,-20.77017,53,27,5,-26
-42.045,-20.77017,53,27,5,-26
-42.0423,-20.77017,49,30,5,-19
-42.03938,-20.77017,52,32,5,-20
-42.03668,-20.77017,48,29,5,-19
-42.03399,-20.77017,51,30,5,-21
-42.03106,-20.77017,53,30,5,-23
-42.02837,-20.77017,58,34,0,-24
-42.02545,-20.77017,57,30,5,-27
-42.02275,-20.77017,48,27,5,-21
-42.02005,-20.77017,46,32,0,-14
-42.01713,-20.77017,67,35,0,-32
-42.01444,-20.77017,63,35,0,-28
-42.01174,-20.77017,63,39,5,-24
-42.00882,-20.77017,60,31,5,-29
-42.00612,-20.77017,66,43,5,-23
-42.00342,-20.77017,62,35,5,-27
-42.0005,-20.77017,53,37,5,-16
-41.99781,-20.77017,54,36,5,-18
-41.99511,-20.77017,55,32,5,-23
-41.99219,-20.77017,56,46,5,-10
-41.98949,-20.77017,58,28,0,-30
-41.98657,-20.77017,60,40,0,-20
-41.98387,-20.77017,59,51,0,-8
-41.98118,-20.77017,59,31,0,-28
-41.97826,-20.77017,58,32,0,-26
-41.97556,-20.77017,73,35,0,-38
-41.97286,-20.77017,73,37,0,-36
-41.96994,-20.77017,72,41,0,-31
-42.1005,-20.76996,62,32,0,-30
-42.0978,-20.76996,65,26,5,-39
-42.09511,-20.76996,66,27,5,-39
-42.09219,-20.76996,66,36,5,-30
-42.08949,-20.76996,64,34,5,-30
-42.08657,-20.76996,56,35,0,-21
-42.08387,-20.76996,59,28,5,-31
-42.08118,-20.76996,61,33,5,-28
-42.07825,-20.76996,63,33,5,-30
-42.07556,-20.76996,70,39,5,-31
-42.07286,-20.76996,56,39,0,-17
-42.06994,-20.76996,56,33,5,-23
-42.06724,-20.76996,56,33,5,-23
-42.06455,-20.76996,56,38,5,-18
-42.06163,-20.76996,55,35,5,-20
-42.05893,-20.76996,53,27,5,-26
-42.05601,-20.76996,57,32,5,-25
-42.05331,-20.76996,60,40,5,-20
-42.05061,-20.76996,58,24,11,-34
-42.04769,-20.76996,53,27,5,-26
-42.045,-20.76996,54,26,5,-28
-42.0423,-20.76996,50,30,5,-20
-42.03938,-20.76996,54,32,5,-22
-42.03668,-20.76996,49,29,5,-20
-42.03399,-20.76996,50,30,5,-20
-42.03106,-20.76996,54,31,5,-23
-42.02837,-20.76996,58,33,0,-25
-42.02545,-20.76996,58,31,5,-27
-42.02275,-20.76996,51,28,5,-23
-42.02005,-20.76996,50,32,0,-18
-42.01713,-20.76996,60,35,0,-25
-42.01444,-20.76996,64,34,0,-30
-42.01174,-20.76996,64,39,0,-25
-42.00882,-20.76996,62,31,5,-31
-42.00612,-20.76996,65,43,0,-22
-42.00342,-20.76996,63,34,5,-29
-42.0005,-20.76996,53,34,5,-19
-41.99781,-20.76996,54,32,5,-22
-41.99511,-20.76996,55,34,5,-21
-41.99219,-20.76996,56,46,5,-10
-41.98949,-20.76996,68,28,5,-40
-41.98657,-20.76996,61,41,0,-20
-41.98387,-20.76996,59,51,0,-8
-41.98118,-20.76996,59,31,0,-28
-41.97826,-20.76996,58,32,0,-26
-41.97556,-20.76996,73,35,0,-38
-41.97286,-20.76996,71,37,0,-34
-41.96994,-20.76996,72,40,0,-32
-42.1005,-20.76975,64,32,0,-32
-42.0978,-20.76975,65,26,5,-39
-42.09511,-20.76975,66,28,5,-38
-42.09219,-20.76975,66,35,5,-31
-42.08949,-20.76975,64,32,5,-32
-42.08657,-20.76975,56,34,0,-22
-42.08387,-20.76975,59,28,5,-31
-42.08118,-20.76975,61,33,5,-28
-42.07825,-20.76975,63,32,5,-31
-42.07556,-20.76975,70,37,5,-33
-42.07286,-20.76975,56,39,0,-17
-42.06994,-20.76975,56,30,5,-26
-42.06724,-20.76975,56,32,11,-24
-42.06455,-20.76975,56,38,5,-18
-42.06163,-20.76975,55,33,5,-22
-42.05893,-20.76975,54,28,5,-26
-42.05601,-20.76975,56,32,5,-24
-42.05331,-20.76975,60,40,5,-20
-42.05061,-20.76975,59,23,5,-36
-42.04769,-20.76975,53,27,5,-26
-42.045,-20.76975,54,26,5,-28
-42.0423,-20.76975,50,30,5,-20
-42.03938,-20.76975,55,34,5,-21
-42.03668,-20.76975,49,30,5,-19
-42.03399,-20.76975,49,30,5,-19
-42.03106,-20.76975,54,30,5,-24
-42.02837,-20.76975,58,33,0,-25
-42.02545,-20.76975,59,31,5,-28
-42.02275,-20.76975,53,29,5,-24
-42.02005,-20.76975,52,31,5,-21
-42.01713,-20.76975,61,35,0,-26
-42.01444,-20.76975,64,34,0,-30
-42.01174,-20.76975,66,39,0,-27
-42.00882,-20.76975,64,34,5,-30
-42.00612,-20.76975,65,43,0,-22
-42.00342,-20.76975,63,34,5,-29
-42.0005,-20.76975,53,32,5,-21
-41.99781,-20.76975,54,29,5,-25
-41.99511,-20.76975,55,33,5,-22
-41.99219,-20.76975,56,48,5,-8
-41.98949,-20.76975,66,28,5,-38
-41.98657,-20.76975,63,41,0,-22
-41.98387,-20.76975,59,51,0,-8
-41.98118,-20.76975,59,31,0,-28
-41.97826,-20.76975,58,32,0,-26
-41.97556,-20.76975,73,35,0,-38
-41.97286,-20.76975,69,37,0,-32
-41.96994,-20.76975,72,40,0,-32
-42.1005,-20.76954,67,32,0,-35
-42.0978,-20.76954,66,25,5,-41
-42.09511,-20.76954,66,28,5,-38
-42.09219,-20.76954,68,30,5,-38
-42.08949,-20.76954,61,36,5,-25
-42.08657,-20.76954,56,34,6,-22
-42.08387,-20.76954,59,28,5,-31
-42.08118,-20.76954,61,33,5,-28
-42.07825,-20.76954,63,32,5,-31
-42.07556,-20.76954,68,37,5,-31
-42.07286,-20.76954,56,39,11,-17
-42.06994,-20.76954,58,36,5,-22
-42.06724,-20.76954,58,32,5,-26
-42.06455,-20.76954,56,38,5,-18
-42.06163,-20.76954,55,32,5,-23
-42.05893,-20.76954,58,28,5,-30
-42.05601,-20.76954,58,32,5,-26
-42.05331,-20.76954,61,40,5,-21
-42.05061,-20.76954,64,23,5,-41
-42.04769,-20.76954,54,27,5,-27
-42.045,-20.76954,54,26,5,-28
-42.0423,-20.76954,51,32,5,-19
-42.03938,-20.76954,56,32,5,-24
-42.03668,-20.76954,49,29,5,-20
-42.03399,-20.76954,47,30,5,-17
-42.03106,-20.76954,55,30,5,-25
-42.02837,-20.76954,58,33,0,-25
-42.02545,-20.76954,60,31,5,-29
-42.02275,-20.76954,54,28,5,-26
-42.02005,-20.76954,56,31,5,-25
-42.01713,-20.76954,64,35,0,-29
-42.01444,-20.76954,65,34,0,-31
-42.01174,-20.76954,66,39,0,-27
-42.00882,-20.76954,66,34,5,-32
-42.00612,-20.76954,68,43,0,-25
-42.00342,-20.76954,63,34,5,-29
-42.0005,-20.76954,53,31,5,-22
-41.99781,-20.76954,55,29,5,-26
-41.99511,-20.76954,55,34,5,-21
-41.99219,-20.76954,56,49,0,-7
-41.98949,-20.76954,59,28,5,-31
-41.98657,-20.76954,64,41,0,-23
-41.98387,-20.76954,59,51,0,-8
-41.98118,-20.76954,59,32,0,-27
-41.97826,-20.76954,58,32,0,-26
-41.97556,-20.76954,68,35,0,-33
-41.97286,-20.76954,67,38,0,-29
-41.96994,-20.76954,72,39,0,-33
-42.1005,-20.76912,68,33,0,-35
-42.0978,-20.76912,66,26,5,-40
-42.09511,-20.76912,66,27,5,-39
-42.09219,-20.76912,67,30,5,-37
-42.08949,-20.76912,63,35,5,-28
-42.08657,-20.76912,57,34,6,-23
-42.08387,-20.76912,59,29,5,-30
-42.08118,-20.76912,62,30,5,-32
-42.07825,-20.76912,63,33,5,-30
-42.07556,-20.76912,67,33,5,-34
-42.07286,-20.76912,57,38,0,-19
-42.06994,-20.76912,61,38,5,-23
-42.06724,-20.76912,62,31,5,-31
-42.06455,-20.76912,56,38,5,-18
-42.06163,-20.76912,55,29,5,-26
-42.05893,-20.76912,55,29,5,-26
-42.05601,-20.76912,48,34,5,-14
-42.05331,-20.76912,47,37,5,-10
-42.05061,-20.76912,67,25,5,-42
-42.04769,-20.76912,54,28,5,-26
-42.045,-20.76912,55,27,5,-28
-42.0423,-20.76912,51,33,5,-18
-42.03938,-20.76912,56,32,5,-24
-42.03668,-20.76912,49,31,5,-18
-42.03399,-20.76912,42,31,5,-11
-42.03106,-20.76912,58,31,5,-27
-42.02837,-20.76912,58,33,11,-25
-42.02545,-20.76912,59,32,5,-27
-42.02275,-20.76912,56,29,5,-27
-42.02005,-20.76912,58,32,5,-26
-42.01713,-20.76912,65,34,0,-31
-42.01444,-20.76912,66,33,0,-33
-42.01174,-20.76912,65,38,0,-27
-42.00882,-20.76912,64,33,0,-31
-42.00612,-20.76912,69,42,0,-27
-42.00342,-20.76912,64,34,5,-30
-42.0005,-20.76912,53,33,5,-20
-41.99781,-20.76912,55,28,5,-27
-41.99511,-20.76912,55,35,5,-20
-41.99219,-20.76912,57,49,0,-8
-41.98949,-20.76912,64,29,5,-35
-41.98657,-20.76912,64,41,5,-23
-41.98387,-20.76912,59,51,0,-8
-41.98118,-20.76912,59,31,5,-28
-41.97826,-20.76912,58,31,0,-27
-41.97556,-20.76912,58,35,0,-23
-41.97286,-20.76912,64,38,0,-26
-41.96994,-20.76912,71,39,0,-32
-42.1005,-20.76891,68,33,0,-35
-42.0978,-20.76891,67,26,5,-41
-42.09511,-20.76891,66,28,5,-38
-42.09219,-20.76891,66,30,5,-36
-42.08949,-20.76891,64,35,0,-29
-42.08657,-20.76891,57,34,5,-23
-42.08387,-20.76891,59,29,5,-30
-42.08118,-20.76891,62,30,5,-32
-42.07825,-20.76891,64,33,5,-31
-42.07556,-20.76891,66,32,5,-34
-42.07286,-20.76891,57,38,5,-19
-42.06994,-20.76891,62,38,0,-24
-42.06724,-20.76891,58,35,5,-23
-42.06455,-20.76891,56,38,5,-18
-42.06163,-20.76891,55,29,5,-26
-42.05893,-20.76891,53,29,5,-24
-42.05601,-20.76891,48,40,5,-8
-42.05331,-20.76891,47,34,5,-13
-42.05061,-20.76891,57,25,5,-32
-42.04769,-20.76891,54,28,5,-26
-42.045,-20.76891,55,28,5,-27
-42.0423,-20.76891,52,32,5,-20
-42.03938,-20.76891,56,35,5,-21
-42.03668,-20.76891,49,30,5,-19
-42.03399,-20.76891,43,31,5,-12
-42.03106,-20.76891,54,31,5,-23
-42.02837,-20.76891,58,32,5,-26
-42.02545,-20.76891,59,32,5,-27
-42.02275,-20.76891,56,29,5,-27
-42.02005,-20.76891,56,32,5,-24
-42.01713,-20.76891,66,34,0,-32
-42.01444,-20.76891,67,33,0,-34
-42.01174,-20.76891,65,38,0,-27
-42.00882,-20.76891,63,32,5,-31
-42.00612,-20.76891,66,41,0,-25
-42.00342,-20.76891,66,34,5,-32
-42.0005,-20.76891,53,31,5,-22
-41.99781,-20.76891,55,31,5,-24
-41.99511,-20.76891,55,37,5,-18
-41.99219,-20.76891,57,50,0,-7
-41.98949,-20.76891,65,29,5,-36
-41.98657,-20.76891,64,31,5,-33
-41.98387,-20.76891,59,51,0,-8
-41.98118,-20.76891,59,31,5,-28
-41.97826,-20.76891,58,31,0,-27
-41.97556,-20.76891,58,35,0,-23
-41.97286,-20.76891,67,39,11,-28
-41.96994,-20.76891,71,39,0,-32
-42.1005,-20.76869,69,33,0,-36
-42.0978,-20.76869,68,26,5,-42
-42.09511,-20.76869,67,28,5,-39
-42.09219,-20.76869,66,34,5,-32
-42.08949,-20.76869,61,35,0,-26
-42.08657,-20.76869,57,32,5,-25
-42.08387,-20.76869,59,31,5,-28
-42.08118,-20.76869,62,30,5,-32
-42.07825,-20.76869,64,35,5,-29
-42.07556,-20.76869,64,32,5,-32
-42.07286,-20.76869,60,38,5,-22
-42.06994,-20.76869,63,38,11,-25
-42.06724,-20.76869,56,35,5,-21
-42.06455,-20.76869,56,38,5,-18
-42.06163,-20.76869,55,29,5,-26
-42.05893,-20.76869,54,30,5,-24
-42.05601,-20.76869,48,40,5,-8
-42.05331,-20.76869,47,34,5,-13
-42.05061,-20.76869,56,25,5,-31
-42.04769,-20.76869,57,28,5,-29
-42.045,-20.76869,56,27,5,-29
-42.0423,-20.76869,53,33,5,-20
-42.03938,-20.76869,57,34,5,-23
-42.03668,-20.76869,49,31,5,-18
-42.03399,-20.76869,43,31,5,-12
-42.03106,-20.76869,54,31,5,-23
-42.02837,-20.76869,58,31,5,-27
-42.02545,-20.76869,59,32,5,-27
-42.02275,-20.76869,57,30,5,-27
-42.02005,-20.76869,46,32,5,-14
-42.01713,-20.76869,62,34,0,-28
-42.01444,-20.76869,69,33,0,-36
-42.01174,-20.76869,66,35,5,-31
-42.00882,-20.76869,61,31,5,-30
-42.00612,-20.76869,63,40,0,-23
-42.00342,-20.76869,66,34,5,-32
-42.0005,-20.76869,53,32,5,-21
-41.99781,-20.76869,55,30,5,-25
-41.99511,-20.76869,55,37,5,-18
-41.99219,-20.76869,58,50,0,-8
-41.98949,-20.76869,67,29,5,-38
-41.98657,-20.76869,64,31,5,-33
-41.98387,-20.76869,59,50,0,-9
-41.98118,-20.76869,59,31,5,-28
-41.97826,-20.76869,58,31,0,-27
-41.97556,-20.76869,58,35,0,-23
-41.97286,-20.76869,69,39,11,-30
-41.96994,-20.76869,69,38,0,-31
-42.1005,-20.76827,69,33,0,-36
-42.0978,-20.76827,69,26,5,-43
-42.09511,-20.76827,68,27,5,-41
-42.09219,-20.76827,67,36,5,-31
-42.08949,-20.76827,57,35,0,-22
-42.08657,-20.76827,57,31,5,-26
-42.08387,-20.76827,59,34,0,-25
-42.08118,-20.76827,62,30,5,-32
-42.07825,-20.76827,64,34,5,-30
-42.07556,-20.76827,63,39,5,-24
-42.07286,-20.76827,61,38,5,-23
-42.06994,-20.76827,65,34,5,-31
-42.06724,-20.76827,56,34,5,-22
-42.06455,-20.76827,56,37,5,-19
-42.06163,-20.76827,55,29,5,-26
-42.05893,-20.76827,54,32,5,-22
-42.05601,-20.76827,48,40,0,-8
-42.05331,-20.76827,47,33,0,-14
-42.05061,-20.76827,52,26,5,-26
-42.04769,-20.76827,58,27,5,-31
-42.045,-20.76827,56,29,5,-27
-42.0423,-20.76827,56,33,5,-23
-42.03938,-20.76827,60,34,5,-26
-42.03668,-20.76827,49,32,5,-17
-42.03399,-20.76827,44,31,5,-13
-42.03106,-20.76827,55,31,5,-24
-42.02837,-20.76827,58,31,5,-27
-42.02545,-20.76827,61,31,5,-30
-42.02275,-20.76827,57,31,5,-26
-42.02005,-20.76827,49,32,5,-17
-42.01713,-20.76827,62,34,0,-28
-42.01444,-20.76827,70,29,5,-41
-42.01174,-20.76827,64,33,5,-31
-42.00882,-20.76827,50,32,5,-18
-42.00612,-20.76827,51,38,0,-13
-42.00342,-20.76827,65,34,5,-31
-42.0005,-20.76827,54,35,5,-19
-41.99781,-20.76827,55,31,5,-24
-41.99511,-20.76827,58,38,5,-20
-41.99219,-20.76827,58,50,0,-8
-41.98949,-20.76827,70,34,0,-36
-41.98657,-20.76827,63,32,5,-31
-41.98387,-20.76827,59,49,0,-10
-41.98118,-20.76827,59,50,5,-9
-41.97826,-20.76827,58,33,0,-25
-41.97556,-20.76827,58,33,5,-25
-41.97286,-20.76827,58,39,11,-19
-41.96994,-20.76827,58,38,0,-20
-42.1005,-20.76806,69,33,0,-36
-42.0978,-20.76806,69,25,5,-44
-42.09511,-20.76806,68,26,5,-42
-42.09219,-20.76806,67,36,5,-31
-42.08949,-20.76806,58,35,0,-23
-42.08657,-20.76806,57,30,5,-27
-42.08387,-20.76806,59,32,5,-27
-42.08118,-20.76806,62,29,5,-33
-42.07825,-20.76806,64,33,5,-31
-42.07556,-20.76806,62,39,0,-23
-42.07286,-20.76806,63,37,5,-26
-42.06994,-20.76806,65,30,5,-35
-42.06724,-20.76806,59,33,5,-26
-42.06455,-20.76806,56,36,5,-20
-42.06163,-20.76806,55,29,5,-26
-42.05893,-20.76806,54,32,5,-22
-42.05601,-20.76806,49,40,0,-9
-42.05331,-20.76806,48,33,0,-15
-42.05061,-20.76806,54,27,5,-27
-42.04769,-20.76806,57,27,5,-30
-42.045,-20.76806,56,29,5,-27
-42.0423,-20.76806,54,33,5,-21
-42.03938,-20.76806,58,34,5,-24
-42.03668,-20.76806,51,31,5,-20
-42.03399,-20.76806,44,31,5,-13
-42.03106,-20.76806,55,31,5,-24
-42.02837,-20.76806,58,31,5,-27
-42.02545,-20.76806,63,31,5,-32
-42.02275,-20.76806,56,31,5,-25
-42.02005,-20.76806,45,32,5,-13
-42.01713,-20.76806,62,34,5,-28
-42.01444,-20.76806,71,28,5,-43
-42.01174,-20.76806,63,33,5,-30
-42.00882,-20.76806,50,31,5,-19
-42.00612,-20.76806,51,37,5,-14
-42.00342,-20.76806,62,34,5,-28
-42.0005,-20.76806,54,32,5,-22
-41.99781,-20.76806,55,32,5,-23
-41.99511,-20.76806,61,38,5,-23
-41.99219,-20.76806,58,50,0,-8
-41.98949,-20.76806,72,51,0,-21
-41.98657,-20.76806,63,34,5,-29
-41.98387,-20.76806,59,49,0,-10
-41.98118,-20.76806,59,50,5,-9
-41.97826,-20.76806,58,33,0,-25
-41.97556,-20.76806,58,32,5,-26
-41.97286,-20.76806,58,39,0,-19
-41.96994,-20.76806,58,38,0,-20
-42.10297,-20.76785,66,32,0,-34
-42.10275,-20.76785,66,32,0,-34
-42.10252,-20.76785,67,33,0,-34
-42.1023,-20.76785,68,33,0,-35
-42.10185,-20.76785,68,32,0,-36
-42.10163,-20.76785,69,32,0,-37
-42.1014,-20.76785,69,32,0,-37
-42.10118,-20.76785,70,32,0,-38
-42.10073,-20.76785,70,32,0,-38
-42.1005,-20.76785,70,31,0,-39
-42.10028,-20.76785,70,33,0,-37
-42.10005,-20.76785,70,33,0,-37
-42.09983,-20.76785,69,33,0,-36
-42.09938,-20.76785,69,33,0,-36
-42.09915,-20.76785,69,33,0,-36
-42.09893,-20.76785,69,33,0,-36
-42.0987,-20.76785,69,33,0,-36
-42.09825,-20.76785,69,26,5,-43
-42.09803,-20.76785,69,26,5,-43
-42.0978,-20.76785,69,27,5,-42
-42.09758,-20.76785,69,28,5,-41
-42.09713,-20.76785,70,33,5,-37
-42.09691,-20.76785,70,31,5,-39
-42.09668,-20.76785,70,28,5,-42
-42.09646,-20.76785,70,33,5,-37
-42.09601,-20.76785,70,25,5,-45
-42.09578,-20.76785,70,25,5,-45
-42.09556,-20.76785,69,26,5,-43
-42.09533,-20.76785,69,26,5,-43
-42.09511,-20.76785,69,26,5,-43
-42.09466,-20.76785,69,26,5,-43
-42.09443,-20.76785,69,27,5,-42
-42.09421,-20.76785,68,27,5,-41
-42.09398,-20.76785,68,27,5,-41
-42.09354,-20.76785,69,30,5,-39
-42.09331,-20.76785,67,29,5,-38
-42.09309,-20.76785,67,33,5,-34
-42.09286,-20.76785,65,36,5,-29
-42.09241,-20.76785,65,36,5,-29
-42.09219,-20.76785,66,36,0,-30
-42.09196,-20.76785,62,36,0,-26
-42.09174,-20.76785,61,36,0,-25
-42.09129,-20.76785,59,36,0,-23
-42.09106,-20.76785,58,36,0,-22
-42.09084,-20.76785,60,36,5,-24
-42.09061,-20.76785,60,36,5,-24
-42.09039,-20.76785,60,36,5,-24
-42.08994,-20.76785,58,35,5,-23
-42.08972,-20.76785,58,35,5,-23
-42.08949,-20.76785,58,35,5,-23
-42.08927,-20.76785,57,35,5,-22
-42.08882,-20.76785,58,35,5,-23
-42.08859,-20.76785,57,34,5,-23
-42.08837,-20.76785,56,34,5,-22
-42.08814,-20.76785,56,34,5,-22
-42.08769,-20.76785,56,34,0,-22
-42.08747,-20.76785,56,34,0,-22
-42.08724,-20.76785,57,34,0,-23
-42.08702,-20.76785,57,34,0,-23
-42.08657,-20.76785,57,30,5,-27
-42.08634,-20.76785,58,30,5,-28
-42.08612,-20.76785,58,30,5,-28
-42.08589,-20.76785,59,30,5,-29
-42.08545,-20.76785,58,28,5,-30
-42.08522,-20.76785,59,29,5,-30
-42.085,-20.76785,59,29,5,-30
-42.08477,-20.76785,59,29,5,-30
-42.08455,-20.76785,59,29,5,-30
-42.0841,-20.76785,59,29,5,-30
-42.08387,-20.76785,59,30,5,-29
-42.08365,-20.76785,60,30,5,-30
-42.08342,-20.76785,60,33,5,-27
-42.08297,-20.76785,60,33,5,-27
-42.08275,-20.76785,61,32,0,-29
-42.08252,-20.76785,61,32,5,-29
-42.0823,-20.76785,61,31,5,-30
-42.08185,-20.76785,62,31,5,-31
-42.08163,-20.76785,62,30,5,-32
-42.0814,-20.76785,62,29,5,-33
-42.08118,-20.76785,62,30,5,-32
-42.08073,-20.76785,63,30,5,-33
-42.0805,-20.76785,63,29,5,-34
-42.08028,-20.76785,63,29,5,-34
-42.08005,-20.76785,64,30,5,-34
-42.07983,-20.76785,64,30,5,-34
-42.07938,-20.76785,64,31,5,-33
-42.07915,-20.76785,64,31,5,-33
-42.07893,-20.76785,64,31,5,-33
-42.0787,-20.76785,64,31,5,-33
-42.07825,-20.76785,64,33,5,-31
-42.07803,-20.76785,64,33,5,-31
-42.07781,-20.76785,64,33,5,-31
-42.07758,-20.76785,64,31,5,-33
-42.07713,-20.76785,64,31,5,-33
-42.07691,-20.76785,64,32,5,-32
-42.07668,-20.76785,64,32,5,-32
-42.07646,-20.76785,64,32,5,-32
-42.07601,-20.76785,64,39,5,-25
-42.07578,-20.76785,63,39,0,-24
-42.07556,-20.76785,63,39,0,-24
-42.07533,-20.76785,62,39,0,-23
-42.07511,-20.76785,62,39,0,-23
-42.07466,-20.76785,62,39,0,-23
-42.07443,-20.76785,62,39,0,-23
-42.07421,-20.76785,62,39,0,-23
-42.07399,-20.76785,62,39,0,-23
-42.07354,-20.76785,63,40,0,-23
-42.07331,-20.76785,64,40,0,-24
-42.07309,-20.76785,64,39,0,-25
-42.07286,-20.76785,64,38,5,-26
-42.07241,-20.76785,64,38,5,-26
-42.07219,-20.76785,64,37,5,-27
-42.07196,-20.76785,65,37,5,-28
-42.07174,-20.76785,65,36,5,-29
-42.07129,-20.76785,65,34,5,-31
-42.07106,-20.76785,65,33,0,-32
-42.07084,-20.76785,65,32,5,-33
-42.07061,-20.76785,65,31,5,-34
-42.07039,-20.76785,66,30,5,-36
-42.06994,-20.76785,64,29,5,-35
-42.06972,-20.76785,66,30,5,-36
-42.06949,-20.76785,65,30,5,-35
-42.06927,-20.76785,62,30,5,-32
-42.06882,-20.76785,60,30,5,-30
-42.06859,-20.76785,61,32,5,-29
-42.06837,-20.76785,63,32,5,-31
-42.06814,-20.76785,56,32,11,-24
-42.06769,-20.76785,61,32,5,-29
-42.06747,-20.76785,56,33,5,-23
-42.06724,-20.76785,56,36,5,-20
-42.06702,-20.76785,58,37,5,-21
-42.06657,-20.76785,56,38,5,-18
-42.06634,-20.76785,56,38,5,-18
-42.06612,-20.76785,56,38,5,-18
-42.0659,-20.76785,56,38,5,-18
-42.06545,-20.76785,56,37,5,-19
-42.06522,-20.76785,56,37,5,-19
-42.065,-20.76785,56,36,5,-20
-42.06477,-20.76785,56,36,5,-20
-42.06455,-20.76785,56,35,5,-21
-42.0641,-20.76785,56,34,5,-22
-42.06387,-20.76785,56,33,5,-23
-42.06365,-20.76785,56,31,5,-25
-42.06342,-20.76785,56,29,5,-27
-42.06297,-20.76785,56,27,5,-29
-42.06275,-20.76785,56,28,5,-28
-42.06252,-20.76785,56,28,5,-28
-42.0623,-20.76785,56,29,5,-27
-42.06185,-20.76785,56,29,5,-27
-42.06163,-20.76785,55,30,5,-25
-42.0614,-20.76785,55,30,5,-25
-42.06118,-20.76785,55,30,5,-25
-42.06073,-20.76785,55,31,5,-24
-42.0605,-20.76785,55,30,5,-25
-42.06028,-20.76785,55,30,5,-25
-42.06005,-20.76785,54,30,5,-24
-42.05983,-20.76785,54,30,5,-24
-42.05938,-20.76785,54,31,5,-23
-42.05915,-20.76785,54,32,5,-22
-42.05893,-20.76785,54,32,5,-22
-42.0587,-20.76785,54,32,5,-22
-42.05826,-20.76785,54,30,5,-24
-42.05803,-20.76785,56,31,5,-25
-42.05781,-20.76785,53,32,5,-21
-42.05758,-20.76785,53,32,5,-21
-42.05713,-20.76785,51,36,5,-15
-42.05691,-20.76785,51,40,5,-11
-42.05668,-20.76785,51,40,0,-11
-42.05646,-20.76785,49,40,0,-9
-42.05601,-20.76785,49,40,0,-9
-42.05578,-20.76785,49,40,0,-9
-42.05556,-20.76785,49,40,0,-9
-42.05533,-20.76785,49,40,0,-9
-42.05511,-20.76785,48,40,0,-8
-42.05466,-20.76785,48,40,0,-8
-42.05443,-20.76785,48,39,0,-9
-42.05421,-20.76785,48,39,0,-9
-42.05399,-20.76785,49,36,0,-13
-42.05354,-20.76785,48,34,0,-14
-42.05331,-20.76785,49,33,0,-16
-42.05309,-20.76785,48,33,11,-15
-42.05286,-20.76785,48,32,5,-16
-42.05241,-20.76785,48,27,5,-21
-42.05219,-20.76785,46,27,5,-19
-42.05196,-20.76785,46,27,5,-19
-42.05174,-20.76785,46,27,5,-19
-42.05129,-20.76785,47,27,5,-20
-42.05106,-20.76785,45,27,5,-18
-42.05084,-20.76785,43,27,5,-16
-42.05061,-20.76785,46,27,5,-19
-42.05039,-20.76785,52,27,5,-25
-42.04994,-20.76785,53,26,5,-27
-42.04972,-20.76785,54,27,5,-27
-42.04949,-20.76785,56,27,5,-29
-42.04927,-20.76785,50,27,5,-23
-42.04882,-20.76785,55,27,5,-28
-42.04859,-20.76785,49,28,5,-21
-42.04837,-20.76785,51,27,5,-24
-42.04814,-20.76785,54,27,5,-27
-42.04769,-20.76785,54,27,5,-27
-42.04747,-20.76785,54,27,5,-27
-42.04724,-20.76785,55,27,5,-28
-42.04702,-20.76785,56,27,5,-29
-42.04657,-20.76785,56,27,5,-29
-42.04635,-20.76785,56,27,5,-29
-42.04612,-20.76785,56,27,5,-29
-42.0459,-20.76785,56,28,5,-28
-42.04545,-20.76785,56,28,5,-28
-42.04522,-20.76785,56,28,5,-28
-42.045,-20.76785,56,29,5,-27
-42.04477,-20.76785,56,29,5,-27
-42.04455,-20.76785,56,29,5,-27
-42.0441,-20.76785,56,29,5,-27
-42.04387,-20.76785,56,29,5,-27
-42.04365,-20.76785,56,31,5,-25
-42.04342,-20.76785,56,31,5,-25
-42.04297,-20.76785,56,31,5,-25
-42.04275,-20.76785,55,33,5,-22
-42.04253,-20.76785,54,33,5,-21
-42.0423,-20.76785,55,33,5,-22
-42.04185,-20.76785,54,33,5,-21
-42.04163,-20.76785,53,33,5,-20
-42.0414,-20.76785,52,33,5,-19
-42.04118,-20.76785,53,32,5,-21
-42.04073,-20.76785,53,31,5,-22
-42.0405,-20.76785,54,31,5,-23
-42.04028,-20.76785,55,31,5,-24
-42.04005,-20.76785,55,34,5,-21
-42.03983,-20.76785,56,34,11,-22
-42.03938,-20.76785,56,31,5,-25
-42.03915,-20.76785,56,31,5,-25
-42.03893,-20.76785,55,30,5,-25
-42.0387,-20.76785,54,31,5,-23
-42.03826,-20.76785,55,31,5,-24
-42.03803,-20.76785,55,32,5,-23
-42.03781,-20.76785,54,31,5,-23
-42.03758,-20.76785,52,31,5,-21
-42.03713,-20.76785,52,32,5,-20
-42.03691,-20.76785,49,31,5,-18
-42.03668,-20.76785,49,31,5,-18
-42.03646,-20.76785,49,31,5,-18
-42.03601,-20.76785,49,31,5,-18
-42.03578,-20.76785,49,31,5,-18
-42.03556,-20.76785,49,31,5,-18
-42.03533,-20.76785,48,32,5,-16
-42.03511,-20.76785,48,31,5,-17
-42.03466,-20.76785,48,31,5,-17
-42.03444,-20.76785,46,31,5,-15
-42.03421,-20.76785,46,31,5,-15
-42.03399,-20.76785,46,31,5,-15
-42.03354,-20.76785,46,31,5,-15
-42.03331,-20.76785,48,31,5,-17
-42.03309,-20.76785,48,32,5,-16
-42.03286,-20.76785,47,32,5,-15
-42.03241,-20.76785,47,31,5,-16
-42.03219,-20.76785,48,31,5,-17
-42.03196,-20.76785,50,31,5,-19
-42.03174,-20.76785,52,31,5,-21
-42.03129,-20.76785,54,31,5,-23
-42.03106,-20.76785,56,31,5,-25
-42.03084,-20.76785,58,31,5,-27
-42.03062,-20.76785,58,31,5,-27
-42.03017,-20.76785,59,31,5,-28
-42.02994,-20.76785,58,31,5,-27
-42.02972,-20.76785,58,31,5,-27
-42.02949,-20.76785,57,31,5,-26
-42.02927,-20.76785,57,31,5,-26
-42.02882,-20.76785,58,31,5,-27
-42.02859,-20.76785,58,31,5,-27
-42.02837,-20.76785,58,31,5,-27
-42.02814,-20.76785,59,30,5,-29
-42.02769,-20.76785,59,30,5,-29
-42.02747,-20.76785,59,30,5,-29
-42.02724,-20.76785,59,30,5,-29
-42.02702,-20.76785,59,30,5,-29
-42.02657,-20.76785,60,30,5,-30
-42.02635,-20.76785,60,30,5,-30
-42.02612,-20.76785,60,30,11,-30
-42.0259,-20.76785,60,31,5,-29
-42.02545,-20.76785,59,31,5,-28
-42.02522,-20.76785,59,31,5,-28
-42.025,-20.76785,59,32,5,-27
-42.02477,-20.76785,59,32,5,-27
-42.02455,-20.76785,60,32,5,-28
-42.0241,-20.76785,61,32,5,-29
-42.02387,-20.76785,62,31,5,-31
-42.02365,-20.76785,60,31,5,-29
-42.02342,-20.76785,58,31,5,-27
-42.02297,-20.76785,60,31,5,-29
-42.02275,-20.76785,54,31,5,-23
-42.02253,-20.76785,52,30,5,-22
-42.0223,-20.76785,50,30,5,-20
-42.02185,-20.76785,49,30,5,-19
-42.02163,-20.76785,49,30,5,-19
-42.0214,-20.76785,48,30,5,-18
-42.02118,-20.76785,47,31,5,-16
-42.02073,-20.76785,46,30,5,-16
-42.0205,-20.76785,45,31,5,-14
-42.02028,-20.76785,46,32,5,-14
-42.02005,-20.76785,45,32,5,-13
-42.01983,-20.76785,45,32,5,-13
-42.01938,-20.76785,54,31,5,-23
-42.01915,-20.76785,56,30,5,-26
-42.01893,-20.76785,60,31,5,-29
-42.01871,-20.76785,62,30,5,-32
-42.01826,-20.76785,62,30,5,-32
-42.01803,-20.76785,62,30,5,-32
-42.01781,-20.76785,61,30,5,-31
-42.01758,-20.76785,57,31,5,-26
-42.01713,-20.76785,55,30,5,-25
-42.01691,-20.76785,56,30,5,-26
-42.01668,-20.76785,58,29,5,-29
-42.01646,-20.76785,59,28,5,-31
-42.01601,-20.76785,60,27,5,-33
-42.01578,-20.76785,62,27,5,-35
-42.01556,-20.76785,65,30,5,-35
-42.01533,-20.76785,65,31,0,-34
-42.01511,-20.76785,65,30,5,-35
-42.01466,-20.76785,65,28,5,-37
-42.01444,-20.76785,65,28,5,-37
-42.01421,-20.76785,64,28,5,-36
-42.01399,-20.76785,66,33,5,-33
-42.01354,-20.76785,64,33,5,-31
-42.01331,-20.76785,63,37,0,-26
-42.01309,-20.76785,58,36,0,-22
-42.01286,-20.76785,59,35,0,-24
-42.01241,-20.76785,54,36,0,-18
-42.01219,-20.76785,61,37,0,-24
-42.01196,-20.76785,61,34,5,-27
-42.01174,-20.76785,62,32,5,-30
-42.01129,-20.76785,60,32,5,-28
-42.01106,-20.76785,51,32,5,-19
-42.01084,-20.76785,51,31,5,-20
-42.01062,-20.76785,50,31,5,-19
-42.01017,-20.76785,50,31,5,-19
-42.00994,-20.76785,50,31,5,-19
-42.00972,-20.76785,50,31,5,-19
-42.00949,-20.76785,50,31,5,-19
-42.00927,-20.76785,50,32,5,-18
-42.00882,-20.76785,50,31,5,-19
-42.00859,-20.76785,50,31,5,-19
-42.00837,-20.76785,50,30,5,-20
-42.00814,-20.76785,50,29,5,-21
-42.00769,-20.76785,50,30,5,-20
-42.00747,-20.76785,51,30,5,-21
-42.00724,-20.76785,51,31,5,-20
-42.00702,-20.76785,51,33,5,-18
-42.00657,-20.76785,51,33,5,-18
-42.00635,-20.76785,51,33,5,-18
-42.00612,-20.76785,52,34,5,-18
-42.0059,-20.76785,52,34,5,-18
-42.00545,-20.76785,52,34,5,-18
-42.00522,-20.76785,51,34,5,-17
-42.005,-20.76785,52,34,5,-18
-42.00477,-20.76785,54,34,5,-20
-42.00455,-20.76785,62,35,5,-27
-42.0041,-20.76785,65,35,5,-30
-42.00387,-20.76785,63,35,5,-28
-42.00365,-20.76785,62,34,5,-28
-42.00342,-20.76785,62,37,5,-25
-42.00298,-20.76785,62,37,11,-25
-42.00275,-20.76785,62,36,5,-26
-42.00253,-20.76785,62,33,5,-29
-42.0023,-20.76785,61,35,5,-26
-42.00185,-20.76785,65,38,5,-27
-42.00163,-20.76785,61,36,5,-25
-42.0014,-20.76785,59,38,5,-21
-42.00118,-20.76785,54,38,5,-16
-42.00073,-20.76785,54,44,5,-10
-42.0005,-20.76785,54,41,5,-13
-42.00028,-20.76785,54,40,5,-14
-42.00005,-20.76785,54,36,5,-18
-41.99983,-20.76785,54,36,5,-18
-41.99938,-20.76785,54,39,5,-15
-41.99916,-20.76785,55,39,5,-16
-41.99893,-20.76785,55,39,5,-16
-41.99871,-20.76785,55,40,5,-15
-41.99826,-20.76785,55,35,5,-20
-41.99803,-20.76785,55,33,5,-22
-41.99781,-20.76785,55,33,5,-22
-41.99758,-20.76785,55,32,5,-23
-41.99713,-20.76785,55,32,5,-23
-41.99691,-20.76785,55,31,5,-24
-41.99668,-20.76785,55,33,5,-22
-41.99646,-20.76785,55,33,6,-22
-41.99601,-20.76785,55,32,5,-23
-41.99578,-20.76785,55,31,5,-24
-41.99556,-20.76785,61,36,5,-25
-41.99533,-20.76785,63,36,5,-27
-41.99511,-20.76785,59,36,5,-23
-41.99466,-20.76785,57,40,5,-17
-41.99444,-20.76785,57,41,5,-16
-41.99421,-20.76785,59,41,5,-18
-41.99399,-20.76785,61,41,5,-20
-41.99354,-20.76785,61,45,0,-16
-41.99331,-20.76785,61,46,0,-15
-41.99309,-20.76785,59,48,0,-11
-41.99286,-20.76785,60,48,0,-12
-41.99241,-20.76785,60,49,0,-11
-41.99219,-20.76785,59,50,0,-9
-41.99196,-20.76785,69,51,0,-18
-41.99174,-20.76785,65,51,0,-14
-41.99129,-20.76785,60,52,0,-8
-41.99107,-20.76785,59,52,0,-7
-41.99084,-20.76785,59,52,0,-7
-41.99062,-20.76785,63,52,5,-11
-41.99017,-20.76785,69,51,5,-18
-41.98994,-20.76785,66,51,5,-15
-41.98972,-20.76785,63,51,5,-12
-41.98949,-20.76785,68,51,0,-17
-41.98927,-20.76785,73,51,5,-22
-41.98882,-20.76785,71,34,5,-37
-41.98859,-20.76785,71,38,5,-33
-41.98837,-20.76785,70,38,5,-32
-41.98814,-20.76785,68,36,5,-32
-41.98769,-20.76785,67,36,5,-31
-41.98747,-20.76785,65,35,5,-30
-41.98725,-20.76785,64,33,5,-31
-41.98702,-20.76785,64,32,5,-32
-41.98657,-20.76785,63,39,5,-24
-41.98635,-20.76785,63,48,0,-15
-41.98612,-20.76785,63,50,0,-13
-41.9859,-20.76785,62,50,0,-12
-41.98545,-20.76785,61,50,0,-11
-41.98522,-20.76785,60,50,0,-10
-41.985,-20.76785,60,50,0,-10
-41.98477,-20.76785,60,50,0,-10
-41.98455,-20.76785,60,49,0,-11
-41.9841,-20.76785,59,49,0,-10
-41.98387,-20.76785,60,49,0,-11
-41.98365,-20.76785,59,49,0,-10
-41.98343,-20.76785,59,49,0,-10
-41.98298,-20.76785,59,49,0,-10
-41.98275,-20.76785,59,49,0,-10
-41.98253,-20.76785,59,49,0,-10
-41.9823,-20.76785,59,49,0,-10
-41.98185,-20.76785,59,49,0,-10
-41.98163,-20.76785,59,50,0,-9
-41.9814,-20.76785,59,50,0,-9
-41.98118,-20.76785,59,50,5,-9
-41.98073,-20.76785,59,36,5,-23
-41.9805,-20.76785,59,45,5,-14
-41.98028,-20.76785,58,38,5,-20
-41.98005,-20.76785,58,33,5,-25
-41.97983,-20.76785,58,31,5,-27
-41.97938,-20.76785,58,32,0,-26
-41.97916,-20.76785,58,32,0,-26
-41.97893,-20.76785,58,33,0,-25
-41.97871,-20.76785,58,32,0,-26
-41.97826,-20.76785,58,32,0,-26
-41.97803,-20.76785,58,32,0,-26
-41.97781,-20.76785,58,32,0,-26
-41.97758,-20.76785,58,32,0,-26
-41.97713,-20.76785,58,33,0,-25
-41.97691,-20.76785,69,35,0,-34
-41.97668,-20.76785,70,35,0,-35
-41.97646,-20.76785,74,35,0,-39
-41.97601,-20.76785,72,35,5,-37
-41.97578,-20.76785,58,35,5,-23
-41.97556,-20.76785,58,35,5,-23
-41.97534,-20.76785,63,34,5,-29
-41.97511,-20.76785,58,34,5,-24
-41.97466,-20.76785,58,37,0,-21
-41.97444,-20.76785,58,37,0,-21
-41.97421,-20.76785,58,37,0,-21
-41.97399,-20.76785,58,37,0,-21
-41.97354,-20.76785,67,38,0,-29
-41.97331,-20.76785,67,39,11,-28
-41.97309,-20.76785,60,39,0,-21
-41.97286,-20.76785,66,39,0,-27
-41.97241,-20.76785,69,40,0,-29
-41.97219,-20.76785,70,36,0,-34
-41.97196,-20.76785,71,39,0,-32
-41.97174,-20.76785,74,40,0,-34
-41.97129,-20.76785,71,35,0,-36
-41.97107,-20.76785,71,36,0,-35
-41.97084,-20.76785,67,35,0,-32
-41.97062,-20.76785,66,35,0,-31
-41.97017,-20.76785,67,36,5,-31
-41.96994,-20.76785,58,37,5,-21
-41.96972,-20.76785,58,36,5,-22
-41.96949,-20.76785,58,34,5,-24
-41.96927,-20.76785,58,37,0,-21
-42.1005,-20.76743,70,32,0,-38
-42.0978,-20.76743,69,33,0,-36
-42.09511,-20.76743,68,26,5,-42
-42.09219,-20.76743,64,36,0,-28
-42.08949,-20.76743,58,31,5,-27
-42.08657,-20.76743,59,31,5,-28
-42.08387,-20.76743,60,29,5,-31
-42.08118,-20.76743,62,30,5,-32
-42.07825,-20.76743,64,33,5,-31
-42.07556,-20.76743,63,39,0,-24
-42.07286,-20.76743,64,39,5,-25
-42.06994,-20.76743,65,30,5,-35
-42.06724,-20.76743,56,36,5,-20
-42.06455,-20.76743,56,32,5,-24
-42.06163,-20.76743,56,30,5,-26
-42.05893,-20.76743,54,32,5,-22
-42.05601,-20.76743,49,40,0,-9
-42.05331,-20.76743,49,33,5,-16
-42.05061,-20.76743,44,27,5,-17
-42.04769,-20.76743,57,27,5,-30
-42.045,-20.76743,56,29,5,-27
-42.0423,-20.76743,56,34,5,-22
-42.03938,-20.76743,55,32,5,-23
-42.03668,-20.76743,48,33,5,-15
-42.03399,-20.76743,48,32,5,-16
-42.03106,-20.76743,57,31,5,-26
-42.02837,-20.76743,57,30,5,-27
-42.02545,-20.76743,60,32,5,-28
-42.02275,-20.76743,52,31,5,-21
-42.02005,-20.76743,46,31,5,-15
-42.01713,-20.76743,56,29,5,-27
-42.01444,-20.76743,60,28,5,-32
-42.01174,-20.76743,60,34,5,-26
-42.00882,-20.76743,50,33,5,-17
-42.00612,-20.76743,52,34,5,-18
-42.00342,-20.76743,64,38,11,-26
-42.0005,-20.76743,54,45,0,-9
-41.99781,-20.76743,55,33,5,-22
-41.99511,-20.76743,57,33,5,-24
-41.99219,-20.76743,60,49,0,-11
-41.98949,-20.76743,68,51,0,-17
-41.98657,-20.76743,64,50,5,-14
-41.98387,-20.76743,60,47,0,-13
-41.98118,-20.76743,59,49,5,-10
-41.97826,-20.76743,58,32,0,-26
-41.97556,-20.76743,58,36,0,-22
-41.97286,-20.76743,58,41,0,-17
-41.96994,-20.76743,61,34,5,-27
-42.1005,-20.76722,72,32,0,-40
-42.0978,-20.76722,70,33,0,-37
-42.09511,-20.76722,69,28,5,-41
-42.09219,-20.76722,64,36,0,-28
-42.08949,-20.76722,57,29,5,-28
-42.08657,-20.76722,60,33,5,-27
-42.08387,-20.76722,59,29,5,-30
-42.08118,-20.76722,62,30,5,-32
-42.07825,-20.76722,64,33,5,-31
-42.07556,-20.76722,64,39,0,-25
-42.07286,-20.76722,65,37,5,-28
-42.06994,-20.76722,66,30,5,-36
-42.06724,-20.76722,56,35,5,-21
-42.06455,-20.76722,56,31,5,-25
-42.06163,-20.76722,56,30,5,-26
-42.05893,-20.76722,54,32,5,-22
-42.05601,-20.76722,50,40,0,-10
-42.05331,-20.76722,49,33,5,-16
-42.05061,-20.76722,43,27,5,-16
-42.04769,-20.76722,59,27,5,-32
-42.045,-20.76722,56,29,5,-27
-42.0423,-20.76722,56,34,5,-22
-42.03938,-20.76722,54,32,5,-22
-42.03668,-20.76722,48,32,5,-16
-42.03399,-20.76722,49,31,5,-18
-42.03106,-20.76722,58,30,5,-28
-42.02837,-20.76722,58,30,5,-28
-42.02545,-20.76722,59,32,11,-27
-42.02275,-20.76722,50,31,5,-19
-42.02005,-20.76722,48,31,5,-17
-42.01713,-20.76722,59,29,5,-30
-42.01444,-20.76722,58,33,5,-25
-42.01174,-20.76722,51,34,5,-17
-42.00882,-20.76722,50,31,5,-19
-42.00612,-20.76722,52,35,5,-17
-42.00342,-20.76722,67,43,5,-24
-42.0005,-20.76722,54,45,0,-9
-41.99781,-20.76722,55,33,5,-22
-41.99511,-20.76722,59,33,5,-26
-41.99219,-20.76722,61,50,0,-11
-41.98949,-20.76722,63,51,0,-12
-41.98657,-20.76722,64,50,0,-14
-41.98387,-20.76722,60,46,0,-14
-41.98118,-20.76722,59,49,5,-10
-41.97826,-20.76722,58,32,0,-26
-41.97556,-20.76722,58,36,0,-22
-41.97286,-20.76722,58,41,0,-17
-41.96994,-20.76722,64,33,5,-31
-42.1005,-20.767,73,32,0,-41
-42.0978,-20.767,71,32,0,-39
-42.09511,-20.767,67,34,0,-33
-42.09219,-20.767,64,36,0,-28
-42.08949,-20.767,56,29,5,-27
-42.08657,-20.767,61,34,5,-27
-42.08387,-20.767,59,29,5,-30
-42.08118,-20.767,62,30,5,-32
-42.07825,-20.767,64,33,5,-31
-42.07556,-20.767,64,39,0,-25
-42.07286,-20.767,66,38,5,-28
-42.06994,-20.767,56,30,5,-26
-42.06724,-20.767,62,38,5,-24
-42.06455,-20.767,56,26,5,-30
-42.06163,-20.767,56,30,5,-26
-42.05893,-20.767,54,32,5,-22
-42.05601,-20.767,51,40,0,-11
-42.05331,-20.767,49,33,5,-16
-42.05061,-20.767,46,28,5,-18
-42.04769,-20.767,57,27,5,-30
-42.045,-20.767,58,29,5,-29
-42.0423,-20.767,53,34,5,-19
-42.03938,-20.767,50,32,5,-18
-42.03668,-20.767,50,32,5,-18
-42.03399,-20.767,50,31,5,-19
-42.03106,-20.767,54,30,5,-24
-42.02837,-20.767,59,30,5,-29
-42.02545,-20.767,52,32,5,-20
-42.02275,-20.767,49,31,5,-18
-42.02005,-20.767,60,31,5,-29
-42.01713,-20.767,61,29,5,-32
-42.01444,-20.767,55,33,5,-22
-42.01174,-20.767,51,33,5,-18
-42.00882,-20.767,51,32,5,-19
-42.00612,-20.767,52,36,5,-16
-42.00342,-20.767,66,43,5,-23
-42.0005,-20.767,54,44,0,-10
-41.99781,-20.767,55,33,5,-22
-41.99511,-20.767,64,33,5,-31
-41.99219,-20.767,65,50,0,-15
-41.98949,-20.767,65,51,0,-14
-41.98657,-20.767,64,50,0,-14
-41.98387,-20.767,60,46,0,-14
-41.98118,-20.767,59,49,5,-10
-41.97826,-20.767,58,35,0,-23
-41.97556,-20.767,58,36,0,-22
-41.97286,-20.767,58,41,0,-17
-41.96994,-20.767,65,32,5,-33
-42.1005,-20.76658,71,32,0,-39
-42.0978,-20.76658,68,31,0,-37
-42.09511,-20.76658,63,31,0,-32
-42.09219,-20.76658,63,36,5,-27
-42.08949,-20.76658,56,28,5,-28
-42.08657,-20.76658,61,32,5,-29
-42.08387,-20.76658,59,29,5,-30
-42.08118,-20.76658,62,30,5,-32
-42.07825,-20.76658,65,34,5,-31
-42.07556,-20.76658,65,39,5,-26
-42.07286,-20.76658,67,34,5,-33
-42.06994,-20.76658,56,31,5,-25
-42.06724,-20.76658,56,39,0,-17
-42.06455,-20.76658,56,20,5,-36
-42.06163,-20.76658,56,31,5,-25
-42.05893,-20.76658,54,32,5,-22
-42.05601,-20.76658,51,40,0,-11
-42.05331,-20.76658,50,30,5,-20
-42.05061,-20.76658,44,28,5,-16
-42.04769,-20.76658,53,27,5,-26
-42.045,-20.76658,57,29,5,-28
-42.0423,-20.76658,53,33,5,-20
-42.03938,-20.76658,50,32,5,-18
-42.03668,-20.76658,47,33,5,-14
-42.03399,-20.76658,50,32,5,-18
-42.03106,-20.76658,46,30,5,-16
-42.02837,-20.76658,50,31,5,-19
-42.02545,-20.76658,43,31,5,-12
-42.02275,-20.76658,50,31,5,-19
-42.02005,-20.76658,45,33,5,-12
-42.01713,-20.76658,59,30,5,-29
-42.01444,-20.76658,50,33,5,-17
-42.01174,-20.76658,51,35,5,-16
-42.00882,-20.76658,51,43,5,-8
-42.00612,-20.76658,58,36,5,-22
-42.00342,-20.76658,67,41,11,-26
-42.0005,-20.76658,54,34,5,-20
-41.99781,-20.76658,55,34,5,-21
-41.99511,-20.76658,67,37,5,-30
-41.99219,-20.76658,62,48,0,-14
-41.98949,-20.76658,65,51,0,-14
-41.98657,-20.76658,64,49,0,-15
-41.98387,-20.76658,60,45,0,-15
-41.98118,-20.76658,59,48,5,-11
-41.97826,-20.76658,58,34,0,-24
-41.97556,-20.76658,58,33,5,-25
-41.97286,-20.76658,67,47,5,-20
-41.96994,-20.76658,67,32,5,-35
-42.1005,-20.76637,70,32,0,-38
-42.0978,-20.76637,67,31,0,-36
-42.09511,-20.76637,58,31,0,-27
-42.09219,-20.76637,63,36,5,-27
-42.08949,-20.76637,56,28,5,-28
-42.08657,-20.76637,61,33,5,-28
-42.08387,-20.76637,59,29,5,-30
-42.08118,-20.76637,62,30,5,-32
-42.07825,-20.76637,65,34,5,-31
-42.07556,-20.76637,64,38,5,-26
-42.07286,-20.76637,68,36,5,-32
-42.06994,-20.76637,56,31,5,-25
-42.06724,-20.76637,56,39,0,-17
-42.06455,-20.76637,56,25,5,-31
-42.06163,-20.76637,56,32,5,-24
-42.05893,-20.76637,54,32,5,-22
-42.05601,-20.76637,52,40,0,-12
-42.05331,-20.76637,50,29,5,-21
-42.05061,-20.76637,46,29,5,-17
-42.04769,-20.76637,54,27,5,-27
-42.045,-20.76637,56,30,5,-26
-42.0423,-20.76637,55,33,5,-22
-42.03938,-20.76637,47,34,5,-13
-42.03668,-20.76637,48,35,5,-13
-42.03399,-20.76637,48,32,5,-16
-42.03106,-20.76637,46,29,5,-17
-42.02837,-20.76637,46,31,5,-15
-42.02545,-20.76637,44,31,5,-13
-42.02275,-20.76637,50,32,5,-18
-42.02005,-20.76637,45,33,5,-12
-42.01713,-20.76637,54,30,5,-24
-42.01444,-20.76637,48,34,5,-14
-42.01174,-20.76637,52,35,5,-17
-42.00882,-20.76637,51,43,0,-8
-42.00612,-20.76637,56,35,5,-21
-42.00342,-20.76637,63,41,5,-22
-42.0005,-20.76637,54,36,5,-18
-41.99781,-20.76637,56,34,5,-22
-41.99511,-20.76637,70,37,5,-33
-41.99219,-20.76637,62,47,0,-15
-41.98949,-20.76637,66,51,0,-15
-41.98657,-20.76637,64,48,0,-16
-41.98387,-20.76637,60,45,0,-15
-41.98118,-20.76637,59,48,0,-11
-41.97826,-20.76637,58,33,0,-25
-41.97556,-20.76637,58,32,5,-26
-41.97286,-20.76637,58,47,5,-11
-41.96994,-20.76637,68,34,5,-34
-42.1005,-20.76616,70,32,0,-38
-42.0978,-20.76616,66,31,0,-35
-42.09511,-20.76616,57,32,0,-25
-42.09219,-20.76616,65,36,5,-29
-42.08949,-20.76616,56,30,5,-26
-42.08657,-20.76616,63,34,0,-29
-42.08387,-20.76616,58,28,5,-30
-42.08118,-20.76616,63,30,5,-33
-42.07825,-20.76616,66,37,5,-29
-42.07556,-20.76616,65,38,5,-27
-42.07286,-20.76616,65,34,5,-31
-42.06994,-20.76616,56,31,5,-25
-42.06724,-20.76616,60,39,0,-21
-42.06455,-20.76616,56,17,5,-39
-42.06163,-20.76616,56,31,5,-25
-42.05893,-20.76616,54,32,5,-22
-42.05601,-20.76616,52,40,0,-12
-42.05331,-20.76616,50,29,5,-21
-42.05061,-20.76616,46,29,5,-17
-42.04769,-20.76616,53,27,5,-26
-42.045,-20.76616,57,30,5,-27
-42.0423,-20.76616,55,33,5,-22
-42.03938,-20.76616,47,33,5,-14
-42.03668,-20.76616,48,35,5,-13
-42.03399,-20.76616,47,32,5,-15
-42.03106,-20.76616,47,28,5,-19
-42.02837,-20.76616,48,30,5,-18
-42.02545,-20.76616,45,29,5,-16
-42.02275,-20.76616,50,35,5,-15
-42.02005,-20.76616,48,33,5,-15
-42.01713,-20.76616,51,30,5,-21
-42.01444,-20.76616,49,33,5,-16
-42.01174,-20.76616,52,37,5,-15
-42.00882,-20.76616,51,43,0,-8
-42.00612,-20.76616,57,36,5,-21
-42.00342,-20.76616,61,36,5,-25
-42.0005,-20.76616,55,36,5,-19
-41.99781,-20.76616,57,34,5,-23
-41.99511,-20.76616,70,35,5,-35
-41.99219,-20.76616,63,46,0,-17
-41.98949,-20.76616,66,50,0,-16
-41.98657,-20.76616,64,46,0,-18
-41.98387,-20.76616,60,44,0,-16
-41.98118,-20.76616,59,48,0,-11
-41.97826,-20.76616,58,33,0,-25
-41.97556,-20.76616,58,32,5,-26
-41.97286,-20.76616,58,37,5,-21
-41.96994,-20.76616,69,34,0,-35
-42.1005,-20.76574,69,32,0,-37
-42.0978,-20.76574,66,31,0,-35
-42.09511,-20.76574,58,31,0,-27
-42.09219,-20.76574,66,36,0,-30
-42.08949,-20.76574,58,27,5,-31
-42.08657,-20.76574,63,34,0,-29
-42.08387,-20.76574,58,30,5,-28
-42.08118,-20.76574,62,31,5,-31
-42.07825,-20.76574,68,37,5,-31
-42.07556,-20.76574,66,38,5,-28
-42.07286,-20.76574,64,34,5,-30
-42.06994,-20.76574,56,30,5,-26
-42.06724,-20.76574,56,38,0,-18
-42.06455,-20.76574,56,16,5,-40
-42.06163,-20.76574,56,35,11,-21
-42.05893,-20.76574,55,32,5,-23
-42.05601,-20.76574,52,40,0,-12
-42.05331,-20.76574,50,30,5,-20
-42.05061,-20.76574,58,29,5,-29
-42.04769,-20.76574,40,28,5,-12
-42.045,-20.76574,57,30,5,-27
-42.0423,-20.76574,57,34,5,-23
-42.03938,-20.76574,47,36,5,-11
-42.03668,-20.76574,48,33,5,-15
-42.03399,-20.76574,48,32,5,-16
-42.03106,-20.76574,49,29,5,-20
-42.02837,-20.76574,49,30,5,-19
-42.02545,-20.76574,44,32,5,-12
-42.02275,-20.76574,50,35,5,-15
-42.02005,-20.76574,45,34,5,-11
-42.01713,-20.76574,44,31,5,-13
-42.01444,-20.76574,49,35,5,-14
-42.01174,-20.76574,52,43,0,-9
-42.00882,-20.76574,53,42,0,-11
-42.00612,-20.76574,58,34,5,-24
-42.00342,-20.76574,61,41,0,-20
-42.0005,-20.76574,55,32,5,-23
-41.99781,-20.76574,58,34,5,-24
-41.99511,-20.76574,72,37,0,-35
-41.99219,-20.76574,64,45,0,-19
-41.98949,-20.76574,66,45,0,-21
-41.98657,-20.76574,65,44,0,-21
-41.98387,-20.76574,60,41,0,-19
-41.98118,-20.76574,59,45,0,-14
-41.97826,-20.76574,58,34,0,-24
-41.97556,-20.76574,67,33,5,-34
-41.97286,-20.76574,68,49,5,-19
-41.96994,-20.76574,69,34,0,-35
-42.1005,-20.76552,69,32,0,-37
-42.0978,-20.76552,67,29,5,-38
-42.09511,-20.76552,57,30,5,-27
-42.09219,-20.76552,64,36,0,-28
-42.08949,-20.76552,61,28,5,-33
-42.08657,-20.76552,63,34,0,-29
-42.08387,-20.76552,57,30,5,-27
-42.08118,-20.76552,61,30,5,-31
-42.07825,-20.76552,66,36,5,-30
-42.07556,-20.76552,64,38,5,-26
-42.07286,-20.76552,64,35,5,-29
-42.06994,-20.76552,57,31,5,-26
-42.06724,-20.76552,56,38,0,-18
-42.06455,-20.76552,56,22,5,-34
-42.06163,-20.76552,56,35,5,-21
-42.05893,-20.76552,55,32,5,-23
-42.05601,-20.76552,52,39,0,-13
-42.05331,-20.76552,50,30,5,-20
-42.05061,-20.76552,58,30,5,-28
-42.04769,-20.76552,40,28,5,-12
-42.045,-20.76552,52,30,5,-22
-42.0423,-20.76552,53,34,5,-19
-42.03938,-20.76552,47,36,5,-11
-42.03668,-20.76552,48,34,5,-14
-42.03399,-20.76552,44,32,5,-12
-42.03106,-20.76552,51,30,5,-21
-42.02837,-20.76552,51,31,5,-20
-42.02545,-20.76552,45,36,5,-9
-42.02275,-20.76552,50,37,5,-13
-42.02005,-20.76552,45,34,5,-11
-42.01713,-20.76552,44,31,5,-13
-42.01444,-20.76552,49,35,5,-14
-42.01174,-20.76552,52,43,0,-9
-42.00882,-20.76552,58,42,0,-16
-42.00612,-20.76552,56,34,5,-22
-42.00342,-20.76552,53,41,0,-12
-42.0005,-20.76552,55,32,5,-23
-41.99781,-20.76552,58,34,5,-24
-41.99511,-20.76552,70,37,5,-33
-41.99219,-20.76552,64,44,0,-20
-41.98949,-20.76552,67,42,0,-25
-41.98657,-20.76552,64,44,0,-20
-41.98387,-20.76552,60,38,0,-22
-41.98118,-20.76552,59,44,0,-15
-41.97826,-20.76552,58,33,0,-25
-41.97556,-20.76552,66,34,0,-32
-41.97286,-20.76552,58,49,0,-9
-41.96994,-20.76552,70,34,0,-36
-42.1005,-20.76531,67,31,0,-36
-42.0978,-20.76531,67,27,5,-40
-42.09511,-20.76531,56,26,5,-30
-42.09219,-20.76531,62,36,0,-26
-42.08949,-20.76531,62,28,5,-34
-42.08657,-20.76531,64,34,0,-30
-42.08387,-20.76531,57,29,5,-28
-42.08118,-20.76531,61,30,5,-31
-42.07825,-20.76531,66,38,5,-28
-42.07556,-20.76531,65,38,5,-27
-42.07286,-20.76531,64,34,5,-30
-42.06994,-20.76531,57,30,5,-27
-42.06724,-20.76531,56,38,0,-18
-42.06455,-20.76531,60,22,5,-38
-42.06163,-20.76531,56,31,5,-25
-42.05893,-20.76531,55,32,5,-23
-42.05601,-20.76531,53,38,0,-15
-42.05331,-20.76531,51,30,5,-21
-42.05061,-20.76531,55,34,5,-21
-42.04769,-20.76531,41,28,5,-13
-42.045,-20.76531,48,30,5,-18
-42.0423,-20.76531,53,34,5,-19
-42.03938,-20.76531,43,36,0,-7
-42.03668,-20.76531,48,34,5,-14
-42.03399,-20.76531,43,31,5,-12
-42.03106,-20.76531,52,34,5,-18
-42.02837,-20.76531,53,31,5,-22
-42.02545,-20.76531,48,44,5,-4
-42.02275,-20.76531,49,36,5,-13
-42.02005,-20.76531,47,34,5,-13
-42.01713,-20.76531,44,31,5,-13
-42.01444,-20.76531,52,35,5,-17
-42.01174,-20.76531,52,43,0,-9
-42.00882,-20.76531,59,42,5,-17
-42.00612,-20.76531,53,34,5,-19
-42.00342,-20.76531,53,36,5,-17
-42.0005,-20.76531,55,33,5,-22
-41.99781,-20.76531,58,32,5,-26
-41.99511,-20.76531,70,33,5,-37
-41.99219,-20.76531,62,43,0,-19
-41.98949,-20.76531,67,41,0,-26
-41.98657,-20.76531,65,43,0,-22
-41.98387,-20.76531,60,37,0,-23
-41.98118,-20.76531,59,44,0,-15
-41.97826,-20.76531,58,36,0,-22
-41.97556,-20.76531,58,35,0,-23
-41.97286,-20.76531,58,50,0,-8
-41.96994,-20.76531,70,34,0,-36
-42.10297,-20.7651,62,33,5,-29
-42.10275,-20.7651,63,32,5,-31
-42.10252,-20.7651,66,32,5,-34
-42.1023,-20.7651,66,32,5,-34
-42.10185,-20.7651,67,31,5,-36
-42.10163,-20.7651,68,32,5,-36
-42.1014,-20.7651,69,31,5,-38
-42.10118,-20.7651,70,31,5,-39
-42.10073,-20.7651,65,31,5,-34
-42.1005,-20.7651,65,31,0,-34
-42.10028,-20.7651,65,31,0,-34
-42.10005,-20.7651,65,31,0,-34
-42.09983,-20.7651,66,31,0,-35
-42.09938,-20.7651,66,25,5,-41
-42.09915,-20.7651,67,25,5,-42
-42.09893,-20.7651,70,26,5,-44
-42.0987,-20.7651,68,27,5,-41
-42.09825,-20.7651,70,26,5,-44
-42.09803,-20.7651,67,27,5,-40
-42.0978,-20.7651,66,28,5,-38
-42.09758,-20.7651,65,27,5,-38
-42.09713,-20.7651,60,26,5,-34
-42.09691,-20.7651,60,26,5,-34
-42.09668,-20.7651,55,26,5,-29
-42.09646,-20.7651,55,26,5,-29
-42.09601,-20.7651,55,26,5,-29
-42.09578,-20.7651,55,25,5,-30
-42.09556,-20.7651,55,26,5,-29
-42.09533,-20.7651,57,26,5,-31
-42.09511,-20.7651,60,26,5,-34
-42.09466,-20.7651,62,25,5,-37
-42.09443,-20.7651,63,27,5,-36
-42.09421,-20.7651,64,27,5,-37
-42.09398,-20.7651,64,28,5,-36
-42.09354,-20.7651,65,32,5,-33
-42.09331,-20.7651,65,34,5,-31
-42.09309,-20.7651,65,36,0,-29
-42.09286,-20.7651,57,35,0,-22
-42.09241,-20.7651,56,36,0,-20
-42.09219,-20.7651,61,35,0,-26
-42.09196,-20.7651,56,35,0,-21
-42.09174,-20.7651,57,33,5,-24
-42.09129,-20.7651,58,29,5,-29
-42.09106,-20.7651,59,29,5,-30
-42.09084,-20.7651,61,32,5,-29
-42.09061,-20.7651,62,31,5,-31
-42.09039,-20.7651,62,29,5,-33
-42.08994,-20.7651,63,29,5,-34
-42.08972,-20.7651,63,28,5,-35
-42.08949,-20.7651,63,27,5,-36
-42.08927,-20.7651,65,27,5,-38
-42.08882,-20.7651,62,27,5,-35
-42.08859,-20.7651,61,27,5,-34
-42.08837,-20.7651,60,28,5,-32
-42.08814,-20.7651,60,30,5,-30
-42.08769,-20.7651,61,35,5,-26
-42.08747,-20.7651,61,35,5,-26
-42.08724,-20.7651,62,35,0,-27
-42.08702,-20.7651,63,35,0,-28
-42.08657,-20.7651,64,34,0,-30
-42.08634,-20.7651,66,34,0,-32
-42.08612,-20.7651,65,34,0,-31
-42.08589,-20.7651,65,33,0,-32
-42.08545,-20.7651,65,32,5,-33
-42.08522,-20.7651,65,31,5,-34
-42.085,-20.7651,63,30,5,-33
-42.08477,-20.7651,57,30,5,-27
-42.08455,-20.7651,56,30,5,-26
-42.0841,-20.7651,56,29,5,-27
-42.08387,-20.7651,57,29,5,-28
-42.08365,-20.7651,57,29,5,-28
-42.08342,-20.7651,58,28,5,-30
-42.08297,-20.7651,58,28,5,-30
-42.08275,-20.7651,59,29,5,-30
-42.08252,-20.7651,59,31,5,-28
-42.0823,-20.7651,60,31,5,-29
-42.08185,-20.7651,60,31,5,-29
-42.08163,-20.7651,60,31,5,-29
-42.0814,-20.7651,61,29,5,-32
-42.08118,-20.7651,61,30,5,-31
-42.08073,-20.7651,62,30,5,-32
-42.0805,-20.7651,63,30,5,-33
-42.08028,-20.7651,64,31,5,-33
-42.08005,-20.7651,64,31,5,-33
-42.07983,-20.7651,67,34,5,-33
-42.07938,-20.7651,69,38,5,-31
-42.07915,-20.7651,69,38,5,-31
-42.07893,-20.7651,69,38,5,-31
-42.0787,-20.7651,66,35,5,-31
-42.07825,-20.7651,66,35,5,-31
-42.07803,-20.7651,69,35,5,-34
-42.07781,-20.7651,69,37,5,-32
-42.07758,-20.7651,69,35,5,-34
-42.07713,-20.7651,69,38,5,-31
-42.07691,-20.7651,69,38,5,-31
-42.07668,-20.7651,68,38,5,-30
-42.07646,-20.7651,66,38,5,-28
-42.07601,-20.7651,65,38,5,-27
-42.07578,-20.7651,65,38,5,-27
-42.07556,-20.7651,66,38,5,-28
-42.07533,-20.7651,65,38,0,-27
-42.07511,-20.7651,66,38,0,-28
-42.07466,-20.7651,66,38,0,-28
-42.07443,-20.7651,65,38,0,-27
-42.07421,-20.7651,66,38,0,-28
-42.07399,-20.7651,65,38,5,-27
-42.07354,-20.7651,65,37,5,-28
-42.07331,-20.7651,66,37,5,-29
-42.07309,-20.7651,65,37,5,-28
-42.07286,-20.7651,65,37,5,-28
-42.07241,-20.7651,64,34,5,-30
-42.07219,-20.7651,62,32,5,-30
-42.07196,-20.7651,57,31,5,-26
-42.07174,-20.7651,56,31,5,-25
-42.07129,-20.7651,56,30,5,-26
-42.07106,-20.7651,56,30,5,-26
-42.07084,-20.7651,56,30,5,-26
-42.07061,-20.7651,57,30,5,-27
-42.07039,-20.7651,57,31,5,-26
-42.06994,-20.7651,57,30,5,-27
-42.06972,-20.7651,57,31,5,-26
-42.06949,-20.7651,57,32,5,-25
-42.06927,-20.7651,57,32,5,-25
-42.06882,-20.7651,57,39,5,-18
-42.06859,-20.7651,56,39,5,-17
-42.06837,-20.7651,56,39,5,-17
-42.06814,-20.7651,56,39,0,-17
-42.06769,-20.7651,56,39,0,-17
-42.06747,-20.7651,56,38,0,-18
-42.06724,-20.7651,56,38,0,-18
-42.06702,-20.7651,56,37,5,-19
-42.06657,-20.7651,56,35,5,-21
-42.06634,-20.7651,56,35,5,-21
-42.06612,-20.7651,56,35,11,-21
-42.0659,-20.7651,58,34,5,-24
-42.06545,-20.7651,56,32,5,-24
-42.06522,-20.7651,60,30,5,-30
-42.065,-20.7651,62,26,5,-36
-42.06477,-20.7651,62,19,5,-43
-42.06455,-20.7651,62,26,5,-36
-42.0641,-20.7651,61,28,5,-33
-42.06387,-20.7651,58,28,5,-30
-42.06365,-20.7651,56,28,5,-28
-42.06342,-20.7651,56,28,5,-28
-42.06297,-20.7651,56,29,5,-27
-42.06275,-20.7651,56,29,5,-27
-42.06252,-20.7651,56,32,5,-24
-42.0623,-20.7651,56,33,5,-23
-42.06185,-20.7651,56,33,5,-23
-42.06163,-20.7651,56,31,5,-25
-42.0614,-20.7651,56,32,5,-24
-42.06118,-20.7651,56,32,5,-24
-42.06073,-20.7651,56,32,5,-24
-42.0605,-20.7651,56,32,5,-24
-42.06028,-20.7651,56,36,5,-20
-42.06005,-20.7651,56,36,11,-20
-42.05983,-20.7651,56,36,5,-20
-42.05938,-20.7651,55,32,5,-23
-42.05915,-20.7651,55,32,5,-23
-42.05893,-20.7651,55,32,5,-23
-42.0587,-20.7651,55,32,5,-23
-42.05826,-20.7651,55,33,5,-22
-42.05803,-20.7651,54,34,5,-20
-42.05781,-20.7651,54,37,5,-17
-42.05758,-20.7651,54,40,0,-14
-42.05713,-20.7651,54,40,0,-14
-42.05691,-20.7651,54,38,0,-16
-42.05668,-20.7651,54,38,0,-16
-42.05646,-20.7651,54,38,0,-16
-42.05601,-20.7651,53,38,0,-15
-42.05578,-20.7651,53,38,11,-15
-42.05556,-20.7651,53,38,0,-15
-42.05533,-20.7651,52,38,0,-14
-42.05511,-20.7651,51,39,0,-12
-42.05466,-20.7651,51,37,5,-14
-42.05443,-20.7651,51,34,5,-17
-42.05421,-20.7651,50,31,5,-19
-42.05399,-20.7651,50,31,5,-19
-42.05354,-20.7651,51,30,5,-21
-42.05331,-20.7651,51,30,5,-21
-42.05309,-20.7651,51,30,5,-21
-42.05286,-20.7651,51,30,5,-21
-42.05241,-20.7651,51,30,5,-21
-42.05219,-20.7651,51,29,5,-22
-42.05196,-20.7651,50,30,5,-20
-42.05174,-20.7651,50,30,5,-20
-42.05129,-20.7651,49,30,5,-19
-42.05106,-20.7651,54,30,5,-24
-42.05084,-20.7651,58,34,5,-24
-42.05061,-20.7651,55,35,5,-20
-42.05039,-20.7651,49,39,5,-10
-42.04994,-20.7651,44,38,5,-6
-42.04972,-20.7651,44,36,0,-8
-42.04949,-20.7651,44,30,0,-14
-42.04927,-20.7651,44,26,0,-18
-42.04882,-20.7651,42,26,5,-16
-42.04859,-20.7651,43,26,5,-17
-42.04837,-20.7651,41,26,5,-15
-42.04814,-20.7651,41,27,5,-14
-42.04769,-20.7651,43,28,5,-15
-42.04747,-20.7651,44,28,5,-16
-42.04724,-20.7651,44,28,5,-16
-42.04702,-20.7651,43,28,5,-15
-42.04657,-20.7651,43,28,5,-15
-42.04635,-20.7651,43,28,5,-15
-42.04612,-20.7651,41,28,5,-13
-42.0459,-20.7651,38,28,5,-10
-42.04545,-20.7651,38,31,5,-7
-42.04522,-20.7651,39,32,5,-7
-42.045,-20.7651,39,38,5,-1
-42.04477,-20.7651,51,30,5,-21
-42.04455,-20.7651,50,33,5,-17
-42.0441,-20.7651,49,34,5,-15
-42.04387,-20.7651,50,35,5,-15
-42.04365,-20.7651,50,34,5,-16
-42.04342,-20.7651,49,35,5,-14
-42.04297,-20.7651,51,38,5,-13
-42.04275,-20.7651,52,38,5,-14
-42.04253,-20.7651,51,34,5,-17
-42.0423,-20.7651,52,34,5,-18
-42.04185,-20.7651,52,34,5,-18
-42.04163,-20.7651,53,33,5,-20
-42.0414,-20.7651,52,36,5,-16
-42.04118,-20.7651,52,36,11,-16
-42.04073,-20.7651,50,33,5,-17
-42.0405,-20.7651,48,33,5,-15
-42.04028,-20.7651,47,33,5,-14
-42.04005,-20.7651,46,36,5,-10
-42.03983,-20.7651,44,36,0,-8
-42.03938,-20.7651,43,36,0,-7
-42.03915,-20.7651,39,36,0,-3
-42.03893,-20.7651,40,36,0,-4
-42.0387,-20.7651,40,36,0,-4
-42.03826,-20.7651,40,36,5,-4
-42.03803,-20.7651,41,35,5,-6
-42.03781,-20.7651,42,35,5,-7
-42.03758,-20.7651,43,35,5,-8
-42.03713,-20.7651,45,37,5,-8
-42.03691,-20.7651,47,37,5,-10
-42.03668,-20.7651,50,35,5,-15
-42.03646,-20.7651,52,33,5,-19
-42.03601,-20.7651,52,33,5,-19
-42.03578,-20.7651,48,32,5,-16
-42.03556,-20.7651,48,32,5,-16
-42.03533,-20.7651,47,32,5,-15
-42.03511,-20.7651,47,32,5,-15
-42.03466,-20.7651,46,32,5,-14
-42.03444,-20.7651,45,31,5,-14
-42.03421,-20.7651,44,31,5,-13
-42.03399,-20.7651,44,31,5,-13
-42.03354,-20.7651,46,30,5,-16
-42.03331,-20.7651,46,30,5,-16
-42.03309,-20.7651,48,32,5,-16
-42.03286,-20.7651,49,33,5,-16
-42.03241,-20.7651,51,34,5,-17
-42.03219,-20.7651,52,34,5,-18
-42.03196,-20.7651,53,34,5,-19
-42.03174,-20.7651,53,34,5,-19
-42.03129,-20.7651,53,35,5,-18
-42.03106,-20.7651,54,35,5,-19
-42.03084,-20.7651,55,34,5,-21
-42.03062,-20.7651,55,34,5,-21
-42.03017,-20.7651,55,33,5,-22
-42.02994,-20.7651,55,32,5,-23
-42.02972,-20.7651,55,33,5,-22
-42.02949,-20.7651,54,36,5,-18
-42.02927,-20.7651,54,36,5,-18
-42.02882,-20.7651,53,31,5,-22
-42.02859,-20.7651,53,31,5,-22
-42.02837,-20.7651,54,31,5,-23
-42.02814,-20.7651,55,32,5,-23
-42.02769,-20.7651,55,35,5,-20
-42.02747,-20.7651,54,46,5,-8
-42.02724,-20.7651,54,47,5,-7
-42.02702,-20.7651,53,47,5,-6
-42.02657,-20.7651,52,47,0,-5
-42.02635,-20.7651,53,45,0,-8
-42.02612,-20.7651,52,45,5,-7
-42.0259,-20.7651,50,45,5,-5
-42.02545,-20.7651,50,44,5,-6
-42.02522,-20.7651,51,44,5,-7
-42.025,-20.7651,51,40,5,-11
-42.02477,-20.7651,51,40,5,-11
-42.02455,-20.7651,51,32,5,-19
-42.0241,-20.7651,51,42,5,-9
-42.02387,-20.7651,52,38,5,-14
-42.02365,-20.7651,52,42,11,-10
-42.02342,-20.7651,51,42,5,-9
-42.02297,-20.7651,50,35,5,-15
-42.02275,-20.7651,49,35,5,-14
-42.02253,-20.7651,49,36,5,-13
-42.0223,-20.7651,48,41,5,-7
-42.02185,-20.7651,47,37,5,-10
-42.02163,-20.7651,47,37,5,-10
-42.0214,-20.7651,47,35,5,-12
-42.02118,-20.7651,48,35,5,-13
-42.02073,-20.7651,45,33,5,-12
-42.0205,-20.7651,49,33,5,-16
-42.02028,-20.7651,49,32,5,-17
-42.02005,-20.7651,49,31,5,-18
-42.01983,-20.7651,49,31,5,-18
-42.01938,-20.7651,47,31,5,-16
-42.01915,-20.7651,48,30,5,-18
-42.01893,-20.7651,47,30,5,-17
-42.01871,-20.7651,48,30,5,-18
-42.01826,-20.7651,50,29,5,-21
-42.01803,-20.7651,50,29,5,-21
-42.01781,-20.7651,48,29,5,-19
-42.01758,-20.7651,45,31,5,-14
-42.01713,-20.7651,45,33,5,-12
-42.01691,-20.7651,45,34,5,-11
-42.01668,-20.7651,45,34,0,-11
-42.01646,-20.7651,46,34,0,-12
-42.01601,-20.7651,50,30,5,-20
-42.01578,-20.7651,52,29,5,-23
-42.01556,-20.7651,52,34,5,-18
-42.01533,-20.7651,53,35,5,-18
-42.01511,-20.7651,52,35,5,-17
-42.01466,-20.7651,54,36,5,-18
-42.01444,-20.7651,54,37,5,-17
-42.01421,-20.7651,54,37,5,-17
-42.01399,-20.7651,54,36,5,-18
-42.01354,-20.7651,55,36,5,-19
-42.01331,-20.7651,55,35,5,-20
-42.01309,-20.7651,55,38,5,-17
-42.01286,-20.7651,56,39,5,-17
-42.01241,-20.7651,56,43,5,-13
-42.01219,-20.7651,56,43,0,-13
-42.01196,-20.7651,55,43,0,-12
-42.01174,-20.7651,53,43,0,-10
-42.01129,-20.7651,52,43,0,-9
-42.01106,-20.7651,52,42,0,-10
-42.01084,-20.7651,51,42,0,-9
-42.01062,-20.7651,59,42,0,-17
-42.01017,-20.7651,61,42,0,-19
-42.00994,-20.7651,62,41,0,-21
-42.00972,-20.7651,61,42,0,-19
-42.00949,-20.7651,61,42,0,-19
-42.00927,-20.7651,62,43,0,-19
-42.00882,-20.7651,61,43,5,-18
-42.00859,-20.7651,62,37,5,-25
-42.00837,-20.7651,61,38,5,-23
-42.00814,-20.7651,59,35,5,-24
-42.00769,-20.7651,54,36,5,-18
-42.00747,-20.7651,52,35,5,-17
-42.00724,-20.7651,52,34,5,-18
-42.00702,-20.7651,52,34,5,-18
-42.00657,-20.7651,52,35,5,-17
-42.00635,-20.7651,52,35,5,-17
-42.00612,-20.7651,56,35,5,-21
-42.0059,-20.7651,57,35,5,-22
-42.00545,-20.7651,56,36,5,-20
-42.00522,-20.7651,53,35,5,-18
-42.005,-20.7651,53,35,5,-18
-42.00477,-20.7651,53,35,5,-18
-42.00455,-20.7651,53,33,5,-20
-42.0041,-20.7651,53,34,5,-19
-42.00387,-20.7651,53,34,5,-19
-42.00365,-20.7651,53,33,5,-20
-42.00342,-20.7651,53,32,5,-21
-42.00298,-20.7651,53,31,5,-22
-42.00275,-20.7651,63,31,5,-32
-42.00253,-20.7651,62,32,5,-30
-42.0023,-20.7651,59,39,11,-20
-42.00185,-20.7651,62,33,5,-29
-42.00163,-20.7651,58,32,5,-26
-42.0014,-20.7651,55,34,5,-21
-42.00118,-20.7651,55,34,5,-21
-42.00073,-20.7651,55,32,5,-23
-42.0005,-20.7651,56,32,5,-24
-42.00028,-20.7651,57,33,5,-24
-42.00005,-20.7651,57,33,5,-24
-41.99983,-20.7651,57,32,5,-25
-41.99938,-20.7651,56,32,5,-24
-41.99916,-20.7651,57,32,5,-25
-41.99893,-20.7651,57,32,5,-25
-41.99871,-20.7651,57,33,5,-24
-41.99826,-20.7651,58,33,5,-25
-41.99803,-20.7651,58,33,5,-25
-41.99781,-20.7651,58,33,5,-25
-41.99758,-20.7651,58,32,5,-26
-41.99713,-20.7651,59,32,5,-27
-41.99691,-20.7651,58,31,5,-27
-41.99668,-20.7651,58,30,5,-28
-41.99646,-20.7651,62,30,5,-32
-41.99601,-20.7651,58,29,5,-29
-41.99578,-20.7651,58,34,5,-24
-41.99556,-20.7651,59,34,6,-25
-41.99533,-20.7651,70,34,5,-36
-41.99511,-20.7651,71,33,5,-38
-41.99466,-20.7651,73,30,5,-43
-41.99444,-20.7651,74,30,5,-44
-41.99421,-20.7651,73,30,5,-43
-41.99399,-20.7651,71,29,5,-42
-41.99354,-20.7651,70,33,0,-37
-41.99331,-20.7651,69,34,0,-35
-41.99309,-20.7651,68,38,0,-30
-41.99286,-20.7651,67,39,0,-28
-41.99241,-20.7651,64,40,0,-24
-41.99219,-20.7651,61,43,0,-18
-41.99196,-20.7651,59,46,0,-13
-41.99174,-20.7651,59,46,0,-13
-41.99129,-20.7651,68,48,0,-20
-41.99107,-20.7651,71,48,0,-23
-41.99084,-20.7651,71,48,0,-23
-41.99062,-20.7651,70,47,0,-23
-41.99017,-20.7651,69,45,0,-24
-41.98994,-20.7651,69,44,0,-25
-41.98972,-20.7651,69,35,0,-34
-41.98949,-20.7651,69,40,0,-29
-41.98927,-20.7651,68,41,0,-27
-41.98882,-20.7651,67,42,0,-25
-41.98859,-20.7651,66,42,0,-24
-41.98837,-20.7651,66,42,0,-24
-41.98814,-20.7651,67,41,0,-26
-41.98769,-20.7651,66,42,0,-24
-41.98747,-20.7651,70,42,0,-28
-41.98725,-20.7651,66,42,0,-24
-41.98702,-20.7651,65,42,0,-23
-41.98657,-20.7651,64,42,0,-22
-41.98635,-20.7651,63,43,0,-20
-41.98612,-20.7651,61,43,0,-18
-41.9859,-20.7651,61,42,0,-19
-41.98545,-20.7651,61,37,5,-24
-41.98522,-20.7651,61,40,5,-21
-41.985,-20.7651,61,36,5,-25
-41.98477,-20.7651,61,35,5,-26
-41.98455,-20.7651,61,34,0,-27
-41.9841,-20.7651,60,35,0,-25
-41.98387,-20.7651,60,36,0,-24
-41.98365,-20.7651,60,35,0,-25
-41.98343,-20.7651,60,35,0,-25
-41.98298,-20.7651,60,35,0,-25
-41.98275,-20.7651,60,36,0,-24
-41.98253,-20.7651,59,36,0,-23
-41.9823,-20.7651,59,39,0,-20
-41.98185,-20.7651,59,41,0,-18
-41.98163,-20.7651,59,42,0,-17
-41.9814,-20.7651,59,43,0,-16
-41.98118,-20.7651,59,45,0,-14
-41.98073,-20.7651,59,50,0,-9
-41.9805,-20.7651,58,50,0,-8
-41.98028,-20.7651,58,51,5,-7
-41.98005,-20.7651,58,51,5,-7
-41.97983,-20.7651,58,47,5,-11
-41.97938,-20.7651,58,44,5,-14
-41.97916,-20.7651,58,42,0,-16
-41.97893,-20.7651,58,36,0,-22
-41.97871,-20.7651,58,37,0,-21
-41.97826,-20.7651,58,36,0,-22
-41.97803,-20.7651,58,34,0,-24
-41.97781,-20.7651,58,34,0,-24
-41.97758,-20.7651,58,33,0,-25
-41.97713,-20.7651,58,33,0,-25
-41.97691,-20.7651,70,32,0,-38
-41.97668,-20.7651,63,32,0,-31
-41.97646,-20.7651,67,33,0,-34
-41.97601,-20.7651,58,34,0,-24
-41.97578,-20.7651,58,35,0,-23
-41.97556,-20.7651,58,36,0,-22
-41.97534,-20.7651,58,37,11,-21
-41.97511,-20.7651,58,37,11,-21
-41.97466,-20.7651,58,41,0,-17
-41.97444,-20.7651,58,42,0,-16
-41.97421,-20.7651,60,49,0,-11
-41.97399,-20.7651,58,43,0,-15
-41.97354,-20.7651,58,50,0,-8
-41.97331,-20.7651,58,50,0,-8
-41.97309,-20.7651,63,50,5,-13
-41.97286,-20.7651,67,38,5,-29
-41.97241,-20.7651,67,33,5,-34
-41.97219,-20.7651,70,33,5,-37
-41.97196,-20.7651,73,32,5,-41
-41.97174,-20.7651,72,32,5,-40
-41.97129,-20.7651,73,33,5,-40
-41.97107,-20.7651,73,33,5,-40
-41.97084,-20.7651,72,33,5,-39
-41.97062,-20.7651,72,34,5,-38
-41.97017,-20.7651,71,34,0,-37
-41.96994,-20.7651,69,33,0,-36
-41.96972,-20.7651,69,33,0,-36
-41.96949,-20.7651,68,32,0,-36
-41.96927,-20.7651,67,33,0,-34
-42.1005,-20.76468,65,25,5,-40
-42.0978,-20.76468,65,28,5,-37
-42.09511,-20.76468,60,27,5,-33
-42.09219,-20.76468,57,29,5,-28
-42.08949,-20.76468,64,27,5,-37
-42.08657,-20.76468,65,34,0,-31
-42.08387,-20.76468,56,29,5,-27
-42.08118,-20.76468,61,30,5,-31
-42.07825,-20.76468,65,34,5,-31
-42.07556,-20.76468,66,38,0,-28
-42.07286,-20.76468,64,33,5,-31
-42.06994,-20.76468,57,32,5,-25
-42.06724,-20.76468,56,36,0,-20
-42.06455,-20.76468,56,27,5,-29
-42.06163,-20.76468,56,33,5,-23
-42.05893,-20.76468,55,34,5,-21
-42.05601,-20.76468,54,38,0,-16
-42.05331,-20.76468,51,31,5,-20
-42.05061,-20.76468,56,40,5,-16
-42.04769,-20.76468,44,27,5,-17
-42.045,-20.76468,39,39,0,0
-42.0423,-20.76468,49,35,5,-14
-42.03938,-20.76468,43,35,5,-8
-42.03668,-20.76468,52,36,5,-16
-42.03399,-20.76468,46,30,5,-16
-42.03106,-20.76468,55,36,5,-19
-42.02837,-20.76468,56,34,5,-22
-42.02545,-20.76468,52,39,5,-13
-42.02275,-20.76468,51,33,5,-18
-42.02005,-20.76468,50,33,5,-17
-42.01713,-20.76468,50,34,0,-16
-42.01444,-20.76468,55,38,5,-17
-42.01174,-20.76468,56,42,0,-14
-42.00882,-20.76468,64,37,5,-27
-42.00612,-20.76468,59,40,5,-19
-42.00342,-20.76468,53,35,5,-18
-42.0005,-20.76468,57,35,5,-22
-41.99781,-20.76468,59,33,5,-26
-41.99511,-20.76468,69,31,5,-38
-41.99219,-20.76468,60,42,0,-18
-41.98949,-20.76468,69,38,0,-31
-41.98657,-20.76468,64,43,0,-21
-41.98387,-20.76468,60,31,0,-29
-41.98118,-20.76468,59,48,0,-11
-41.97826,-20.76468,58,39,5,-19
-41.97556,-20.76468,64,38,11,-26
-41.97286,-20.76468,57,50,5,-7
-41.96994,-20.76468,69,31,5,-38
-42.1005,-20.76447,65,25,5,-40
-42.0978,-20.76447,68,28,5,-40
-42.09511,-20.76447,62,26,5,-36
-42.09219,-20.76447,57,29,5,-28
-42.08949,-20.76447,66,28,5,-38
-42.08657,-20.76447,63,34,0,-29
-42.08387,-20.76447,58,29,5,-29
-42.08118,-20.76447,61,30,5,-31
-42.07825,-20.76447,62,35,5,-27
-42.07556,-20.76447,63,38,5,-25
-42.07286,-20.76447,57,34,5,-23
-42.06994,-20.76447,57,34,5,-23
-42.06724,-20.76447,56,35,0,-21
-42.06455,-20.76447,56,27,5,-29
-42.06163,-20.76447,59,33,5,-26
-42.05893,-20.76447,55,34,11,-21
-42.05601,-20.76447,54,37,0,-17
-42.05331,-20.76447,51,31,5,-20
-42.05061,-20.76447,48,40,5,-8
-42.04769,-20.76447,47,29,5,-18
-42.045,-20.76447,39,38,0,-1
-42.0423,-20.76447,49,36,5,-13
-42.03938,-20.76447,44,33,5,-11
-42.03668,-20.76447,48,34,5,-14
-42.03399,-20.76447,46,32,5,-14
-42.03106,-20.76447,56,36,5,-20
-42.02837,-20.76447,58,37,5,-21
-42.02545,-20.76447,55,33,5,-22
-42.02275,-20.76447,53,38,5,-15
-42.02005,-20.76447,52,33,5,-19
-42.01713,-20.76447,45,36,0,-9
-42.01444,-20.76447,57,37,5,-20
-42.01174,-20.76447,52,41,0,-11
-42.00882,-20.76447,66,36,5,-30
-42.00612,-20.76447,61,40,0,-21
-42.00342,-20.76447,53,41,5,-12
-42.0005,-20.76447,57,35,5,-22
-41.99781,-20.76447,59,34,5,-25
-41.99511,-20.76447,68,31,5,-37
-41.99219,-20.76447,60,42,0,-18
-41.98949,-20.76447,70,39,0,-31
-41.98657,-20.76447,63,43,0,-20
-41.98387,-20.76447,60,31,0,-29
-41.98118,-20.76447,59,49,0,-10
-41.97826,-20.76447,58,50,5,-8
-41.97556,-20.76447,66,37,11,-29
-41.97286,-20.76447,57,41,5,-16
-41.96994,-20.76447,70,31,5,-39
-42.1005,-20.76426,66,25,5,-41
-42.0978,-20.76426,66,27,5,-39
-42.09511,-20.76426,63,26,5,-37
-42.09219,-20.76426,58,30,5,-28
-42.08949,-20.76426,67,28,5,-39
-42.08657,-20.76426,64,34,5,-30
-42.08387,-20.76426,55,29,5,-26
-42.08118,-20.76426,61,31,5,-30
-42.07825,-20.76426,62,34,5,-28
-42.07556,-20.76426,64,37,5,-27
-42.07286,-20.76426,59,32,5,-27
-42.06994,-20.76426,59,38,5,-21
-42.06724,-20.76426,56,35,0,-21
-42.06455,-20.76426,56,27,5,-29
-42.06163,-20.76426,61,32,5,-29
-42.05893,-20.76426,55,34,5,-21
-42.05601,-20.76426,54,35,11,-19
-42.05331,-20.76426,52,31,5,-21
-42.05061,-20.76426,48,40,0,-8
-42.04769,-20.76426,48,29,5,-19
-42.045,-20.76426,42,39,0,-3
-42.0423,-20.76426,51,36,5,-15
-42.03938,-20.76426,45,33,5,-12
-42.03668,-20.76426,48,35,5,-13
-42.03399,-20.76426,43,32,5,-11
-42.03106,-20.76426,57,36,5,-21
-42.02837,-20.76426,59,37,5,-22
-42.02545,-20.76426,56,43,5,-13
-42.02275,-20.76426,50,40,5,-10
-42.02005,-20.76426,53,34,5,-19
-42.01713,-20.76426,45,36,0,-9
-42.01444,-20.76426,59,37,5,-22
-42.01174,-20.76426,52,41,0,-11
-42.00882,-20.76426,65,36,5,-29
-42.00612,-20.76426,63,40,0,-23
-42.00342,-20.76426,54,41,11,-13
-42.0005,-20.76426,57,33,5,-24
-41.99781,-20.76426,59,34,0,-25
-41.99511,-20.76426,62,30,5,-32
-41.99219,-20.76426,60,42,0,-18
-41.98949,-20.76426,70,38,0,-32
-41.98657,-20.76426,61,43,0,-18
-41.98387,-20.76426,60,33,0,-27
-41.98118,-20.76426,59,50,0,-9
-41.97826,-20.76426,58,50,11,-8
-41.97556,-20.76426,58,37,0,-21
-41.97286,-20.76426,57,46,5,-11
-41.96994,-20.76426,70,31,5,-39
-42.1005,-20.76383,66,25,5,-41
-42.0978,-20.76383,62,28,5,-34
-42.09511,-20.76383,62,26,5,-36
-42.09219,-20.76383,59,31,5,-28
-42.08949,-20.76383,67,28,5,-39
-42.08657,-20.76383,64,32,5,-32
-42.08387,-20.76383,54,27,5,-27
-42.08118,-20.76383,60,31,5,-29
-42.07825,-20.76383,61,33,5,-28
-42.07556,-20.76383,64,37,5,-27
-42.07286,-20.76383,57,32,5,-25
-42.06994,-20.76383,64,40,5,-24
-42.06724,-20.76383,57,33,0,-24
-42.06455,-20.76383,56,27,11,-29
-42.06163,-20.76383,57,30,5,-27
-42.05893,-20.76383,55,33,5,-22
-42.05601,-20.76383,54,34,5,-20
-42.05331,-20.76383,52,31,5,-21
-42.05061,-20.76383,49,41,0,-8
-42.04769,-20.76383,48,27,0,-21
-42.045,-20.76383,44,34,0,-10
-42.0423,-20.76383,47,36,5,-11
-42.03938,-20.76383,46,32,5,-14
-42.03668,-20.76383,48,34,5,-14
-42.03399,-20.76383,43,36,5,-7
-42.03106,-20.76383,57,43,5,-14
-42.02837,-20.76383,61,39,5,-22
-42.02545,-20.76383,58,43,0,-15
-42.02275,-20.76383,48,43,5,-5
-42.02005,-20.76383,54,34,5,-20
-42.01713,-20.76383,45,36,0,-9
-42.01444,-20.76383,60,36,5,-24
-42.01174,-20.76383,52,39,5,-13
-42.00882,-20.76383,55,35,5,-20
-42.00612,-20.76383,64,39,0,-25
-42.00342,-20.76383,54,41,5,-13
-42.0005,-20.76383,58,36,5,-22
-41.99781,-20.76383,59,35,0,-24
-41.99511,-20.76383,58,22,5,-36
-41.99219,-20.76383,60,38,0,-22
-41.98949,-20.76383,72,36,0,-36
-41.98657,-20.76383,61,43,0,-18
-41.98387,-20.76383,60,33,0,-27
-41.98118,-20.76383,58,51,0,-7
-41.97826,-20.76383,58,50,5,-8
-41.97556,-20.76383,58,41,0,-17
-41.97286,-20.76383,57,45,5,-12
-41.96994,-20.76383,70,34,0,-36
-42.1005,-20.76362,66,25,5,-41
-42.0978,-20.76362,65,27,5,-38
-42.09511,-20.76362,55,27,5,-28
-42.09219,-20.76362,59,31,5,-28
-42.08949,-20.76362,66,28,5,-38
-42.08657,-20.76362,60,34,5,-26
-42.08387,-20.76362,53,29,5,-24
-42.08118,-20.76362,60,31,5,-29
-42.07825,-20.76362,61,34,5,-27
-42.07556,-20.76362,64,37,5,-27
-42.07286,-20.76362,56,33,5,-23
-42.06994,-20.76362,62,40,5,-22
-42.06724,-20.76362,57,33,0,-24
-42.06455,-20.76362,56,27,11,-29
-42.06163,-20.76362,56,30,5,-26
-42.05893,-20.76362,56,34,5,-22
-42.05601,-20.76362,54,34,5,-20
-42.05331,-20.76362,52,31,5,-21
-42.05061,-20.76362,50,41,0,-9
-42.04769,-20.76362,50,17,0,-33
-42.045,-20.76362,45,33,0,-12
-42.0423,-20.76362,47,36,5,-11
-42.03938,-20.76362,47,33,5,-14
-42.03668,-20.76362,47,33,5,-14
-42.03399,-20.76362,44,34,5,-10
-42.03106,-20.76362,57,44,0,-13
-42.02837,-20.76362,60,42,5,-18
-42.02545,-20.76362,59,43,0,-16
-42.02275,-20.76362,49,43,5,-6
-42.02005,-20.76362,55,34,5,-21
-42.01713,-20.76362,57,35,0,-22
-42.01444,-20.76362,61,36,5,-25
-42.01174,-20.76362,52,37,5,-15
-42.00882,-20.76362,52,35,5,-17
-42.00612,-20.76362,63,39,0,-24
-42.00342,-20.76362,54,35,5,-19
-42.0005,-20.76362,58,37,5,-21
-41.99781,-20.76362,60,36,0,-24
-41.99511,-20.76362,59,18,5,-41
-41.99219,-20.76362,60,34,0,-26
-41.98949,-20.76362,70,33,0,-37
-41.98657,-20.76362,61,43,0,-18
-41.98387,-20.76362,60,33,0,-27
-41.98118,-20.76362,59,51,0,-8
-41.97826,-20.76362,58,50,5,-8
-41.97556,-20.76362,58,42,0,-16
-41.97286,-20.76362,57,43,5,-14
-41.96994,-20.76362,70,33,0,-37
-42.1005,-20.76341,66,25,5,-41
-42.0978,-20.76341,65,27,5,-38
-42.09511,-20.76341,56,27,5,-29
-42.09219,-20.76341,61,37,5,-24
-42.08949,-20.76341,66,28,5,-38
-42.08657,-20.76341,55,34,5,-21
-42.08387,-20.76341,54,30,5,-24
-42.08118,-20.76341,60,31,5,-29
-42.07825,-20.76341,61,37,5,-24
-42.07556,-20.76341,65,36,5,-29
-42.07286,-20.76341,56,32,5,-24
-42.06994,-20.76341,57,40,5,-17
-42.06724,-20.76341,57,31,0,-26
-42.06455,-20.76341,56,28,11,-28
-42.06163,-20.76341,56,30,5,-26
-42.05893,-20.76341,56,34,5,-22
-42.05601,-20.76341,54,37,5,-17
-42.05331,-20.76341,52,31,5,-21
-42.05061,-20.76341,50,41,0,-9
-42.04769,-20.76341,50,26,0,-24
-42.045,-20.76341,47,31,0,-16
-42.0423,-20.76341,48,36,5,-12
-42.03938,-20.76341,48,33,5,-15
-42.03668,-20.76341,47,33,5,-14
-42.03399,-20.76341,45,34,5,-11
-42.03106,-20.76341,57,44,0,-13
-42.02837,-20.76341,60,42,5,-18
-42.02545,-20.76341,57,42,0,-15
-42.02275,-20.76341,49,43,0,-6
-42.02005,-20.76341,57,34,5,-23
-42.01713,-20.76341,45,33,0,-12
-42.01444,-20.76341,61,36,5,-25
-42.01174,-20.76341,53,37,5,-16
-42.00882,-20.76341,52,35,5,-17
-42.00612,-20.76341,63,37,5,-26
-42.00342,-20.76341,54,35,5,-19
-42.0005,-20.76341,60,36,5,-24
-41.99781,-20.76341,60,36,0,-24
-41.99511,-20.76341,59,21,5,-38
-41.99219,-20.76341,60,31,0,-29
-41.98949,-20.76341,70,33,0,-37
-41.98657,-20.76341,62,42,0,-20
-41.98387,-20.76341,62,33,0,-29
-41.98118,-20.76341,59,50,0,-9
-41.97826,-20.76341,61,49,5,-12
-41.97556,-20.76341,62,49,0,-13
-41.97286,-20.76341,64,35,5,-29
-41.96994,-20.76341,70,35,0,-35
-42.1005,-20.76299,65,25,5,-40
-42.0978,-20.76299,56,26,5,-30
-42.09511,-20.76299,56,27,5,-29
-42.09219,-20.76299,63,37,0,-26
-42.08949,-20.76299,67,28,5,-39
-42.08657,-20.76299,52,34,0,-18
-42.08387,-20.76299,54,29,5,-25
-42.08118,-20.76299,60,31,5,-29
-42.07825,-20.76299,61,37,5,-24
-42.07556,-20.76299,65,38,5,-27
-42.07286,-20.76299,63,32,5,-31
-42.06994,-20.76299,57,40,0,-17
-42.06724,-20.76299,62,25,0,-37
-42.06455,-20.76299,56,28,5,-28
-42.06163,-20.76299,56,31,5,-25
-42.05893,-20.76299,56,33,5,-23
-42.05601,-20.76299,54,39,0,-15
-42.05331,-20.76299,52,32,5,-20
-42.05061,-20.76299,50,41,0,-9
-42.04769,-20.76299,52,26,5,-26
-42.045,-20.76299,49,25,0,-24
-42.0423,-20.76299,48,36,5,-12
-42.03938,-20.76299,49,33,5,-16
-42.03668,-20.76299,47,34,5,-13
-42.03399,-20.76299,46,35,5,-11
-42.03106,-20.76299,59,44,0,-15
-42.02837,-20.76299,61,41,5,-20
-42.02545,-20.76299,53,41,0,-12
-42.02275,-20.76299,48,42,0,-6
-42.02005,-20.76299,58,35,5,-23
-42.01713,-20.76299,59,31,5,-28
-42.01444,-20.76299,62,36,5,-26
-42.01174,-20.76299,53,36,5,-17
-42.00882,-20.76299,52,35,5,-17
-42.00612,-20.76299,64,34,5,-30
-42.00342,-20.76299,55,36,5,-19
-42.0005,-20.76299,60,35,5,-25
-41.99781,-20.76299,60,37,0,-23
-41.99511,-20.76299,59,24,0,-35
-41.99219,-20.76299,60,33,0,-27
-41.98949,-20.76299,71,36,0,-35
-41.98657,-20.76299,62,43,0,-19
-41.98387,-20.76299,64,43,0,-21
-41.98118,-20.76299,59,50,0,-9
-41.97826,-20.76299,65,49,0,-16
-41.97556,-20.76299,63,50,0,-13
-41.97286,-20.76299,68,35,5,-33
-41.96994,-20.76299,69,35,0,-34
-42.1005,-20.76278,62,29,5,-33
-42.0978,-20.76278,56,26,5,-30
-42.09511,-20.76278,57,27,5,-30
-42.09219,-20.76278,63,37,5,-26
-42.08949,-20.76278,66,28,5,-38
-42.08657,-20.76278,52,34,0,-18
-42.08387,-20.76278,54,29,5,-25
-42.08118,-20.76278,59,29,5,-30
-42.07825,-20.76278,61,35,5,-26
-42.07556,-20.76278,67,38,5,-29
-42.07286,-20.76278,63,32,5,-31
-42.06994,-20.76278,57,39,0,-18
-42.06724,-20.76278,57,19,0,-38
-42.06455,-20.76278,56,28,5,-28
-42.06163,-20.76278,56,31,5,-25
-42.05893,-20.76278,57,33,5,-24
-42.05601,-20.76278,54,39,0,-15
-42.05331,-20.76278,52,38,5,-14
-42.05061,-20.76278,52,41,0,-11
-42.04769,-20.76278,53,26,5,-27
-42.045,-20.76278,50,25,5,-25
-42.0423,-20.76278,49,33,5,-16
-42.03938,-20.76278,50,33,5,-17
-42.03668,-20.76278,48,33,5,-15
-42.03399,-20.76278,46,34,5,-12
-42.03106,-20.76278,55,44,0,-11
-42.02837,-20.76278,60,41,0,-19
-42.02545,-20.76278,49,41,0,-8
-42.02275,-20.76278,48,42,0,-6
-42.02005,-20.76278,60,42,5,-18
-42.01713,-20.76278,46,31,5,-15
-42.01444,-20.76278,62,36,5,-26
-42.01174,-20.76278,53,36,5,-17
-42.00882,-20.76278,52,35,5,-17
-42.00612,-20.76278,63,35,5,-28
-42.00342,-20.76278,55,37,5,-18
-42.0005,-20.76278,59,35,5,-24
-41.99781,-20.76278,60,42,0,-18
-41.99511,-20.76278,59,24,0,-35
-41.99219,-20.76278,60,33,0,-27
-41.98949,-20.76278,71,40,0,-31
-41.98657,-20.76278,62,42,0,-20
-41.98387,-20.76278,68,43,0,-25
-41.98118,-20.76278,59,50,0,-9
-41.97826,-20.76278,68,49,0,-19
-41.97556,-20.76278,66,50,0,-16
-41.97286,-20.76278,71,35,5,-36
-41.96994,-20.76278,68,34,0,-34
-42.1005,-20.76257,62,32,5,-30
-42.0978,-20.76257,57,27,5,-30
-42.09511,-20.76257,60,28,5,-32
-42.09219,-20.76257,63,31,5,-32
-42.08949,-20.76257,65,29,5,-36
-42.08657,-20.76257,59,34,0,-25
-42.08387,-20.76257,54,28,5,-26
-42.08118,-20.76257,59,31,5,-28
-42.07825,-20.76257,61,35,5,-26
-42.07556,-20.76257,66,36,5,-30
-42.07286,-20.76257,56,33,5,-23
-42.06994,-20.76257,61,39,0,-22
-42.06724,-20.76257,57,18,0,-39
-42.06455,-20.76257,57,28,5,-29
-42.06163,-20.76257,56,31,5,-25
-42.05893,-20.76257,56,33,5,-23
-42.05601,-20.76257,55,39,0,-16
-42.05331,-20.76257,51,38,5,-13
-42.05061,-20.76257,52,40,0,-12
-42.04769,-20.76257,53,26,5,-27
-42.045,-20.76257,50,27,5,-23
-42.0423,-20.76257,50,33,5,-17
-42.03938,-20.76257,51,33,5,-18
-42.03668,-20.76257,48,33,5,-15
-42.03399,-20.76257,42,36,5,-6
-42.03106,-20.76257,53,44,0,-9
-42.02837,-20.76257,55,41,0,-14
-42.02545,-20.76257,48,41,0,-7
-42.02275,-20.76257,48,42,0,-6
-42.02005,-20.76257,61,42,0,-19
-42.01713,-20.76257,46,32,5,-14
-42.01444,-20.76257,62,38,5,-24
-42.01174,-20.76257,54,36,5,-18
-42.00882,-20.76257,52,35,5,-17
-42.00612,-20.76257,61,34,5,-27
-42.00342,-20.76257,55,36,5,-19
-42.0005,-20.76257,60,36,5,-24
-41.99781,-20.76257,60,39,0,-21
-41.99511,-20.76257,60,20,0,-40
-41.99219,-20.76257,60,33,0,-27
-41.98949,-20.76257,70,43,0,-27
-41.98657,-20.76257,61,40,0,-21
-41.98387,-20.76257,68,43,0,-25
-41.98118,-20.76257,60,50,0,-10
-41.97826,-20.76257,62,49,0,-13
-41.97556,-20.76257,67,50,0,-17
-41.97286,-20.76257,68,34,5,-34
-41.96994,-20.76257,67,33,5,-34
-42.10297,-20.76214,60,33,5,-27
-42.10275,-20.76214,62,32,5,-30
-42.10252,-20.76214,61,32,5,-29
-42.1023,-20.76214,58,32,5,-26
-42.10185,-20.76214,58,32,5,-26
-42.10163,-20.76214,58,32,0,-26
-42.1014,-20.76214,58,32,0,-26
-42.10118,-20.76214,59,32,0,-27
-42.10073,-20.76214,60,32,0,-28
-42.1005,-20.76214,60,32,0,-28
-42.10028,-20.76214,61,32,0,-29
-42.10005,-20.76214,63,32,0,-31
-42.09983,-20.76214,66,32,0,-34
-42.09938,-20.76214,67,32,0,-35
-42.09915,-20.76214,69,32,0,-37
-42.09893,-20.76214,69,28,0,-41
-42.0987,-20.76214,66,26,5,-40
-42.09825,-20.76214,66,25,5,-41
-42.09803,-20.76214,64,26,5,-38
-42.0978,-20.76214,57,26,5,-31
-42.09758,-20.76214,57,27,5,-30
-42.09713,-20.76214,57,27,5,-30
-42.09691,-20.76214,57,28,5,-29
-42.09668,-20.76214,57,28,5,-29
-42.09646,-20.76214,57,28,5,-29
-42.09601,-20.76214,57,28,5,-29
-42.09578,-20.76214,59,27,5,-32
-42.09556,-20.76214,60,27,5,-33
-42.09533,-20.76214,60,28,5,-32
-42.09511,-20.76214,62,28,5,-34
-42.09466,-20.76214,64,26,5,-38
-42.09443,-20.76214,64,26,5,-38
-42.09421,-20.76214,65,26,5,-39
-42.09398,-20.76214,66,26,5,-40
-42.09354,-20.76214,65,28,5,-37
-42.09331,-20.76214,64,29,5,-35
-42.09309,-20.76214,59,30,5,-29
-42.09286,-20.76214,59,30,5,-29
-42.09241,-20.76214,63,32,5,-31
-42.09219,-20.76214,65,31,5,-34
-42.09196,-20.76214,63,31,5,-32
-42.09174,-20.76214,63,31,5,-32
-42.09129,-20.76214,65,33,5,-32
-42.09106,-20.76214,66,33,5,-33
-42.09084,-20.76214,67,30,5,-37
-42.09061,-20.76214,69,29,5,-40
-42.09039,-20.76214,67,29,5,-38
-42.08994,-20.76214,68,29,5,-39
-42.08972,-20.76214,66,28,5,-38
-42.08949,-20.76214,60,29,5,-31
-42.08927,-20.76214,64,35,5,-29
-42.08882,-20.76214,60,37,0,-23
-42.08859,-20.76214,59,37,0,-22
-42.08837,-20.76214,60,37,0,-23
-42.08814,-20.76214,56,37,0,-19
-42.08769,-20.76214,60,36,0,-24
-42.08747,-20.76214,53,36,0,-17
-42.08724,-20.76214,56,35,5,-21
-42.08702,-20.76214,60,31,5,-29
-42.08657,-20.76214,56,30,5,-26
-42.08634,-20.76214,58,30,5,-28
-42.08612,-20.76214,52,30,5,-22
-42.08589,-20.76214,52,30,5,-22
-42.08545,-20.76214,52,29,5,-23
-42.08522,-20.76214,52,31,5,-21
-42.085,-20.76214,52,31,5,-21
-42.08477,-20.76214,52,31,5,-21
-42.08455,-20.76214,53,30,5,-23
-42.0841,-20.76214,54,28,5,-26
-42.08387,-20.76214,54,28,5,-26
-42.08365,-20.76214,55,30,5,-25
-42.08342,-20.76214,55,30,5,-25
-42.08297,-20.76214,55,27,5,-28
-42.08275,-20.76214,56,29,5,-27
-42.08252,-20.76214,56,29,5,-27
-42.0823,-20.76214,57,28,5,-29
-42.08185,-20.76214,57,29,5,-28
-42.08163,-20.76214,58,29,5,-29
-42.0814,-20.76214,58,30,5,-28
-42.08118,-20.76214,59,33,5,-26
-42.08073,-20.76214,59,33,5,-26
-42.0805,-20.76214,60,33,5,-27
-42.08028,-20.76214,61,34,5,-27
-42.08005,-20.76214,61,33,5,-28
-42.07983,-20.76214,66,33,5,-33
-42.07938,-20.76214,66,35,5,-31
-42.07915,-20.76214,61,36,5,-25
-42.07893,-20.76214,62,35,5,-27
-42.0787,-20.76214,61,35,5,-26
-42.07825,-20.76214,61,37,5,-24
-42.07803,-20.76214,61,37,5,-24
-42.07781,-20.76214,62,37,5,-25
-42.07758,-20.76214,63,36,5,-27
-42.07713,-20.76214,64,38,5,-26
-42.07691,-20.76214,65,34,5,-31
-42.07668,-20.76214,66,34,5,-32
-42.07646,-20.76214,65,34,5,-31
-42.07601,-20.76214,65,35,5,-30
-42.07578,-20.76214,67,34,5,-33
-42.07556,-20.76214,66,34,5,-32
-42.07533,-20.76214,64,33,5,-31
-42.07511,-20.76214,66,32,5,-34
-42.07466,-20.76214,67,32,5,-35
-42.07443,-20.76214,63,32,5,-31
-42.07421,-20.76214,63,32,5,-31
-42.07399,-20.76214,56,33,5,-23
-42.07354,-20.76214,56,34,5,-22
-42.07331,-20.76214,56,34,5,-22
-42.07309,-20.76214,56,35,5,-21
-42.07286,-20.76214,56,38,5,-18
-42.07241,-20.76214,56,38,5,-18
-42.07219,-20.76214,61,38,5,-23
-42.07196,-20.76214,57,38,5,-19
-42.07174,-20.76214,57,38,5,-19
-42.07129,-20.76214,57,39,5,-18
-42.07106,-20.76214,57,39,0,-18
-42.07084,-20.76214,57,39,0,-18
-42.07061,-20.76214,57,39,0,-18
-42.07039,-20.76214,57,39,0,-18
-42.06994,-20.76214,61,39,0,-22
-42.06972,-20.76214,57,39,0,-18
-42.06949,-20.76214,57,39,0,-18
-42.06927,-20.76214,57,39,0,-18
-42.06882,-20.76214,57,38,0,-19
-42.06859,-20.76214,57,37,0,-20
-42.06837,-20.76214,57,36,5,-21
-42.06814,-20.76214,57,30,5,-27
-42.06769,-20.76214,57,19,5,-38
-42.06747,-20.76214,57,20,5,-37
-42.06724,-20.76214,57,14,5,-43
-42.06702,-20.76214,57,23,5,-34
-42.06657,-20.76214,57,23,5,-34
-42.06634,-20.76214,57,24,5,-33
-42.06612,-20.76214,57,26,5,-31
-42.0659,-20.76214,58,27,5,-31
-42.06545,-20.76214,58,26,5,-32
-42.06522,-20.76214,57,25,5,-32
-42.065,-20.76214,57,25,5,-32
-42.06477,-20.76214,61,27,5,-34
-42.06455,-20.76214,57,28,5,-29
-42.0641,-20.76214,57,29,5,-28
-42.06387,-20.76214,62,30,5,-32
-42.06365,-20.76214,57,30,5,-27
-42.06342,-20.76214,57,30,5,-27
-42.06297,-20.76214,57,32,5,-25
-42.06275,-20.76214,57,32,5,-25
-42.06252,-20.76214,57,31,5,-26
-42.0623,-20.76214,57,31,5,-26
-42.06185,-20.76214,57,32,5,-25
-42.06163,-20.76214,57,32,5,-25
-42.0614,-20.76214,56,32,5,-24
-42.06118,-20.76214,56,32,5,-24
-42.06073,-20.76214,56,32,5,-24
-42.0605,-20.76214,56,32,5,-24
-42.06028,-20.76214,56,32,5,-24
-42.06005,-20.76214,56,32,5,-24
-42.05983,-20.76214,56,33,5,-23
-42.05938,-20.76214,56,33,5,-23
-42.05915,-20.76214,56,33,5,-23
-42.05893,-20.76214,56,33,5,-23
-42.0587,-20.76214,56,34,5,-22
-42.05826,-20.76214,56,34,5,-22
-42.05803,-20.76214,56,35,5,-21
-42.05781,-20.76214,55,36,5,-19
-42.05758,-20.76214,55,38,5,-17
-42.05713,-20.76214,55,39,5,-16
-42.05691,-20.76214,55,39,5,-16
-42.05668,-20.76214,55,39,5,-16
-42.05646,-20.76214,55,37,5,-18
-42.05601,-20.76214,55,37,5,-18
-42.05578,-20.76214,54,36,5,-18
-42.05556,-20.76214,58,35,5,-23
-42.05533,-20.76214,62,32,5,-30
-42.05511,-20.76214,61,33,5,-28
-42.05466,-20.76214,58,33,5,-25
-42.05443,-20.76214,54,35,5,-19
-42.05421,-20.76214,52,37,5,-15
-42.05399,-20.76214,52,38,0,-14
-42.05354,-20.76214,51,38,0,-13
-42.05331,-20.76214,52,38,0,-14
-42.05309,-20.76214,52,38,0,-14
-42.05286,-20.76214,52,40,0,-12
-42.05241,-20.76214,52,40,0,-12
-42.05219,-20.76214,52,40,0,-12
-42.05196,-20.76214,52,40,0,-12
-42.05174,-20.76214,53,40,0,-13
-42.05129,-20.76214,53,40,0,-13
-42.05106,-20.76214,53,41,0,-12
-42.05084,-20.76214,52,40,0,-12
-42.05061,-20.76214,52,40,0,-12
-42.05039,-20.76214,51,39,0,-12
-42.04994,-20.76214,51,37,0,-14
-42.04972,-20.76214,51,27,0,-24
-42.04949,-20.76214,51,25,0,-26
-42.04927,-20.76214,51,32,0,-19
-42.04882,-20.76214,51,31,0,-20
-42.04859,-20.76214,52,27,0,-25
-42.04837,-20.76214,53,27,5,-26
-42.04814,-20.76214,53,27,5,-26
-42.04769,-20.76214,53,27,5,-26
-42.04747,-20.76214,54,27,5,-27
-42.04724,-20.76214,53,27,5,-26
-42.04702,-20.76214,53,27,5,-26
-42.04657,-20.76214,53,29,5,-24
-42.04635,-20.76214,54,29,5,-25
-42.04612,-20.76214,53,29,5,-24
-42.0459,-20.76214,52,29,11,-23
-42.04545,-20.76214,52,29,11,-23
-42.04522,-20.76214,51,29,11,-22
-42.045,-20.76214,51,29,11,-22
-42.04477,-20.76214,51,25,5,-26
-42.04455,-20.76214,50,27,5,-23
-42.0441,-20.76214,50,31,5,-19
-42.04387,-20.76214,49,31,5,-18
-42.04365,-20.76214,49,32,5,-17
-42.04342,-20.76214,50,34,5,-16
-42.04297,-20.76214,50,34,5,-16
-42.04275,-20.76214,50,34,5,-16
-42.04253,-20.76214,51,33,5,-18
-42.0423,-20.76214,52,33,5,-19
-42.04185,-20.76214,52,33,5,-19
-42.04163,-20.76214,52,33,5,-19
-42.0414,-20.76214,52,34,5,-18
-42.04118,-20.76214,52,34,5,-18
-42.04073,-20.76214,52,32,5,-20
-42.0405,-20.76214,52,32,5,-20
-42.04028,-20.76214,52,32,5,-20
-42.04005,-20.76214,52,32,5,-20
-42.03983,-20.76214,52,33,5,-19
-42.03938,-20.76214,51,33,5,-18
-42.03915,-20.76214,51,33,5,-18
-42.03893,-20.76214,51,32,5,-19
-42.0387,-20.76214,50,32,5,-18
-42.03826,-20.76214,47,32,5,-15
-42.03803,-20.76214,43,32,5,-11
-42.03781,-20.76214,42,32,5,-10
-42.03758,-20.76214,45,32,5,-13
-42.03713,-20.76214,47,32,5,-15
-42.03691,-20.76214,49,32,5,-17
-42.03668,-20.76214,49,33,5,-16
-42.03646,-20.76214,49,33,5,-16
-42.03601,-20.76214,49,33,5,-16
-42.03578,-20.76214,49,34,5,-15
-42.03556,-20.76214,49,35,5,-14
-42.03533,-20.76214,49,34,5,-15
-42.03511,-20.76214,48,34,5,-14
-42.03466,-20.76214,47,35,5,-12
-42.03444,-20.76214,45,35,5,-10
-42.03421,-20.76214,43,35,5,-8
-42.03399,-20.76214,42,38,5,-4
-42.03354,-20.76214,42,40,5,-2
-42.03331,-20.76214,41,40,5,-1
-42.03309,-20.76214,39,40,0,1
-42.03286,-20.76214,39,43,0,4
-42.03241,-20.76214,38,43,0,5
-42.03219,-20.76214,36,43,0,7
-42.03196,-20.76214,41,42,0,1
-42.03174,-20.76214,47,43,0,-4
-42.03129,-20.76214,50,44,0,-6
-42.03106,-20.76214,54,43,0,-11
-42.03084,-20.76214,55,43,0,-12
-42.03062,-20.76214,55,43,0,-12
-42.03017,-20.76214,54,43,0,-11
-42.02994,-20.76214,54,43,0,-11
-42.02972,-20.76214,53,42,0,-11
-42.02949,-20.76214,53,42,0,-11
-42.02927,-20.76214,53,41,0,-12
-42.02882,-20.76214,54,41,0,-13
-42.02859,-20.76214,54,40,0,-14
-42.02837,-20.76214,53,39,0,-14
-42.02814,-20.76214,50,40,0,-10
-42.02769,-20.76214,44,40,0,-4
-42.02747,-20.76214,42,40,0,-2
-42.02724,-20.76214,44,40,0,-4
-42.02702,-20.76214,43,41,0,-2
-42.02657,-20.76214,43,41,0,-2
-42.02635,-20.76214,45,41,0,-4
-42.02612,-20.76214,45,41,0,-4
-42.0259,-20.76214,46,41,0,-5
-42.02545,-20.76214,48,41,0,-7
-42.02522,-20.76214,50,40,0,-10
-42.025,-20.76214,50,41,0,-9
-42.02477,-20.76214,50,41,0,-9
-42.02455,-20.76214,51,41,0,-10
-42.0241,-20.76214,51,41,11,-10
-42.02387,-20.76214,51,41,0,-10
-42.02365,-20.76214,51,41,0,-10
-42.02342,-20.76214,50,41,0,-9
-42.02297,-20.76214,49,41,0,-8
-42.02275,-20.76214,52,41,0,-11
-42.02253,-20.76214,50,41,0,-9
-42.0223,-20.76214,49,41,0,-8
-42.02185,-20.76214,51,41,0,-10
-42.02163,-20.76214,54,41,0,-13
-42.0214,-20.76214,56,41,11,-15
-42.02118,-20.76214,59,41,0,-18
-42.02073,-20.76214,59,41,0,-18
-42.0205,-20.76214,59,42,0,-17
-42.02028,-20.76214,61,42,0,-19
-42.02005,-20.76214,61,42,0,-19
-42.01983,-20.76214,60,42,5,-18
-42.01938,-20.76214,61,43,5,-18
-42.01915,-20.76214,62,43,5,-19
-42.01893,-20.76214,62,43,5,-19
-42.01871,-20.76214,62,43,5,-19
-42.01826,-20.76214,62,33,5,-29
-42.01803,-20.76214,59,33,5,-26
-42.01781,-20.76214,50,33,5,-17
-42.01758,-20.76214,46,33,5,-13
-42.01713,-20.76214,47,39,5,-8
-42.01691,-20.76214,47,39,5,-8
-42.01668,-20.76214,48,40,5,-8
-42.01646,-20.76214,48,41,5,-7
-42.01601,-20.76214,49,45,5,-4
-42.01578,-20.76214,49,40,5,-9
-42.01556,-20.76214,60,40,5,-20
-42.01533,-20.76214,63,40,5,-23
-42.01511,-20.76214,61,42,5,-19
-42.01466,-20.76214,64,43,5,-21
-42.01444,-20.76214,62,39,5,-23
-42.01421,-20.76214,63,39,5,-24
-42.01399,-20.76214,63,39,5,-24
-42.01354,-20.76214,62,39,5,-23
-42.01331,-20.76214,62,38,5,-24
-42.01309,-20.76214,58,38,5,-20
-42.01286,-20.76214,56,38,5,-18
-42.01241,-20.76214,54,38,5,-16
-42.01219,-20.76214,55,38,5,-17
-42.01196,-20.76214,56,38,5,-18
-42.01174,-20.76214,54,38,5,-16
-42.01129,-20.76214,53,37,5,-16
-42.01106,-20.76214,53,37,5,-16
-42.01084,-20.76214,53,36,5,-17
-42.01062,-20.76214,52,36,5,-16
-42.01017,-20.76214,52,35,5,-17
-42.00994,-20.76214,52,35,5,-17
-42.00972,-20.76214,52,35,5,-17
-42.00949,-20.76214,52,35,5,-17
-42.00927,-20.76214,52,36,5,-16
-42.00882,-20.76214,52,36,5,-16
-42.00859,-20.76214,52,36,5,-16
-42.00837,-20.76214,52,37,5,-15
-42.00814,-20.76214,53,42,5,-11
-42.00769,-20.76214,53,42,0,-11
-42.00747,-20.76214,53,42,0,-11
-42.00724,-20.76214,53,41,0,-12
-42.00702,-20.76214,53,39,0,-14
-42.00657,-20.76214,53,39,5,-14
-42.00635,-20.76214,54,37,5,-17
-42.00612,-20.76214,55,36,5,-19
-42.0059,-20.76214,56,35,5,-21
-42.00545,-20.76214,56,35,5,-21
-42.00522,-20.76214,56,35,5,-21
-42.005,-20.76214,56,35,5,-21
-42.00477,-20.76214,56,35,5,-21
-42.00455,-20.76214,56,36,5,-20
-42.0041,-20.76214,56,41,11,-15
-42.00387,-20.76214,56,42,5,-14
-42.00365,-20.76214,56,39,5,-17
-42.00342,-20.76214,57,39,5,-18
-42.00298,-20.76214,57,37,5,-20
-42.00275,-20.76214,57,37,5,-20
-42.00253,-20.76214,58,37,5,-21
-42.0023,-20.76214,58,37,5,-21
-42.00185,-20.76214,61,36,5,-25
-42.00163,-20.76214,63,36,5,-27
-42.0014,-20.76214,63,36,5,-27
-42.00118,-20.76214,62,36,5,-26
-42.00073,-20.76214,61,37,5,-24
-42.0005,-20.76214,61,40,5,-21
-42.00028,-20.76214,60,40,5,-20
-42.00005,-20.76214,60,39,5,-21
-41.99983,-20.76214,60,40,5,-20
-41.99938,-20.76214,60,39,5,-21
-41.99916,-20.76214,60,41,5,-19
-41.99893,-20.76214,60,43,5,-17
-41.99871,-20.76214,61,48,0,-13
-41.99826,-20.76214,61,48,0,-13
-41.99803,-20.76214,61,48,0,-13
-41.99781,-20.76214,61,48,0,-13
-41.99758,-20.76214,61,46,0,-15
-41.99713,-20.76214,60,30,5,-30
-41.99691,-20.76214,61,28,5,-33
-41.99668,-20.76214,60,26,5,-34
-41.99646,-20.76214,60,25,5,-35
-41.99601,-20.76214,60,24,5,-36
-41.99578,-20.76214,60,23,5,-37
-41.99556,-20.76214,60,23,0,-37
-41.99533,-20.76214,60,23,0,-37
-41.99511,-20.76214,60,23,6,-37
-41.99466,-20.76214,60,22,5,-38
-41.99444,-20.76214,60,22,5,-38
-41.99421,-20.76214,60,23,5,-37
-41.99399,-20.76214,60,23,5,-37
-41.99354,-20.76214,67,23,6,-44
-41.99331,-20.76214,67,23,0,-44
-41.99309,-20.76214,65,29,0,-36
-41.99286,-20.76214,67,30,0,-37
-41.99241,-20.76214,60,34,0,-26
-41.99219,-20.76214,60,33,0,-27
-41.99196,-20.76214,60,33,0,-27
-41.99174,-20.76214,60,34,0,-26
-41.99129,-20.76214,60,34,0,-26
-41.99107,-20.76214,60,37,0,-23
-41.99084,-20.76214,60,41,0,-19
-41.99062,-20.76214,65,41,0,-24
-41.99017,-20.76214,64,42,0,-22
-41.98994,-20.76214,70,43,0,-27
-41.98972,-20.76214,72,44,0,-28
-41.98949,-20.76214,69,44,0,-25
-41.98927,-20.76214,70,46,0,-24
-41.98882,-20.76214,71,46,0,-25
-41.98859,-20.76214,69,47,0,-22
-41.98837,-20.76214,64,46,0,-18
-41.98814,-20.76214,64,46,0,-18
-41.98769,-20.76214,64,43,0,-21
-41.98747,-20.76214,64,43,0,-21
-41.98725,-20.76214,62,43,0,-19
-41.98702,-20.76214,61,42,0,-19
-41.98657,-20.76214,61,36,0,-25
-41.98635,-20.76214,61,36,0,-25
-41.98612,-20.76214,61,37,0,-24
-41.9859,-20.76214,60,37,0,-23
-41.98545,-20.76214,62,38,0,-24
-41.98522,-20.76214,66,40,0,-26
-41.985,-20.76214,65,42,0,-23
-41.98477,-20.76214,68,42,11,-26
-41.98455,-20.76214,69,42,11,-27
-41.9841,-20.76214,70,43,11,-27
-41.98387,-20.76214,70,43,0,-27
-41.98365,-20.76214,68,45,0,-23
-41.98343,-20.76214,68,45,0,-23
-41.98298,-20.76214,68,46,0,-22
-41.98275,-20.76214,67,46,0,-21
-41.98253,-20.76214,66,50,0,-16
-41.9823,-20.76214,64,50,0,-14
-41.98185,-20.76214,63,50,0,-13
-41.98163,-20.76214,60,50,0,-10
-41.9814,-20.76214,60,50,0,-10
-41.98118,-20.76214,59,50,0,-9
-41.98073,-20.76214,68,49,0,-19
-41.9805,-20.76214,67,49,0,-18
-41.98028,-20.76214,63,49,0,-14
-41.98005,-20.76214,58,49,0,-9
-41.97983,-20.76214,58,49,0,-9
-41.97938,-20.76214,58,48,0,-10
-41.97916,-20.76214,58,48,0,-10
-41.97893,-20.76214,58,48,0,-10
-41.97871,-20.76214,61,48,0,-13
-41.97826,-20.76214,58,48,0,-10
-41.97803,-20.76214,58,49,0,-9
-41.97781,-20.76214,67,49,0,-18
-41.97758,-20.76214,68,48,5,-20
-41.97713,-20.76214,69,48,5,-21
-41.97691,-20.76214,69,49,5,-20
-41.97668,-20.76214,69,49,5,-20
-41.97646,-20.76214,70,49,0,-21
-41.97601,-20.76214,70,49,0,-21
-41.97578,-20.76214,69,49,0,-20
-41.97556,-20.76214,67,50,0,-17
-41.97534,-20.76214,67,50,0,-17
-41.97511,-20.76214,67,50,0,-17
-41.97466,-20.76214,66,50,0,-16
-41.97444,-20.76214,63,50,0,-13
-41.97421,-20.76214,60,50,0,-10
-41.97399,-20.76214,57,50,0,-7
-41.97354,-20.76214,57,35,5,-22
-41.97331,-20.76214,56,34,5,-22
-41.97309,-20.76214,56,34,5,-22
-41.97286,-20.76214,65,35,5,-30
-41.97241,-20.76214,72,37,0,-35
-41.97219,-20.76214,72,37,0,-35
-41.97196,-20.76214,71,37,0,-34
-41.97174,-20.76214,72,36,0,-36
-41.97129,-20.76214,71,37,0,-34
-41.97107,-20.76214,74,37,0,-37
-41.97084,-20.76214,70,37,0,-33
-41.97062,-20.76214,69,36,5,-33
-41.97017,-20.76214,67,31,5,-36
-41.96994,-20.76214,66,31,5,-35
-41.96972,-20.76214,64,31,5,-33
-41.96949,-20.76214,62,30,5,-32
-41.96927,-20.76214,61,31,5,-30
-42.1005,-20.76193,60,32,0,-28
-42.0978,-20.76193,57,30,5,-27
-42.09511,-20.76193,64,28,5,-36
-42.09219,-20.76193,63,31,5,-32
-42.08949,-20.76193,54,35,5,-19
-42.08657,-20.76193,52,30,5,-22
-42.08387,-20.76193,54,27,5,-27
-42.08118,-20.76193,58,32,5,-26
-42.07825,-20.76193,61,35,5,-26
-42.07556,-20.76193,66,34,5,-32
-42.07286,-20.76193,56,38,5,-18
-42.06994,-20.76193,57,39,0,-18
-42.06724,-20.76193,57,24,5,-33
-42.06455,-20.76193,57,28,5,-29
-42.06163,-20.76193,57,32,5,-25
-42.05893,-20.76193,56,34,5,-22
-42.05601,-20.76193,55,36,5,-19
-42.05331,-20.76193,52,36,0,-16
-42.05061,-20.76193,52,40,0,-12
-42.04769,-20.76193,54,27,5,-27
-42.045,-20.76193,52,27,5,-25
-42.0423,-20.76193,52,33,5,-19
-42.03938,-20.76193,51,33,5,-18
-42.03668,-20.76193,49,33,5,-16
-42.03399,-20.76193,43,44,5,1
-42.03106,-20.76193,54,43,0,-11
-42.02837,-20.76193,50,39,0,-11
-42.02545,-20.76193,50,40,0,-10
-42.02275,-20.76193,46,41,0,-5
-42.02005,-20.76193,63,42,0,-21
-42.01713,-20.76193,47,44,5,-3
-42.01444,-20.76193,61,43,5,-18
-42.01174,-20.76193,59,42,5,-17
-42.00882,-20.76193,52,38,5,-14
-42.00612,-20.76193,56,39,5,-17
-42.00342,-20.76193,58,39,5,-19
-42.0005,-20.76193,61,47,5,-14
-41.99781,-20.76193,61,48,0,-13
-41.99511,-20.76193,60,23,0,-37
-41.99219,-20.76193,60,38,0,-22
-41.98949,-20.76193,67,46,0,-21
-41.98657,-20.76193,61,35,0,-26
-41.98387,-20.76193,71,43,0,-28
-41.98118,-20.76193,60,49,0,-11
-41.97826,-20.76193,58,48,0,-10
-41.97556,-20.76193,69,49,0,-20
-41.97286,-20.76193,65,36,5,-29
-41.96994,-20.76193,65,31,5,-34
-42.1005,-20.76172,60,32,0,-28
-42.0978,-20.76172,57,33,0,-24
-42.09511,-20.76172,65,27,5,-38
-42.09219,-20.76172,58,30,5,-28
-42.08949,-20.76172,54,35,5,-19
-42.08657,-20.76172,53,32,5,-21
-42.08387,-20.76172,54,28,5,-26
-42.08118,-20.76172,58,32,5,-26
-42.07825,-20.76172,61,35,5,-26
-42.07556,-20.76172,64,34,5,-30
-42.07286,-20.76172,56,38,5,-18
-42.06994,-20.76172,57,39,0,-18
-42.06724,-20.76172,58,25,5,-33
-42.06455,-20.76172,58,28,5,-30
-42.06163,-20.76172,57,32,5,-25
-42.05893,-20.76172,56,34,5,-22
-42.05601,-20.76172,55,35,5,-20
-42.05331,-20.76172,54,36,0,-18
-42.05061,-20.76172,52,39,0,-13
-42.04769,-20.76172,54,27,5,-27
-42.045,-20.76172,53,28,5,-25
-42.0423,-20.76172,53,33,5,-20
-42.03938,-20.76172,52,33,5,-19
-42.03668,-20.76172,49,33,5,-16
-42.03399,-20.76172,44,44,5,0
-42.03106,-20.76172,45,43,0,-2
-42.02837,-20.76172,45,39,0,-6
-42.02545,-20.76172,51,40,0,-11
-42.02275,-20.76172,46,41,0,-5
-42.02005,-20.76172,61,42,0,-19
-42.01713,-20.76172,47,46,5,-1
-42.01444,-20.76172,60,52,5,-8
-42.01174,-20.76172,54,42,5,-12
-42.00882,-20.76172,52,42,5,-10
-42.00612,-20.76172,56,39,0,-17
-42.00342,-20.76172,63,43,5,-20
-42.0005,-20.76172,62,47,0,-15
-41.99781,-20.76172,61,48,0,-13
-41.99511,-20.76172,62,23,0,-39
-41.99219,-20.76172,61,39,0,-22
-41.98949,-20.76172,65,46,0,-19
-41.98657,-20.76172,61,34,0,-27
-41.98387,-20.76172,70,42,0,-28
-41.98118,-20.76172,59,49,0,-10
-41.97826,-20.76172,58,48,5,-10
-41.97556,-20.76172,70,50,0,-20
-41.97286,-20.76172,64,35,5,-29
-41.96994,-20.76172,63,32,5,-31
-42.1005,-20.7613,60,32,0,-28
-42.0978,-20.7613,57,33,0,-24
-42.09511,-20.7613,66,26,5,-40
-42.09219,-20.7613,57,31,5,-26
-42.08949,-20.7613,63,32,5,-31
-42.08657,-20.7613,61,31,5,-30
-42.08387,-20.7613,54,28,5,-26
-42.08118,-20.7613,58,30,5,-28
-42.07825,-20.7613,61,37,5,-24
-42.07556,-20.7613,62,35,5,-27
-42.07286,-20.7613,56,38,0,-18
-42.06994,-20.7613,57,39,0,-18
-42.06724,-20.7613,58,25,5,-33
-42.06455,-20.7613,58,29,5,-29
-42.06163,-20.7613,57,32,5,-25
-42.05893,-20.7613,56,34,5,-22
-42.05601,-20.7613,55,34,5,-21
-42.05331,-20.7613,55,34,5,-21
-42.05061,-20.7613,53,39,0,-14
-42.04769,-20.7613,55,30,5,-25
-42.045,-20.7613,53,30,5,-23
-42.0423,-20.7613,54,34,5,-20
-42.03938,-20.7613,49,33,5,-16
-42.03668,-20.7613,49,33,5,-16
-42.03399,-20.7613,46,42,5,-4
-42.03106,-20.7613,43,42,0,-1
-42.02837,-20.7613,43,39,0,-4
-42.02545,-20.7613,51,40,0,-11
-42.02275,-20.7613,47,41,0,-6
-42.02005,-20.7613,55,42,0,-13
-42.01713,-20.7613,49,53,0,4
-42.01444,-20.7613,58,52,5,-6
-42.01174,-20.7613,54,45,5,-9
-42.00882,-20.7613,53,44,0,-9
-42.00612,-20.7613,57,39,0,-18
-42.00342,-20.7613,63,43,5,-20
-42.0005,-20.7613,62,47,0,-15
-41.99781,-20.7613,61,46,0,-15
-41.99511,-20.7613,65,23,5,-42
-41.99219,-20.7613,61,41,0,-20
-41.98949,-20.7613,68,46,0,-22
-41.98657,-20.7613,61,34,11,-27
-41.98387,-20.7613,69,39,0,-30
-41.98118,-20.7613,59,49,0,-10
-41.97826,-20.7613,57,37,5,-20
-41.97556,-20.7613,68,50,0,-18
-41.97286,-20.7613,67,37,0,-30
-41.96994,-20.7613,65,34,5,-31
-42.1005,-20.76109,60,32,0,-28
-42.0978,-20.76109,59,32,0,-27
-42.09511,-20.76109,66,26,5,-40
-42.09219,-20.76109,56,30,5,-26
-42.08949,-20.76109,63,30,5,-33
-42.08657,-20.76109,62,30,5,-32
-42.08387,-20.76109,54,28,5,-26
-42.08118,-20.76109,59,34,5,-25
-42.07825,-20.76109,62,35,5,-27
-42.07556,-20.76109,62,35,5,-27
-42.07286,-20.76109,56,38,0,-18
-42.06994,-20.76109,59,39,0,-20
-42.06724,-20.76109,58,27,5,-31
-42.06455,-20.76109,58,29,5,-29
-42.06163,-20.76109,58,33,5,-25
-42.05893,-20.76109,56,34,5,-22
-42.05601,-20.76109,55,35,5,-20
-42.05331,-20.76109,52,34,5,-18
-42.05061,-20.76109,54,39,0,-15
-42.04769,-20.76109,56,30,5,-26
-42.045,-20.76109,54,29,5,-25
-42.0423,-20.76109,55,34,5,-21
-42.03938,-20.76109,48,34,5,-14
-42.03668,-20.76109,49,33,5,-16
-42.03399,-20.76109,48,42,5,-6
-42.03106,-20.76109,40,41,0,1
-42.02837,-20.76109,46,39,0,-7
-42.02545,-20.76109,51,40,0,-11
-42.02275,-20.76109,45,41,0,-4
-42.02005,-20.76109,52,42,0,-10
-42.01713,-20.76109,52,52,0,0
-42.01444,-20.76109,51,52,0,1
-42.01174,-20.76109,54,46,0,-8
-42.00882,-20.76109,54,44,0,-10
-42.00612,-20.76109,57,38,0,-19
-42.00342,-20.76109,58,43,5,-15
-42.0005,-20.76109,64,47,0,-17
-41.99781,-20.76109,61,42,0,-19
-41.99511,-20.76109,65,23,5,-42
-41.99219,-20.76109,61,41,0,-20
-41.98949,-20.76109,68,45,0,-23
-41.98657,-20.76109,61,36,5,-25
-41.98387,-20.76109,68,39,0,-29
-41.98118,-20.76109,59,49,0,-10
-41.97826,-20.76109,61,36,5,-25
-41.97556,-20.76109,69,50,0,-19
-41.97286,-20.76109,68,37,0,-31
-41.96994,-20.76109,68,35,5,-33
-42.1005,-20.76087,59,32,0,-27
-42.0978,-20.76087,60,32,0,-28
-42.09511,-20.76087,66,26,5,-40
-42.09219,-20.76087,56,30,5,-26
-42.08949,-20.76087,58,30,5,-28
-42.08657,-20.76087,53,36,5,-17
-42.08387,-20.76087,54,28,5,-26
-42.08118,-20.76087,59,34,5,-25
-42.07825,-20.76087,64,38,5,-26
-42.07556,-20.76087,61,35,5,-26
-42.07286,-20.76087,56,38,0,-18
-42.06994,-20.76087,63,39,0,-24
-42.06724,-20.76087,58,28,5,-30
-42.06455,-20.76087,59,29,5,-30
-42.06163,-20.76087,58,33,5,-25
-42.05893,-20.76087,57,34,5,-23
-42.05601,-20.76087,55,34,5,-21
-42.05331,-20.76087,52,34,5,-18
-42.05061,-20.76087,54,39,0,-15
-42.04769,-20.76087,57,29,11,-28
-42.045,-20.76087,55,30,5,-25
-42.0423,-20.76087,56,33,5,-23
-42.03938,-20.76087,46,33,5,-13
-42.03668,-20.76087,50,33,5,-17
-42.03399,-20.76087,49,42,5,-7
-42.03106,-20.76087,39,41,0,2
-42.02837,-20.76087,46,39,0,-7
-42.02545,-20.76087,53,39,0,-14
-42.02275,-20.76087,55,41,0,-14
-42.02005,-20.76087,56,42,0,-14
-42.01713,-20.76087,54,53,0,-1
-42.01444,-20.76087,51,51,0,0
-42.01174,-20.76087,54,45,0,-9
-42.00882,-20.76087,55,45,0,-10
-42.00612,-20.76087,57,38,0,-19
-42.00342,-20.76087,58,40,5,-18
-42.0005,-20.76087,65,47,0,-18
-41.99781,-20.76087,61,40,0,-21
-41.99511,-20.76087,66,24,5,-42
-41.99219,-20.76087,62,41,0,-21
-41.98949,-20.76087,70,44,0,-26
-41.98657,-20.76087,61,46,5,-15
-41.98387,-20.76087,64,38,0,-26
-41.98118,-20.76087,59,48,0,-11
-41.97826,-20.76087,65,37,5,-28
-41.97556,-20.76087,68,50,0,-18
-41.97286,-20.76087,56,38,0,-18
-41.96994,-20.76087,69,35,0,-34
-42.1005,-20.76045,60,32,0,-28
-42.0978,-20.76045,61,30,0,-31
-42.09511,-20.76045,66,26,5,-40
-42.09219,-20.76045,56,28,5,-28
-42.08949,-20.76045,62,31,5,-31
-42.08657,-20.76045,53,36,0,-17
-42.08387,-20.76045,54,28,5,-26
-42.08118,-20.76045,61,38,0,-23
-42.07825,-20.76045,66,35,5,-31
-42.07556,-20.76045,61,38,5,-23
-42.07286,-20.76045,56,38,5,-18
-42.06994,-20.76045,62,38,5,-24
-42.06724,-20.76045,57,28,5,-29
-42.06455,-20.76045,59,30,5,-29
-42.06163,-20.76045,58,33,5,-25
-42.05893,-20.76045,58,34,5,-24
-42.05601,-20.76045,55,36,5,-19
-42.05331,-20.76045,52,36,5,-16
-42.05061,-20.76045,54,38,0,-16
-42.04769,-20.76045,57,30,5,-27
-42.045,-20.76045,54,31,5,-23
-42.0423,-20.76045,55,33,5,-22
-42.03938,-20.76045,46,33,5,-13
-42.03668,-20.76045,52,34,5,-18
-42.03399,-20.76045,50,41,0,-9
-42.03106,-20.76045,41,41,0,0
-42.02837,-20.76045,46,38,0,-8
-42.02545,-20.76045,53,39,0,-14
-42.02275,-20.76045,46,41,0,-5
-42.02005,-20.76045,54,42,0,-12
-42.01713,-20.76045,57,52,0,-5
-42.01444,-20.76045,51,51,0,0
-42.01174,-20.76045,54,45,0,-9
-42.00882,-20.76045,56,45,0,-11
-42.00612,-20.76045,59,39,0,-20
-42.00342,-20.76045,58,41,0,-17
-42.0005,-20.76045,65,47,0,-18
-41.99781,-20.76045,61,39,0,-22
-41.99511,-20.76045,68,26,5,-42
-41.99219,-20.76045,62,42,0,-20
-41.98949,-20.76045,71,44,0,-27
-41.98657,-20.76045,61,51,5,-10
-41.98387,-20.76045,60,48,0,-12
-41.98118,-20.76045,59,48,0,-11
-41.97826,-20.76045,65,38,5,-27
-41.97556,-20.76045,68,49,0,-19
-41.97286,-20.76045,61,36,5,-25
-41.96994,-20.76045,70,36,0,-34
-42.1005,-20.76024,60,33,0,-27
-42.0978,-20.76024,61,28,5,-33
-42.09511,-20.76024,66,25,5,-41
-42.09219,-20.76024,56,29,5,-27
-42.08949,-20.76024,65,32,5,-33
-42.08657,-20.76024,60,36,5,-24
-42.08387,-20.76024,54,28,5,-26
-42.08118,-20.76024,64,38,0,-26
-42.07825,-20.76024,61,35,5,-26
-42.07556,-20.76024,62,37,5,-25
-42.07286,-20.76024,57,35,5,-22
-42.06994,-20.76024,62,38,5,-24
-42.06724,-20.76024,57,30,5,-27
-42.06455,-20.76024,59,30,5,-29
-42.06163,-20.76024,58,33,5,-25
-42.05893,-20.76024,58,34,5,-24
-42.05601,-20.76024,55,36,5,-19
-42.05331,-20.76024,53,37,5,-16
-42.05061,-20.76024,54,37,0,-17
-42.04769,-20.76024,58,32,5,-26
-42.045,-20.76024,54,31,5,-23
-42.0423,-20.76024,51,33,5,-18
-42.03938,-20.76024,37,34,5,-3
-42.03668,-20.76024,50,34,5,-16
-42.03399,-20.76024,48,41,0,-7
-42.03106,-20.76024,41,40,0,-1
-42.02837,-20.76024,47,38,0,-9
-42.02545,-20.76024,54,39,0,-15
-42.02275,-20.76024,52,41,0,-11
-42.02005,-20.76024,44,42,0,-2
-42.01713,-20.76024,58,52,0,-6
-42.01444,-20.76024,51,50,0,-1
-42.01174,-20.76024,55,43,0,-12
-42.00882,-20.76024,56,44,0,-12
-42.00612,-20.76024,59,39,0,-20
-42.00342,-20.76024,59,41,0,-18
-42.0005,-20.76024,65,47,0,-18
-41.99781,-20.76024,61,42,0,-19
-41.99511,-20.76024,65,25,0,-40
-41.99219,-20.76024,63,42,0,-21
-41.98949,-20.76024,70,44,0,-26
-41.98657,-20.76024,60,46,5,-14
-41.98387,-20.76024,61,46,0,-15
-41.98118,-20.76024,59,47,0,-12
-41.97826,-20.76024,66,48,5,-18
-41.97556,-20.76024,70,49,0,-21
-41.97286,-20.76024,63,33,5,-30
-41.96994,-20.76024,71,36,0,-35
-42.1005,-20.76003,61,33,0,-28
-42.0978,-20.76003,61,28,5,-33
-42.09511,-20.76003,66,27,5,-39
-42.09219,-20.76003,56,30,5,-26
-42.08949,-20.76003,65,32,5,-33
-42.08657,-20.76003,60,31,5,-29
-42.08387,-20.76003,54,28,5,-26
-42.08118,-20.76003,64,38,0,-26
-42.07825,-20.76003,58,38,5,-20
-42.07556,-20.76003,62,37,5,-25
-42.07286,-20.76003,55,35,5,-20
-42.06994,-20.76003,61,38,5,-23
-42.06724,-20.76003,57,34,5,-23
-42.06455,-20.76003,59,31,5,-28
-42.06163,-20.76003,58,33,5,-25
-42.05893,-20.76003,59,35,5,-24
-42.05601,-20.76003,55,40,5,-15
-42.05331,-20.76003,53,37,5,-16
-42.05061,-20.76003,55,37,0,-18
-42.04769,-20.76003,58,30,0,-28
-42.045,-20.76003,54,31,5,-23
-42.0423,-20.76003,49,33,5,-16
-42.03938,-20.76003,37,34,5,-3
-42.03668,-20.76003,50,34,5,-16
-42.03399,-20.76003,46,41,0,-5
-42.03106,-20.76003,41,40,0,-1
-42.02837,-20.76003,51,38,0,-13
-42.02545,-20.76003,57,39,0,-18
-42.02275,-20.76003,49,41,0,-8
-42.02005,-20.76003,44,41,11,-3
-42.01713,-20.76003,59,52,0,-7
-42.01444,-20.76003,52,48,0,-4
-42.01174,-20.76003,55,42,0,-13
-42.00882,-20.76003,57,43,0,-14
-42.00612,-20.76003,60,39,0,-21
-42.00342,-20.76003,60,40,11,-20
-42.0005,-20.76003,66,46,0,-20
-41.99781,-20.76003,61,43,0,-18
-41.99511,-20.76003,63,30,0,-33
-41.99219,-20.76003,63,42,0,-21
-41.98949,-20.76003,68,44,0,-24
-41.98657,-20.76003,60,42,5,-18
-41.98387,-20.76003,61,49,0,-12
-41.98118,-20.76003,57,48,0,-9
-41.97826,-20.76003,65,48,0,-17
-41.97556,-20.76003,70,49,0,-21
-41.97286,-20.76003,65,34,5,-31
-41.96994,-20.76003,71,36,0,-35
-42.1005,-20.75982,62,33,5,-29
-42.0978,-20.75982,65,26,5,-39
-42.09511,-20.75982,66,27,5,-39
-42.09219,-20.75982,56,29,5,-27
-42.08949,-20.75982,61,32,5,-29
-42.08657,-20.75982,56,30,5,-26
-42.08387,-20.75982,54,28,5,-26
-42.08118,-20.75982,64,38,0,-26
-42.07825,-20.75982,58,38,5,-20
-42.07556,-20.75982,63,36,5,-27
-42.07286,-20.75982,55,34,5,-21
-42.06994,-20.75982,57,38,5,-19
-42.06724,-20.75982,57,30,5,-27
-42.06455,-20.75982,59,31,5,-28
-42.06163,-20.75982,59,33,5,-26
-42.05893,-20.75982,59,36,5,-23
-42.05601,-20.75982,55,41,5,-14
-42.05331,-20.75982,54,37,5,-17
-42.05061,-20.75982,55,37,0,-18
-42.04769,-20.75982,58,33,0,-25
-42.045,-20.75982,54,31,5,-23
-42.0423,-20.75982,45,33,5,-12
-42.03938,-20.75982,38,34,5,-4
-42.03668,-20.75982,50,34,5,-16
-42.03399,-20.75982,47,40,0,-7
-42.03106,-20.75982,41,40,0,-1
-42.02837,-20.75982,53,38,0,-15
-42.02545,-20.75982,57,39,0,-18
-42.02275,-20.75982,44,41,0,-3
-42.02005,-20.75982,52,41,11,-11
-42.01713,-20.75982,59,51,0,-8
-42.01444,-20.75982,52,43,5,-9
-42.01174,-20.75982,55,42,0,-13
-42.00882,-20.75982,57,43,0,-14
-42.00612,-20.75982,61,47,0,-14
-42.00342,-20.75982,62,40,0,-22
-42.0005,-20.75982,66,45,0,-21
-41.99781,-20.75982,62,43,0,-19
-41.99511,-20.75982,64,30,0,-34
-41.99219,-20.75982,63,43,0,-20
-41.98949,-20.75982,64,44,0,-20
-41.98657,-20.75982,60,50,5,-10
-41.98387,-20.75982,61,49,0,-12
-41.98118,-20.75982,57,48,0,-9
-41.97826,-20.75982,66,48,0,-18
-41.97556,-20.75982,69,49,0,-20
-41.97286,-20.75982,67,34,5,-33
-41.96994,-20.75982,70,35,0,-35
-42.10297,-20.75939,58,29,5,-29
-42.10275,-20.75939,58,29,5,-29
-42.10252,-20.75939,58,29,5,-29
-42.1023,-20.75939,58,28,5,-30
-42.10185,-20.75939,60,29,5,-31
-42.10163,-20.75939,61,31,5,-30
-42.1014,-20.75939,61,31,5,-30
-42.10118,-20.75939,61,31,5,-30
-42.10073,-20.75939,62,32,5,-30
-42.1005,-20.75939,63,32,5,-31
-42.10028,-20.75939,65,33,5,-32
-42.10005,-20.75939,66,33,5,-33
-42.09983,-20.75939,66,33,0,-33
-42.09938,-20.75939,66,32,0,-34
-42.09915,-20.75939,66,30,0,-36
-42.09893,-20.75939,66,29,5,-37
-42.0987,-20.75939,66,26,5,-40
-42.09825,-20.75939,66,26,5,-40
-42.09803,-20.75939,66,26,5,-40
-42.0978,-20.75939,67,26,5,-41
-42.09758,-20.75939,66,26,5,-40
-42.09713,-20.75939,66,26,5,-40
-42.09691,-20.75939,65,26,5,-39
-42.09668,-20.75939,64,27,5,-37
-42.09646,-20.75939,65,27,5,-38
-42.09601,-20.75939,65,26,5,-39
-42.09578,-20.75939,65,25,5,-40
-42.09556,-20.75939,66,27,5,-39
-42.09533,-20.75939,67,27,5,-40
-42.09511,-20.75939,66,27,5,-39
-42.09466,-20.75939,65,28,5,-37
-42.09443,-20.75939,65,28,5,-37
-42.09421,-20.75939,59,28,5,-31
-42.09398,-20.75939,57,29,5,-28
-42.09354,-20.75939,57,28,5,-29
-42.09331,-20.75939,56,28,5,-28
-42.09309,-20.75939,56,28,5,-28
-42.09286,-20.75939,56,28,5,-28
-42.09241,-20.75939,56,28,5,-28
-42.09219,-20.75939,56,28,5,-28
-42.09196,-20.75939,56,28,5,-28
-42.09174,-20.75939,56,28,5,-28
-42.09129,-20.75939,56,29,5,-27
-42.09106,-20.75939,59,29,5,-30
-42.09084,-20.75939,64,30,5,-34
-42.09061,-20.75939,64,29,5,-35
-42.09039,-20.75939,63,30,5,-33
-42.08994,-20.75939,64,33,5,-31
-42.08972,-20.75939,59,33,5,-26
-42.08949,-20.75939,61,33,5,-28
-42.08927,-20.75939,64,31,5,-33
-42.08882,-20.75939,56,30,5,-26
-42.08859,-20.75939,56,29,5,-27
-42.08837,-20.75939,57,29,5,-28
-42.08814,-20.75939,57,29,5,-28
-42.08769,-20.75939,58,32,5,-26
-42.08747,-20.75939,59,32,5,-27
-42.08724,-20.75939,59,32,5,-27
-42.08702,-20.75939,61,31,5,-30
-42.08657,-20.75939,58,30,5,-28
-42.08634,-20.75939,58,30,5,-28
-42.08612,-20.75939,57,31,5,-26
-42.08589,-20.75939,57,31,5,-26
-42.08545,-20.75939,62,32,5,-30
-42.08522,-20.75939,59,32,5,-27
-42.085,-20.75939,53,31,5,-22
-42.08477,-20.75939,53,30,5,-23
-42.08455,-20.75939,53,30,5,-23
-42.0841,-20.75939,53,29,5,-24
-42.08387,-20.75939,54,28,5,-26
-42.08365,-20.75939,54,28,5,-26
-42.08342,-20.75939,55,28,5,-27
-42.08297,-20.75939,56,28,5,-28
-42.08275,-20.75939,56,28,5,-28
-42.08252,-20.75939,57,29,5,-28
-42.0823,-20.75939,57,30,5,-27
-42.08185,-20.75939,58,38,5,-20
-42.08163,-20.75939,59,38,5,-21
-42.0814,-20.75939,62,38,0,-24
-42.08118,-20.75939,64,38,0,-26
-42.08073,-20.75939,64,38,0,-26
-42.0805,-20.75939,65,38,0,-27
-42.08028,-20.75939,65,38,0,-27
-42.08005,-20.75939,67,38,0,-29
-42.07983,-20.75939,66,38,0,-28
-42.07938,-20.75939,65,38,0,-27
-42.07915,-20.75939,65,38,0,-27
-42.07893,-20.75939,62,38,5,-24
-42.0787,-20.75939,57,38,5,-19
-42.07825,-20.75939,57,38,5,-19
-42.07803,-20.75939,58,38,5,-20
-42.07781,-20.75939,58,38,0,-20
-42.07758,-20.75939,59,38,0,-21
-42.07713,-20.75939,59,38,0,-21
-42.07691,-20.75939,59,38,0,-21
-42.07668,-20.75939,60,38,0,-22
-42.07646,-20.75939,60,38,0,-22
-42.07601,-20.75939,61,35,5,-26
-42.07578,-20.75939,61,35,5,-26
-42.07556,-20.75939,62,37,5,-25
-42.07533,-20.75939,62,37,5,-25
-42.07511,-20.75939,62,37,0,-25
-42.07466,-20.75939,65,37,0,-28
-42.07443,-20.75939,64,37,0,-27
-42.07421,-20.75939,65,37,0,-28
-42.07399,-20.75939,67,37,0,-30
-42.07354,-20.75939,66,34,5,-32
-42.07331,-20.75939,64,33,5,-31
-42.07309,-20.75939,63,32,5,-31
-42.07286,-20.75939,57,32,5,-25
-42.07241,-20.75939,55,33,5,-22
-42.07219,-20.75939,55,33,5,-22
-42.07196,-20.75939,55,33,5,-22
-42.07174,-20.75939,56,33,5,-23
-42.07129,-20.75939,56,37,5,-19
-42.07106,-20.75939,56,37,5,-19
-42.07084,-20.75939,56,38,5,-18
-42.07061,-20.75939,56,38,5,-18
-42.07039,-20.75939,56,38,5,-18
-42.06994,-20.75939,57,37,5,-20
-42.06972,-20.75939,57,35,5,-22
-42.06949,-20.75939,57,34,5,-23
-42.06927,-20.75939,57,35,5,-22
-42.06882,-20.75939,57,35,5,-22
-42.06859,-20.75939,57,35,5,-22
-42.06837,-20.75939,57,35,5,-22
-42.06814,-20.75939,57,34,5,-23
-42.06769,-20.75939,57,34,5,-23
-42.06747,-20.75939,57,32,5,-25
-42.06724,-20.75939,57,30,5,-27
-42.06702,-20.75939,57,31,5,-26
-42.06657,-20.75939,58,32,5,-26
-42.06634,-20.75939,58,30,5,-28
-42.06612,-20.75939,58,30,5,-28
-42.0659,-20.75939,58,31,5,-27
-42.06545,-20.75939,58,31,5,-27
-42.06522,-20.75939,59,31,5,-28
-42.065,-20.75939,59,31,5,-28
-42.06477,-20.75939,59,31,5,-28
-42.06455,-20.75939,59,31,5,-28
-42.0641,-20.75939,59,32,5,-27
-42.06387,-20.75939,59,32,5,-27
-42.06365,-20.75939,59,32,5,-27
-42.06342,-20.75939,59,33,5,-26
-42.06297,-20.75939,59,33,5,-26
-42.06275,-20.75939,59,34,5,-25
-42.06252,-20.75939,58,34,5,-24
-42.0623,-20.75939,58,34,5,-24
-42.06185,-20.75939,59,34,5,-25
-42.06163,-20.75939,59,34,5,-25
-42.0614,-20.75939,59,34,5,-25
-42.06118,-20.75939,59,34,5,-25
-42.06073,-20.75939,59,35,5,-24
-42.0605,-20.75939,59,36,5,-23
-42.06028,-20.75939,59,35,5,-24
-42.06005,-20.75939,59,35,5,-24
-42.05983,-20.75939,59,35,5,-24
-42.05938,-20.75939,59,36,5,-23
-42.05915,-20.75939,59,37,5,-22
-42.05893,-20.75939,59,38,5,-21
-42.0587,-20.75939,60,38,5,-22
-42.05826,-20.75939,63,40,5,-23
-42.05803,-20.75939,63,41,5,-22
-42.05781,-20.75939,63,43,5,-20
-42.05758,-20.75939,63,44,5,-19
-42.05713,-20.75939,58,44,5,-14
-42.05691,-20.75939,63,43,5,-20
-42.05668,-20.75939,60,43,5,-17
-42.05646,-20.75939,58,44,5,-14
-42.05601,-20.75939,57,42,5,-15
-42.05578,-20.75939,57,41,5,-16
-42.05556,-20.75939,56,42,5,-14
-42.05533,-20.75939,57,40,5,-17
-42.05511,-20.75939,55,40,5,-15
-42.05466,-20.75939,55,39,5,-16
-42.05443,-20.75939,55,39,5,-16
-42.05421,-20.75939,55,42,5,-13
-42.05399,-20.75939,55,40,5,-15
-42.05354,-20.75939,54,38,5,-16
-42.05331,-20.75939,54,37,5,-17
-42.05309,-20.75939,54,37,5,-17
-42.05286,-20.75939,54,39,5,-15
-42.05241,-20.75939,54,38,5,-16
-42.05219,-20.75939,54,38,5,-16
-42.05196,-20.75939,54,38,5,-16
-42.05174,-20.75939,55,39,5,-16
-42.05129,-20.75939,54,39,0,-15
-42.05106,-20.75939,55,39,0,-16
-42.05084,-20.75939,55,38,0,-17
-42.05061,-20.75939,55,37,0,-18
-42.05039,-20.75939,55,35,0,-20
-42.04994,-20.75939,55,37,0,-18
-42.04972,-20.75939,54,37,0,-17
-42.04949,-20.75939,54,36,0,-18
-42.04927,-20.75939,55,36,0,-19
-42.04882,-20.75939,52,36,0,-16
-42.04859,-20.75939,52,34,11,-18
-42.04837,-20.75939,56,32,0,-24
-42.04814,-20.75939,56,32,0,-24
-42.04769,-20.75939,52,33,0,-19
-42.04747,-20.75939,50,32,0,-18
-42.04724,-20.75939,50,32,0,-18
-42.04702,-20.75939,55,33,0,-22
-42.04657,-20.75939,57,34,0,-23
-42.04635,-20.75939,56,37,0,-19
-42.04612,-20.75939,54,38,0,-16
-42.0459,-20.75939,55,39,0,-16
-42.04545,-20.75939,57,38,0,-19
-42.04522,-20.75939,53,34,5,-19
-42.045,-20.75939,56,31,5,-25
-42.04477,-20.75939,55,31,5,-24
-42.04455,-20.75939,53,32,5,-21
-42.0441,-20.75939,49,33,5,-16
-42.04387,-20.75939,50,33,5,-17
-42.04365,-20.75939,48,33,5,-15
-42.04342,-20.75939,46,33,5,-13
-42.04297,-20.75939,43,33,5,-10
-42.04275,-20.75939,38,34,5,-4
-42.04253,-20.75939,38,34,5,-4
-42.0423,-20.75939,41,34,5,-7
-42.04185,-20.75939,49,35,5,-14
-42.04163,-20.75939,50,33,5,-17
-42.0414,-20.75939,49,32,5,-17
-42.04118,-20.75939,49,32,5,-17
-42.04073,-20.75939,48,34,5,-14
-42.0405,-20.75939,46,34,5,-12
-42.04028,-20.75939,38,34,5,-4
-42.04005,-20.75939,38,34,5,-4
-42.03983,-20.75939,38,34,5,-4
-42.03938,-20.75939,38,34,5,-4
-42.03915,-20.75939,39,35,5,-4
-42.03893,-20.75939,40,35,5,-5
-42.0387,-20.75939,41,35,5,-6
-42.03826,-20.75939,42,34,5,-8
-42.03803,-20.75939,42,34,5,-8
-42.03781,-20.75939,46,34,5,-12
-42.03758,-20.75939,49,34,5,-15
-42.03713,-20.75939,50,34,5,-16
-42.03691,-20.75939,51,34,5,-17
-42.03668,-20.75939,52,36,5,-16
-42.03646,-20.75939,53,35,5,-18
-42.03601,-20.75939,53,37,5,-16
-42.03578,-20.75939,51,39,5,-12
-42.03556,-20.75939,48,40,5,-8
-42.03533,-20.75939,48,42,0,-6
-42.03511,-20.75939,48,42,0,-6
-42.03466,-20.75939,47,41,0,-6
-42.03444,-20.75939,47,40,0,-7
-42.03421,-20.75939,45,37,5,-8
-42.03399,-20.75939,44,35,5,-9
-42.03354,-20.75939,42,35,5,-7
-42.03331,-20.75939,44,38,5,-6
-42.03309,-20.75939,42,38,0,-4
-42.03286,-20.75939,42,39,0,-3
-42.03241,-20.75939,33,37,0,4
-42.03219,-20.75939,32,38,0,6
-42.03196,-20.75939,28,38,0,10
-42.03174,-20.75939,30,38,0,8
-42.03129,-20.75939,29,38,0,9
-42.03106,-20.75939,32,38,0,6
-42.03084,-20.75939,31,39,0,8
-42.03062,-20.75939,40,39,0,-1
-42.03017,-20.75939,45,39,0,-6
-42.02994,-20.75939,44,39,0,-5
-42.02972,-20.75939,41,38,0,-3
-42.02949,-20.75939,45,38,0,-7
-42.02927,-20.75939,46,38,0,-8
-42.02882,-20.75939,51,38,0,-13
-42.02859,-20.75939,52,38,0,-14
-42.02837,-20.75939,54,38,0,-16
-42.02814,-20.75939,54,38,0,-16
-42.02769,-20.75939,52,38,0,-14
-42.02747,-20.75939,48,38,0,-10
-42.02724,-20.75939,46,38,0,-8
-42.02702,-20.75939,48,38,0,-10
-42.02657,-20.75939,53,38,0,-15
-42.02635,-20.75939,55,38,0,-17
-42.02612,-20.75939,54,38,0,-16
-42.0259,-20.75939,56,38,0,-18
-42.02545,-20.75939,52,38,0,-14
-42.02522,-20.75939,57,39,0,-18
-42.025,-20.75939,53,39,0,-14
-42.02477,-20.75939,53,39,0,-14
-42.02455,-20.75939,52,39,0,-13
-42.0241,-20.75939,52,39,0,-13
-42.02387,-20.75939,50,39,0,-11
-42.02365,-20.75939,49,39,0,-10
-42.02342,-20.75939,47,40,0,-7
-42.02297,-20.75939,45,41,0,-4
-42.02275,-20.75939,44,41,0,-3
-42.02253,-20.75939,44,40,0,-4
-42.0223,-20.75939,44,40,0,-4
-42.02185,-20.75939,44,41,0,-3
-42.02163,-20.75939,44,41,0,-3
-42.0214,-20.75939,44,41,0,-3
-42.02118,-20.75939,44,41,0,-3
-42.02073,-20.75939,44,41,0,-3
-42.0205,-20.75939,44,41,0,-3
-42.02028,-20.75939,44,41,0,-3
-42.02005,-20.75939,44,41,0,-3
-42.01983,-20.75939,44,41,0,-3
-42.01938,-20.75939,44,42,0,-2
-42.01915,-20.75939,45,42,0,-3
-42.01893,-20.75939,51,43,0,-8
-42.01871,-20.75939,58,43,0,-15
-42.01826,-20.75939,59,51,0,-8
-42.01803,-20.75939,59,51,0,-8
-42.01781,-20.75939,61,51,0,-10
-42.01758,-20.75939,60,51,0,-9
-42.01713,-20.75939,60,51,0,-9
-42.01691,-20.75939,60,51,0,-9
-42.01668,-20.75939,60,51,0,-9
-42.01646,-20.75939,60,49,5,-11
-42.01601,-20.75939,57,44,5,-13
-42.01578,-20.75939,55,44,5,-11
-42.01556,-20.75939,52,44,5,-8
-42.01533,-20.75939,51,39,5,-12
-42.01511,-20.75939,51,39,5,-12
-42.01466,-20.75939,52,38,5,-14
-42.01444,-20.75939,52,39,5,-13
-42.01421,-20.75939,53,39,5,-14
-42.01399,-20.75939,53,39,5,-14
-42.01354,-20.75939,54,44,0,-10
-42.01331,-20.75939,54,44,0,-10
-42.01309,-20.75939,54,43,0,-11
-42.01286,-20.75939,54,43,0,-11
-42.01241,-20.75939,55,42,0,-13
-42.01219,-20.75939,55,42,0,-13
-42.01196,-20.75939,55,42,0,-13
-42.01174,-20.75939,55,41,0,-14
-42.01129,-20.75939,56,40,0,-16
-42.01106,-20.75939,56,40,0,-16
-42.01084,-20.75939,56,40,0,-16
-42.01062,-20.75939,56,40,0,-16
-42.01017,-20.75939,57,40,0,-17
-42.00994,-20.75939,57,40,0,-17
-42.00972,-20.75939,57,41,0,-16
-42.00949,-20.75939,57,41,0,-16
-42.00927,-20.75939,57,41,0,-16
-42.00882,-20.75939,58,42,0,-16
-42.00859,-20.75939,58,43,0,-15
-42.00837,-20.75939,59,44,0,-15
-42.00814,-20.75939,59,45,0,-14
-42.00769,-20.75939,60,46,0,-14
-42.00747,-20.75939,60,47,0,-13
-42.00724,-20.75939,60,47,0,-13
-42.00702,-20.75939,61,48,0,-13
-42.00657,-20.75939,61,48,0,-13
-42.00635,-20.75939,62,48,0,-14
-42.00612,-20.75939,62,48,0,-14
-42.0059,-20.75939,63,47,0,-16
-42.00545,-20.75939,63,47,0,-16
-42.00522,-20.75939,63,46,0,-17
-42.005,-20.75939,64,46,0,-18
-42.00477,-20.75939,64,46,0,-18
-42.00455,-20.75939,65,46,0,-19
-42.0041,-20.75939,65,44,0,-21
-42.00387,-20.75939,65,41,0,-24
-42.00365,-20.75939,64,40,0,-24
-42.00342,-20.75939,64,40,0,-24
-42.00298,-20.75939,64,40,0,-24
-42.00275,-20.75939,63,41,11,-22
-42.00253,-20.75939,63,41,0,-22
-42.0023,-20.75939,63,41,0,-22
-42.00185,-20.75939,64,41,0,-23
-42.00163,-20.75939,64,41,0,-23
-42.0014,-20.75939,66,41,0,-25
-42.00118,-20.75939,67,41,0,-26
-42.00073,-20.75939,67,41,0,-26
-42.0005,-20.75939,67,42,0,-25
-42.00028,-20.75939,66,41,0,-25
-42.00005,-20.75939,64,41,0,-23
-41.99983,-20.75939,64,41,0,-23
-41.99938,-20.75939,64,41,0,-23
-41.99916,-20.75939,64,41,0,-23
-41.99893,-20.75939,64,41,0,-23
-41.99871,-20.75939,63,41,0,-22
-41.99826,-20.75939,63,42,0,-21
-41.99803,-20.75939,62,42,0,-20
-41.99781,-20.75939,62,43,0,-19
-41.99758,-20.75939,62,43,0,-19
-41.99713,-20.75939,62,42,0,-20
-41.99691,-20.75939,63,40,0,-23
-41.99668,-20.75939,64,39,0,-25
-41.99646,-20.75939,64,38,0,-26
-41.99601,-20.75939,65,33,0,-32
-41.99578,-20.75939,65,32,0,-33
-41.99556,-20.75939,65,31,0,-34
-41.99533,-20.75939,65,31,0,-34
-41.99511,-20.75939,65,32,0,-33
-41.99466,-20.75939,66,32,0,-34
-41.99444,-20.75939,66,32,5,-34
-41.99421,-20.75939,66,30,5,-36
-41.99399,-20.75939,66,28,5,-38
-41.99354,-20.75939,66,29,5,-37
-41.99331,-20.75939,66,32,0,-34
-41.99309,-20.75939,65,35,6,-30
-41.99286,-20.75939,65,35,0,-30
-41.99241,-20.75939,64,43,0,-21
-41.99219,-20.75939,64,44,0,-20
-41.99196,-20.75939,63,45,0,-18
-41.99174,-20.75939,63,45,0,-18
-41.99129,-20.75939,62,45,0,-17
-41.99107,-20.75939,61,45,0,-16
-41.99084,-20.75939,61,45,0,-16
-41.99062,-20.75939,61,44,0,-17
-41.99017,-20.75939,61,44,0,-17
-41.98994,-20.75939,61,44,0,-17
-41.98972,-20.75939,68,44,0,-24
-41.98949,-20.75939,63,45,0,-18
-41.98927,-20.75939,68,45,0,-23
-41.98882,-20.75939,62,48,11,-14
-41.98859,-20.75939,62,48,11,-14
-41.98837,-20.75939,62,48,11,-14
-41.98814,-20.75939,62,48,5,-14
-41.98769,-20.75939,61,49,5,-12
-41.98747,-20.75939,61,49,5,-12
-41.98725,-20.75939,61,50,5,-11
-41.98702,-20.75939,61,50,0,-11
-41.98657,-20.75939,61,50,0,-11
-41.98635,-20.75939,61,50,0,-11
-41.98612,-20.75939,61,50,0,-11
-41.9859,-20.75939,61,50,0,-11
-41.98545,-20.75939,61,49,0,-12
-41.98522,-20.75939,61,50,0,-11
-41.985,-20.75939,61,50,0,-11
-41.98477,-20.75939,61,50,0,-11
-41.98455,-20.75939,61,49,0,-12
-41.9841,-20.75939,61,49,0,-12
-41.98387,-20.75939,61,49,0,-12
-41.98365,-20.75939,61,48,0,-13
-41.98343,-20.75939,61,48,0,-13
-41.98298,-20.75939,61,48,0,-13
-41.98275,-20.75939,61,47,0,-14
-41.98253,-20.75939,60,47,0,-13
-41.9823,-20.75939,60,47,0,-13
-41.98185,-20.75939,60,48,0,-12
-41.98163,-20.75939,59,48,0,-11
-41.9814,-20.75939,57,48,0,-9
-41.98118,-20.75939,57,48,0,-9
-41.98073,-20.75939,57,48,0,-9
-41.9805,-20.75939,57,48,5,-9
-41.98028,-20.75939,57,39,5,-18
-41.98005,-20.75939,57,37,5,-20
-41.97983,-20.75939,62,38,5,-24
-41.97938,-20.75939,65,42,0,-23
-41.97916,-20.75939,67,44,0,-23
-41.97893,-20.75939,70,48,0,-22
-41.97871,-20.75939,70,46,0,-24
-41.97826,-20.75939,67,48,0,-19
-41.97803,-20.75939,66,48,0,-18
-41.97781,-20.75939,69,48,0,-21
-41.97758,-20.75939,70,48,0,-22
-41.97713,-20.75939,70,48,0,-22
-41.97691,-20.75939,68,48,0,-20
-41.97668,-20.75939,68,48,0,-20
-41.97646,-20.75939,66,48,0,-18
-41.97601,-20.75939,65,49,0,-16
-41.97578,-20.75939,64,49,0,-15
-41.97556,-20.75939,65,49,0,-16
-41.97534,-20.75939,70,49,0,-21
-41.97511,-20.75939,71,49,0,-22
-41.97466,-20.75939,70,50,0,-20
-41.97444,-20.75939,71,50,5,-21
-41.97421,-20.75939,71,40,5,-31
-41.97399,-20.75939,69,33,5,-36
-41.97354,-20.75939,69,33,5,-36
-41.97331,-20.75939,69,32,5,-37
-41.97309,-20.75939,69,32,5,-37
-41.97286,-20.75939,68,32,5,-36
-41.97241,-20.75939,67,34,0,-33
-41.97219,-20.75939,67,34,0,-33
-41.97196,-20.75939,66,33,0,-33
-41.97174,-20.75939,65,34,0,-31
-41.97129,-20.75939,64,34,0,-30
-41.97107,-20.75939,63,34,5,-29
-41.97084,-20.75939,68,31,5,-37
-41.97062,-20.75939,66,32,5,-34
-41.97017,-20.75939,71,34,5,-37
-41.96994,-20.75939,70,34,0,-36
-41.96972,-20.75939,70,34,0,-36
-41.96949,-20.75939,68,33,0,-35
-41.96927,-20.75939,67,33,0,-34
-42.1005,-20.75918,64,32,5,-32
-42.0978,-20.75918,67,26,5,-41
-42.09511,-20.75918,65,28,5,-37
-42.09219,-20.75918,57,28,5,-29
-42.08949,-20.75918,63,31,5,-32
-42.08657,-20.75918,61,30,5,-31
-42.08387,-20.75918,54,28,5,-26
-42.08118,-20.75918,63,38,0,-25
-42.07825,-20.75918,57,38,0,-19
-42.07556,-20.75918,61,34,5,-27
-42.07286,-20.75918,54,32,5,-22
-42.06994,-20.75918,56,36,5,-20
-42.06724,-20.75918,57,30,5,-27
-42.06455,-20.75918,59,32,5,-27
-42.06163,-20.75918,59,34,5,-25
-42.05893,-20.75918,59,38,5,-21
-42.05601,-20.75918,56,43,5,-13
-42.05331,-20.75918,55,37,5,-18
-42.05061,-20.75918,55,36,0,-19
-42.04769,-20.75918,49,33,0,-16
-42.045,-20.75918,48,31,5,-17
-42.0423,-20.75918,39,34,5,-5
-42.03938,-20.75918,39,34,5,-5
-42.03668,-20.75918,50,36,5,-14
-42.03399,-20.75918,44,36,5,-8
-42.03106,-20.75918,25,38,0,13
-42.02837,-20.75918,47,38,0,-9
-42.02545,-20.75918,51,38,0,-13
-42.02275,-20.75918,44,40,0,-4
-42.02005,-20.75918,44,41,0,-3
-42.01713,-20.75918,60,51,0,-9
-42.01444,-20.75918,52,38,5,-14
-42.01174,-20.75918,55,40,0,-15
-42.00882,-20.75918,59,41,0,-18
-42.00612,-20.75918,64,47,0,-17
-42.00342,-20.75918,69,40,0,-29
-42.0005,-20.75918,67,39,0,-28
-41.99781,-20.75918,63,41,0,-22
-41.99511,-20.75918,68,32,0,-36
-41.99219,-20.75918,68,44,0,-24
-41.98949,-20.75918,65,45,0,-20
-41.98657,-20.75918,61,50,0,-11
-41.98387,-20.75918,61,48,0,-13
-41.98118,-20.75918,57,48,0,-9
-41.97826,-20.75918,65,48,0,-17
-41.97556,-20.75918,65,49,0,-16
-41.97286,-20.75918,69,32,5,-37
-41.96994,-20.75918,68,34,0,-34
-42.1005,-20.75897,66,34,5,-32
-42.0978,-20.75897,66,26,5,-40
-42.09511,-20.75897,65,28,5,-37
-42.09219,-20.75897,57,28,5,-29
-42.08949,-20.75897,63,32,5,-31
-42.08657,-20.75897,62,32,5,-30
-42.08387,-20.75897,53,28,5,-25
-42.08118,-20.75897,60,38,0,-22
-42.07825,-20.75897,57,38,0,-19
-42.07556,-20.75897,61,34,5,-27
-42.07286,-20.75897,58,32,5,-26
-42.06994,-20.75897,57,38,5,-19
-42.06724,-20.75897,57,30,5,-27
-42.06455,-20.75897,59,32,5,-27
-42.06163,-20.75897,59,34,5,-25
-42.05893,-20.75897,59,38,5,-21
-42.05601,-20.75897,55,43,5,-12
-42.05331,-20.75897,55,38,5,-17
-42.05061,-20.75897,55,35,11,-20
-42.04769,-20.75897,49,33,0,-16
-42.045,-20.75897,42,34,5,-8
-42.0423,-20.75897,37,34,5,-3
-42.03938,-20.75897,40,34,5,-6
-42.03668,-20.75897,50,36,5,-14
-42.03399,-20.75897,42,35,5,-7
-42.03106,-20.75897,24,38,0,14
-42.02837,-20.75897,48,38,0,-10
-42.02545,-20.75897,52,38,0,-14
-42.02275,-20.75897,44,40,0,-4
-42.02005,-20.75897,44,41,0,-3
-42.01713,-20.75897,61,44,5,-17
-42.01444,-20.75897,53,38,5,-15
-42.01174,-20.75897,56,41,0,-15
-42.00882,-20.75897,60,41,0,-19
-42.00612,-20.75897,68,47,0,-21
-42.00342,-20.75897,71,40,0,-31
-42.0005,-20.75897,67,37,0,-30
-41.99781,-20.75897,65,39,0,-26
-41.99511,-20.75897,68,32,0,-36
-41.99219,-20.75897,68,44,0,-24
-41.98949,-20.75897,63,47,11,-16
-41.98657,-20.75897,61,50,0,-11
-41.98387,-20.75897,61,48,0,-13
-41.98118,-20.75897,57,48,0,-9
-41.97826,-20.75897,64,47,0,-17
-41.97556,-20.75897,67,49,0,-18
-41.97286,-20.75897,70,32,5,-38
-41.96994,-20.75897,68,32,0,-36
-42.1005,-20.75855,67,34,0,-33
-42.0978,-20.75855,66,26,5,-40
-42.09511,-20.75855,66,28,5,-38
-42.09219,-20.75855,57,28,5,-29
-42.08949,-20.75855,56,30,5,-26
-42.08657,-20.75855,63,29,5,-34
-42.08387,-20.75855,53,30,5,-23
-42.08118,-20.75855,59,38,0,-21
-42.07825,-20.75855,57,38,0,-19
-42.07556,-20.75855,61,35,5,-26
-42.07286,-20.75855,60,34,5,-26
-42.06994,-20.75855,57,38,5,-19
-42.06724,-20.75855,59,31,5,-28
-42.06455,-20.75855,59,32,5,-27
-42.06163,-20.75855,59,35,5,-24
-42.05893,-20.75855,59,44,5,-15
-42.05601,-20.75855,55,43,5,-12
-42.05331,-20.75855,56,38,5,-18
-42.05061,-20.75855,55,37,0,-18
-42.04769,-20.75855,50,26,0,-24
-42.045,-20.75855,36,36,0,0
-42.0423,-20.75855,37,34,5,-3
-42.03938,-20.75855,40,34,5,-6
-42.03668,-20.75855,50,36,5,-14
-42.03399,-20.75855,35,35,5,0
-42.03106,-20.75855,22,37,0,15
-42.02837,-20.75855,50,37,0,-13
-42.02545,-20.75855,53,39,0,-14
-42.02275,-20.75855,44,40,0,-4
-42.02005,-20.75855,44,41,0,-3
-42.01713,-20.75855,59,39,5,-20
-42.01444,-20.75855,53,39,5,-14
-42.01174,-20.75855,56,39,0,-17
-42.00882,-20.75855,66,40,0,-26
-42.00612,-20.75855,70,46,0,-24
-42.00342,-20.75855,71,43,0,-28
-42.0005,-20.75855,70,34,0,-36
-41.99781,-20.75855,66,35,0,-31
-41.99511,-20.75855,69,32,0,-37
-41.99219,-20.75855,69,45,0,-24
-41.98949,-20.75855,64,47,0,-17
-41.98657,-20.75855,62,50,0,-12
-41.98387,-20.75855,61,47,0,-14
-41.98118,-20.75855,57,48,0,-9
-41.97826,-20.75855,56,48,0,-8
-41.97556,-20.75855,67,49,0,-18
-41.97286,-20.75855,70,33,5,-37
-41.96994,-20.75855,71,32,5,-39
-42.1005,-20.75834,67,35,0,-32
-42.0978,-20.75834,57,26,5,-31
-42.09511,-20.75834,65,28,5,-37
-42.09219,-20.75834,57,28,5,-29
-42.08949,-20.75834,56,30,5,-26
-42.08657,-20.75834,64,29,5,-35
-42.08387,-20.75834,53,29,5,-24
-42.08118,-20.75834,58,38,0,-20
-42.07825,-20.75834,57,38,0,-19
-42.07556,-20.75834,63,37,5,-26
-42.07286,-20.75834,60,37,5,-23
-42.06994,-20.75834,57,38,0,-19
-42.06724,-20.75834,60,31,5,-29
-42.06455,-20.75834,59,33,5,-26
-42.06163,-20.75834,60,36,5,-24
-42.05893,-20.75834,60,44,5,-16
-42.05601,-20.75834,55,39,5,-16
-42.05331,-20.75834,56,39,5,-17
-42.05061,-20.75834,55,36,0,-19
-42.04769,-20.75834,51,25,0,-26
-42.045,-20.75834,37,37,0,0
-42.0423,-20.75834,38,34,5,-4
-42.03938,-20.75834,41,34,5,-7
-42.03668,-20.75834,51,40,5,-11
-42.03399,-20.75834,24,34,5,10
-42.03106,-20.75834,24,33,0,9
-42.02837,-20.75834,53,36,5,-17
-42.02545,-20.75834,55,39,0,-16
-42.02275,-20.75834,44,40,0,-4
-42.02005,-20.75834,45,41,0,-4
-42.01713,-20.75834,59,39,5,-20
-42.01444,-20.75834,54,38,5,-16
-42.01174,-20.75834,56,39,5,-17
-42.00882,-20.75834,61,40,0,-21
-42.00612,-20.75834,67,45,0,-22
-42.00342,-20.75834,70,46,0,-24
-42.0005,-20.75834,70,34,0,-36
-41.99781,-20.75834,68,33,0,-35
-41.99511,-20.75834,69,31,0,-38
-41.99219,-20.75834,67,44,0,-23
-41.98949,-20.75834,67,46,0,-21
-41.98657,-20.75834,63,50,0,-13
-41.98387,-20.75834,62,47,0,-15
-41.98118,-20.75834,57,48,0,-9
-41.97826,-20.75834,56,42,0,-14
-41.97556,-20.75834,56,49,0,-7
-41.97286,-20.75834,71,33,5,-38
-41.96994,-20.75834,61,32,5,-29
-42.1005,-20.75813,67,35,0,-32
-42.0978,-20.75813,57,26,5,-31
-42.09511,-20.75813,64,28,5,-36
-42.09219,-20.75813,60,29,5,-31
-42.08949,-20.75813,56,30,5,-26
-42.08657,-20.75813,64,32,5,-32
-42.08387,-20.75813,53,29,5,-24
-42.08118,-20.75813,58,38,0,-20
-42.07825,-20.75813,58,38,0,-20
-42.07556,-20.75813,63,37,5,-26
-42.07286,-20.75813,60,35,5,-25
-42.06994,-20.75813,57,38,0,-19
-42.06724,-20.75813,57,32,5,-25
-42.06455,-20.75813,59,33,5,-26
-42.06163,-20.75813,61,38,5,-23
-42.05893,-20.75813,60,44,5,-16
-42.05601,-20.75813,57,38,5,-19
-42.05331,-20.75813,56,42,5,-14
-42.05061,-20.75813,56,35,0,-21
-42.04769,-20.75813,53,27,5,-26
-42.045,-20.75813,37,36,0,-1
-42.0423,-20.75813,38,34,5,-4
-42.03938,-20.75813,41,34,5,-7
-42.03668,-20.75813,51,36,5,-15
-42.03399,-20.75813,23,33,5,10
-42.03106,-20.75813,24,33,5,9
-42.02837,-20.75813,54,35,5,-19
-42.02545,-20.75813,56,38,0,-18
-42.02275,-20.75813,45,40,0,-5
-42.02005,-20.75813,46,41,0,-5
-42.01713,-20.75813,58,39,5,-19
-42.01444,-20.75813,55,38,5,-17
-42.01174,-20.75813,57,38,5,-19
-42.00882,-20.75813,63,40,0,-23
-42.00612,-20.75813,68,45,0,-23
-42.00342,-20.75813,70,46,0,-24
-42.0005,-20.75813,69,35,0,-34
-41.99781,-20.75813,68,33,0,-35
-41.99511,-20.75813,68,31,5,-37
-41.99219,-20.75813,69,44,0,-25
-41.98949,-20.75813,69,45,0,-24
-41.98657,-20.75813,67,50,0,-17
-41.98387,-20.75813,63,47,0,-16
-41.98118,-20.75813,57,48,0,-9
-41.97826,-20.75813,62,45,0,-17
-41.97556,-20.75813,55,49,0,-6
-41.97286,-20.75813,71,36,5,-35
-41.96994,-20.75813,59,34,5,-25
-42.1005,-20.7577,68,34,0,-34
-42.0978,-20.7577,57,26,5,-31
-42.09511,-20.7577,63,27,5,-36
-42.09219,-20.7577,62,29,5,-33
-42.08949,-20.7577,56,30,5,-26
-42.08657,-20.7577,65,31,5,-34
-42.08387,-20.7577,53,31,5,-22
-42.08118,-20.7577,58,38,0,-20
-42.07825,-20.7577,58,38,0,-20
-42.07556,-20.7577,64,34,5,-30
-42.07286,-20.7577,59,38,5,-21
-42.06994,-20.7577,57,38,0,-19
-42.06724,-20.7577,57,34,5,-23
-42.06455,-20.7577,59,34,5,-25
-42.06163,-20.7577,61,38,5,-23
-42.05893,-20.7577,62,44,5,-18
-42.05601,-20.7577,59,38,5,-21
-42.05331,-20.7577,56,40,5,-16
-42.05061,-20.7577,56,34,0,-22
-42.04769,-20.7577,54,30,5,-24
-42.045,-20.7577,37,30,5,-7
-42.0423,-20.7577,39,37,5,-2
-42.03938,-20.7577,41,35,5,-6
-42.03668,-20.7577,51,36,5,-15
-42.03399,-20.7577,21,33,5,12
-42.03106,-20.7577,24,34,5,10
-42.02837,-20.7577,55,35,5,-20
-42.02545,-20.7577,57,39,0,-18
-42.02275,-20.7577,45,40,0,-5
-42.02005,-20.7577,46,41,0,-5
-42.01713,-20.7577,57,39,5,-18
-42.01444,-20.7577,55,38,5,-17
-42.01174,-20.7577,57,40,5,-17
-42.00882,-20.7577,63,45,0,-18
-42.00612,-20.7577,66,43,0,-23
-42.00342,-20.7577,70,48,0,-22
-42.0005,-20.7577,70,41,0,-29
-41.99781,-20.7577,69,31,0,-38
-41.99511,-20.7577,69,27,5,-42
-41.99219,-20.7577,68,43,0,-25
-41.98949,-20.7577,70,45,0,-25
-41.98657,-20.7577,69,48,0,-21
-41.98387,-20.7577,64,47,0,-17
-41.98118,-20.7577,57,48,0,-9
-41.97826,-20.7577,65,45,0,-20
-41.97556,-20.7577,55,49,0,-6
-41.97286,-20.7577,71,37,5,-34
-41.96994,-20.7577,55,34,5,-21
-42.1005,-20.75749,69,34,0,-35
-42.0978,-20.75749,57,26,5,-31
-42.09511,-20.75749,63,27,5,-36
-42.09219,-20.75749,64,29,5,-35
-42.08949,-20.75749,56,30,5,-26
-42.08657,-20.75749,65,30,5,-35
-42.08387,-20.75749,53,31,5,-22
-42.08118,-20.75749,58,38,0,-20
-42.07825,-20.75749,58,38,0,-20
-42.07556,-20.75749,65,37,5,-28
-42.07286,-20.75749,62,38,0,-24
-42.06994,-20.75749,56,38,0,-18
-42.06724,-20.75749,57,34,5,-23
-42.06455,-20.75749,59,34,5,-25
-42.06163,-20.75749,62,39,5,-23
-42.05893,-20.75749,61,44,5,-17
-42.05601,-20.75749,59,38,5,-21
-42.05331,-20.75749,56,40,5,-16
-42.05061,-20.75749,57,34,0,-23
-42.04769,-20.75749,54,30,5,-24
-42.045,-20.75749,40,30,5,-10
-42.0423,-20.75749,40,37,5,-3
-42.03938,-20.75749,42,35,5,-7
-42.03668,-20.75749,49,37,5,-12
-42.03399,-20.75749,23,33,5,10
-42.03106,-20.75749,26,34,5,8
-42.02837,-20.75749,53,35,5,-18
-42.02545,-20.75749,56,38,0,-18
-42.02275,-20.75749,45,40,0,-5
-42.02005,-20.75749,47,41,0,-6
-42.01713,-20.75749,54,39,5,-15
-42.01444,-20.75749,55,38,5,-17
-42.01174,-20.75749,57,40,5,-17
-42.00882,-20.75749,62,46,0,-16
-42.00612,-20.75749,61,43,0,-18
-42.00342,-20.75749,70,48,0,-22
-42.0005,-20.75749,69,41,0,-28
-41.99781,-20.75749,70,31,11,-39
-41.99511,-20.75749,69,27,5,-42
-41.99219,-20.75749,67,42,0,-25
-41.98949,-20.75749,70,45,0,-25
-41.98657,-20.75749,68,48,0,-20
-41.98387,-20.75749,64,48,0,-16
-41.98118,-20.75749,57,48,0,-9
-41.97826,-20.75749,68,46,0,-22
-41.97556,-20.75749,56,49,0,-7
-41.97286,-20.75749,72,40,5,-32
-41.96994,-20.75749,55,35,5,-20
-42.1005,-20.75728,68,34,0,-34
-42.0978,-20.75728,59,26,5,-33
-42.09511,-20.75728,59,28,5,-31
-42.09219,-20.75728,64,29,5,-35
-42.08949,-20.75728,57,30,5,-27
-42.08657,-20.75728,64,32,5,-32
-42.08387,-20.75728,53,32,5,-21
-42.08118,-20.75728,58,38,0,-20
-42.07825,-20.75728,58,38,0,-20
-42.07556,-20.75728,65,37,0,-28
-42.07286,-20.75728,62,38,0,-24
-42.06994,-20.75728,56,38,0,-18
-42.06724,-20.75728,57,34,5,-23
-42.06455,-20.75728,59,34,5,-25
-42.06163,-20.75728,61,41,5,-20
-42.05893,-20.75728,60,44,5,-16
-42.05601,-20.75728,60,38,5,-22
-42.05331,-20.75728,56,41,5,-15
-42.05061,-20.75728,57,36,0,-21
-42.04769,-20.75728,55,30,5,-25
-42.045,-20.75728,44,30,5,-14
-42.0423,-20.75728,41,37,5,-4
-42.03938,-20.75728,42,35,5,-7
-42.03668,-20.75728,39,36,5,-3
-42.03399,-20.75728,30,33,5,3
-42.03106,-20.75728,28,33,5,5
-42.02837,-20.75728,47,35,5,-12
-42.02545,-20.75728,56,39,0,-17
-42.02275,-20.75728,45,40,0,-5
-42.02005,-20.75728,47,41,0,-6
-42.01713,-20.75728,50,39,5,-11
-42.01444,-20.75728,56,39,5,-17
-42.01174,-20.75728,58,41,5,-17
-42.00882,-20.75728,64,46,0,-18
-42.00612,-20.75728,62,43,0,-19
-42.00342,-20.75728,64,49,0,-15
-42.0005,-20.75728,64,48,0,-16
-41.99781,-20.75728,69,31,5,-38
-41.99511,-20.75728,69,28,5,-41
-41.99219,-20.75728,68,42,0,-26
-41.98949,-20.75728,62,45,0,-17
-41.98657,-20.75728,66,47,0,-19
-41.98387,-20.75728,63,48,0,-15
-41.98118,-20.75728,58,48,0,-10
-41.97826,-20.75728,64,41,0,-23
-41.97556,-20.75728,56,49,0,-7
-41.97286,-20.75728,69,41,5,-28
-41.96994,-20.75728,55,35,5,-20
-42.1005,-20.75686,66,34,0,-32
-42.0978,-20.75686,59,26,5,-33
-42.09511,-20.75686,58,28,5,-30
-42.09219,-20.75686,63,29,5,-34
-42.08949,-20.75686,57,30,5,-27
-42.08657,-20.75686,64,32,5,-32
-42.08387,-20.75686,53,35,5,-18
-42.08118,-20.75686,58,38,0,-20
-42.07825,-20.75686,59,37,0,-22
-42.07556,-20.75686,65,37,5,-28
-42.07286,-20.75686,63,38,0,-25
-42.06994,-20.75686,56,37,5,-19
-42.06724,-20.75686,57,35,5,-22
-42.06455,-20.75686,59,36,5,-23
-42.06163,-20.75686,61,41,5,-20
-42.05893,-20.75686,60,43,5,-17
-42.05601,-20.75686,61,37,5,-24
-42.05331,-20.75686,56,43,5,-13
-42.05061,-20.75686,58,38,5,-20
-42.04769,-20.75686,55,30,5,-25
-42.045,-20.75686,48,30,5,-18
-42.0423,-20.75686,42,35,5,-7
-42.03938,-20.75686,44,36,5,-8
-42.03668,-20.75686,39,35,5,-4
-42.03399,-20.75686,39,36,5,-3
-42.03106,-20.75686,31,34,5,3
-42.02837,-20.75686,34,34,5,0
-42.02545,-20.75686,55,42,0,-13
-42.02275,-20.75686,45,40,0,-5
-42.02005,-20.75686,48,41,0,-7
-42.01713,-20.75686,50,40,5,-10
-42.01444,-20.75686,56,41,5,-15
-42.01174,-20.75686,58,41,5,-17
-42.00882,-20.75686,65,46,0,-19
-42.00612,-20.75686,62,42,0,-20
-42.00342,-20.75686,64,48,0,-16
-42.0005,-20.75686,61,52,0,-9
-41.99781,-20.75686,70,32,5,-38
-41.99511,-20.75686,69,31,5,-38
-41.99219,-20.75686,68,43,0,-25
-41.98949,-20.75686,63,45,11,-18
-41.98657,-20.75686,66,46,0,-20
-41.98387,-20.75686,64,48,0,-16
-41.98118,-20.75686,58,48,0,-10
-41.97826,-20.75686,58,36,5,-22
-41.97556,-20.75686,58,48,0,-10
-41.97286,-20.75686,63,42,5,-21
-41.96994,-20.75686,58,33,5,-25
-42.10297,-20.75665,66,34,0,-32
-42.10275,-20.75665,67,34,0,-33
-42.10252,-20.75665,68,34,0,-34
-42.1023,-20.75665,69,35,0,-34
-42.10185,-20.75665,69,35,0,-34
-42.10163,-20.75665,69,35,0,-34
-42.1014,-20.75665,69,35,0,-34
-42.10118,-20.75665,68,34,0,-34
-42.10073,-20.75665,66,34,0,-32
-42.1005,-20.75665,65,34,0,-31
-42.10028,-20.75665,63,34,0,-29
-42.10005,-20.75665,59,34,0,-25
-42.09983,-20.75665,62,34,0,-28
-42.09938,-20.75665,59,31,5,-28
-42.09915,-20.75665,58,26,5,-32
-42.09893,-20.75665,59,26,5,-33
-42.0987,-20.75665,59,26,5,-33
-42.09825,-20.75665,59,26,5,-33
-42.09803,-20.75665,59,26,5,-33
-42.0978,-20.75665,59,26,5,-33
-42.09758,-20.75665,60,26,5,-34
-42.09713,-20.75665,61,26,5,-35
-42.09691,-20.75665,61,26,5,-35
-42.09668,-20.75665,62,26,5,-36
-42.09646,-20.75665,65,27,5,-38
-42.09601,-20.75665,68,26,5,-42
-42.09578,-20.75665,67,27,5,-40
-42.09556,-20.75665,60,27,5,-33
-42.09533,-20.75665,60,28,5,-32
-42.09511,-20.75665,59,28,5,-31
-42.09466,-20.75665,59,27,5,-32
-42.09443,-20.75665,60,27,5,-33
-42.09421,-20.75665,61,29,5,-32
-42.09398,-20.75665,63,29,5,-34
-42.09354,-20.75665,64,29,5,-35
-42.09331,-20.75665,64,29,5,-35
-42.09309,-20.75665,65,30,5,-35
-42.09286,-20.75665,64,29,5,-35
-42.09241,-20.75665,64,29,5,-35
-42.09219,-20.75665,64,29,5,-35
-42.09196,-20.75665,60,28,5,-32
-42.09174,-20.75665,57,28,5,-29
-42.09129,-20.75665,57,28,5,-29
-42.09106,-20.75665,57,29,5,-28
-42.09084,-20.75665,57,29,5,-28
-42.09061,-20.75665,57,29,5,-28
-42.09039,-20.75665,57,28,5,-29
-42.08994,-20.75665,57,28,5,-29
-42.08972,-20.75665,57,28,5,-29
-42.08949,-20.75665,57,30,5,-27
-42.08927,-20.75665,57,29,5,-28
-42.08882,-20.75665,57,30,5,-27
-42.08859,-20.75665,57,31,5,-26
-42.08837,-20.75665,57,31,5,-26
-42.08814,-20.75665,58,32,5,-26
-42.08769,-20.75665,58,30,5,-28
-42.08747,-20.75665,59,30,5,-29
-42.08724,-20.75665,60,30,5,-30
-42.08702,-20.75665,63,31,5,-32
-42.08657,-20.75665,64,32,5,-32
-42.08634,-20.75665,64,32,5,-32
-42.08612,-20.75665,66,33,5,-33
-42.08589,-20.75665,64,32,5,-32
-42.08545,-20.75665,67,32,5,-35
-42.08522,-20.75665,66,32,5,-34
-42.085,-20.75665,63,33,5,-30
-42.08477,-20.75665,65,34,5,-31
-42.08455,-20.75665,57,34,5,-23
-42.0841,-20.75665,53,38,5,-15
-42.08387,-20.75665,53,38,5,-15
-42.08365,-20.75665,53,38,0,-15
-42.08342,-20.75665,53,38,0,-15
-42.08297,-20.75665,54,38,0,-16
-42.08275,-20.75665,54,38,0,-16
-42.08252,-20.75665,55,38,0,-17
-42.0823,-20.75665,55,38,0,-17
-42.08185,-20.75665,56,38,0,-18
-42.08163,-20.75665,57,38,0,-19
-42.0814,-20.75665,57,38,0,-19
-42.08118,-20.75665,58,38,0,-20
-42.08073,-20.75665,58,38,0,-20
-42.0805,-20.75665,58,38,0,-20
-42.08028,-20.75665,59,38,0,-21
-42.08005,-20.75665,58,38,0,-20
-42.07983,-20.75665,58,38,0,-20
-42.07938,-20.75665,58,38,0,-20
-42.07915,-20.75665,58,38,0,-20
-42.07893,-20.75665,59,38,0,-21
-42.0787,-20.75665,59,38,0,-21
-42.07825,-20.75665,59,37,0,-22
-42.07803,-20.75665,60,37,0,-23
-42.07781,-20.75665,60,37,5,-23
-42.07758,-20.75665,61,37,5,-24
-42.07713,-20.75665,61,37,5,-24
-42.07691,-20.75665,62,37,5,-25
-42.07668,-20.75665,64,36,5,-28
-42.07646,-20.75665,66,32,5,-34
-42.07601,-20.75665,64,32,5,-32
-42.07578,-20.75665,64,35,5,-29
-42.07556,-20.75665,65,37,5,-28
-42.07533,-20.75665,62,37,0,-25
-42.07511,-20.75665,61,37,0,-24
-42.07466,-20.75665,61,37,0,-24
-42.07443,-20.75665,61,37,0,-24
-42.07421,-20.75665,62,37,0,-25
-42.07399,-20.75665,57,37,0,-20
-42.07354,-20.75665,57,37,0,-20
-42.07331,-20.75665,61,37,0,-24
-42.07309,-20.75665,61,37,0,-24
-42.07286,-20.75665,63,37,0,-26
-42.07241,-20.75665,60,38,0,-22
-42.07219,-20.75665,52,38,0,-14
-42.07196,-20.75665,52,38,0,-14
-42.07174,-20.75665,53,38,0,-15
-42.07129,-20.75665,53,38,0,-15
-42.07106,-20.75665,54,38,0,-16
-42.07084,-20.75665,55,38,0,-17
-42.07061,-20.75665,55,38,0,-17
-42.07039,-20.75665,55,38,5,-17
-42.06994,-20.75665,56,36,5,-20
-42.06972,-20.75665,56,36,5,-20
-42.06949,-20.75665,56,35,5,-21
-42.06927,-20.75665,56,34,5,-22
-42.06882,-20.75665,57,34,5,-23
-42.06859,-20.75665,57,33,5,-24
-42.06837,-20.75665,57,34,5,-23
-42.06814,-20.75665,57,34,5,-23
-42.06769,-20.75665,57,34,5,-23
-42.06747,-20.75665,57,34,5,-23
-42.06724,-20.75665,57,35,5,-22
-42.06702,-20.75665,57,35,5,-22
-42.06657,-20.75665,57,35,5,-22
-42.06634,-20.75665,57,35,5,-22
-42.06612,-20.75665,57,34,5,-23
-42.0659,-20.75665,57,35,5,-22
-42.06545,-20.75665,57,33,5,-24
-42.06522,-20.75665,57,33,5,-24
-42.065,-20.75665,58,34,5,-24
-42.06477,-20.75665,58,36,5,-22
-42.06455,-20.75665,59,36,5,-23
-42.0641,-20.75665,59,35,5,-24
-42.06387,-20.75665,59,34,5,-25
-42.06365,-20.75665,60,35,5,-25
-42.06342,-20.75665,60,35,5,-25
-42.06297,-20.75665,60,36,5,-24
-42.06275,-20.75665,61,39,5,-22
-42.06252,-20.75665,61,41,5,-20
-42.0623,-20.75665,61,40,5,-21
-42.06185,-20.75665,61,44,5,-17
-42.06163,-20.75665,61,44,5,-17
-42.0614,-20.75665,61,44,5,-17
-42.06118,-20.75665,60,44,5,-16
-42.06073,-20.75665,60,44,5,-16
-42.0605,-20.75665,59,43,5,-16
-42.06028,-20.75665,59,43,5,-16
-42.06005,-20.75665,59,43,5,-16
-42.05983,-20.75665,59,44,5,-15
-42.05938,-20.75665,59,43,5,-16
-42.05915,-20.75665,60,43,5,-17
-42.05893,-20.75665,60,36,5,-24
-42.0587,-20.75665,60,36,5,-24
-42.05826,-20.75665,60,31,5,-29
-42.05803,-20.75665,61,37,5,-24
-42.05781,-20.75665,61,37,5,-24
-42.05758,-20.75665,61,37,5,-24
-42.05713,-20.75665,61,38,5,-23
-42.05691,-20.75665,61,38,5,-23
-42.05668,-20.75665,61,38,5,-23
-42.05646,-20.75665,61,36,5,-25
-42.05601,-20.75665,62,36,5,-26
-42.05578,-20.75665,64,37,5,-27
-42.05556,-20.75665,65,38,5,-27
-42.05533,-20.75665,63,38,5,-25
-42.05511,-20.75665,64,39,5,-25
-42.05466,-20.75665,60,40,5,-20
-42.05443,-20.75665,59,40,5,-19
-42.05421,-20.75665,56,40,5,-16
-42.05399,-20.75665,56,40,5,-16
-42.05354,-20.75665,56,40,5,-16
-42.05331,-20.75665,56,43,5,-13
-42.05309,-20.75665,56,43,5,-13
-42.05286,-20.75665,57,43,0,-14
-42.05241,-20.75665,57,41,0,-16
-42.05219,-20.75665,57,41,0,-16
-42.05196,-20.75665,56,41,0,-15
-42.05174,-20.75665,56,41,0,-15
-42.05129,-20.75665,56,41,0,-15
-42.05106,-20.75665,57,41,0,-16
-42.05084,-20.75665,58,41,0,-17
-42.05061,-20.75665,57,38,5,-19
-42.05039,-20.75665,58,36,5,-22
-42.04994,-20.75665,57,31,5,-26
-42.04972,-20.75665,57,31,5,-26
-42.04949,-20.75665,57,31,5,-26
-42.04927,-20.75665,57,31,5,-26
-42.04882,-20.75665,57,32,5,-25
-42.04859,-20.75665,57,31,5,-26
-42.04837,-20.75665,56,34,5,-22
-42.04814,-20.75665,56,31,5,-25
-42.04769,-20.75665,56,30,5,-26
-42.04747,-20.75665,56,30,5,-26
-42.04724,-20.75665,56,30,5,-26
-42.04702,-20.75665,55,29,5,-26
-42.04657,-20.75665,55,28,5,-27
-42.04635,-20.75665,54,28,5,-26
-42.04612,-20.75665,53,28,5,-25
-42.0459,-20.75665,52,27,5,-25
-42.04545,-20.75665,51,29,5,-22
-42.04522,-20.75665,50,29,5,-21
-42.045,-20.75665,49,29,5,-20
-42.04477,-20.75665,48,31,5,-17
-42.04455,-20.75665,46,32,5,-14
-42.0441,-20.75665,45,32,5,-13
-42.04387,-20.75665,44,31,5,-13
-42.04365,-20.75665,42,32,5,-10
-42.04342,-20.75665,43,33,5,-10
-42.04297,-20.75665,43,34,5,-9
-42.04275,-20.75665,43,35,5,-8
-42.04253,-20.75665,43,35,5,-8
-42.0423,-20.75665,43,36,5,-7
-42.04185,-20.75665,43,36,5,-7
-42.04163,-20.75665,42,35,5,-7
-42.0414,-20.75665,42,34,5,-8
-42.04118,-20.75665,42,40,5,-2
-42.04073,-20.75665,42,37,5,-5
-42.0405,-20.75665,42,37,5,-5
-42.04028,-20.75665,43,37,5,-6
-42.04005,-20.75665,43,38,5,-5
-42.03983,-20.75665,45,37,5,-8
-42.03938,-20.75665,47,37,5,-10
-42.03915,-20.75665,49,37,5,-12
-42.03893,-20.75665,49,37,5,-12
-42.0387,-20.75665,49,37,5,-12
-42.03826,-20.75665,49,37,5,-12
-42.03803,-20.75665,47,37,5,-10
-42.03781,-20.75665,45,37,5,-8
-42.03758,-20.75665,45,36,5,-9
-42.03713,-20.75665,42,35,5,-7
-42.03691,-20.75665,42,35,5,-7
-42.03668,-20.75665,41,36,5,-5
-42.03646,-20.75665,38,36,5,-2
-42.03601,-20.75665,37,36,5,-1
-42.03578,-20.75665,34,34,5,0
-42.03556,-20.75665,32,35,5,3
-42.03533,-20.75665,29,34,5,5
-42.03511,-20.75665,28,34,5,6
-42.03466,-20.75665,28,35,5,7
-42.03444,-20.75665,35,35,5,0
-42.03421,-20.75665,37,36,5,-1
-42.03399,-20.75665,42,38,5,-4
-42.03354,-20.75665,43,38,5,-5
-42.03331,-20.75665,42,37,5,-5
-42.03309,-20.75665,42,38,5,-4
-42.03286,-20.75665,40,38,5,-2
-42.03241,-20.75665,37,37,5,0
-42.03219,-20.75665,34,35,5,1
-42.03196,-20.75665,29,36,5,7
-42.03174,-20.75665,31,35,5,4
-42.03129,-20.75665,32,35,5,3
-42.03106,-20.75665,32,35,5,3
-42.03084,-20.75665,32,35,5,3
-42.03062,-20.75665,31,35,5,4
-42.03017,-20.75665,31,36,5,5
-42.02994,-20.75665,33,35,5,2
-42.02972,-20.75665,33,35,5,2
-42.02949,-20.75665,33,35,5,2
-42.02927,-20.75665,33,35,5,2
-42.02882,-20.75665,33,35,5,2
-42.02859,-20.75665,34,36,5,2
-42.02837,-20.75665,35,36,5,1
-42.02814,-20.75665,36,36,5,0
-42.02769,-20.75665,37,38,5,1
-42.02747,-20.75665,37,37,5,0
-42.02724,-20.75665,38,36,5,-2
-42.02702,-20.75665,38,36,5,-2
-42.02657,-20.75665,40,38,5,-2
-42.02635,-20.75665,51,48,5,-3
-42.02612,-20.75665,53,44,5,-9
-42.0259,-20.75665,54,43,0,-11
-42.02545,-20.75665,53,47,0,-6
-42.02522,-20.75665,56,46,0,-10
-42.025,-20.75665,56,46,0,-10
-42.02477,-20.75665,56,44,0,-12
-42.02455,-20.75665,56,44,0,-12
-42.0241,-20.75665,55,42,0,-13
-42.02387,-20.75665,51,42,0,-9
-42.02365,-20.75665,50,41,0,-9
-42.02342,-20.75665,49,41,0,-8
-42.02297,-20.75665,45,40,0,-5
-42.02275,-20.75665,45,40,0,-5
-42.02253,-20.75665,45,40,0,-5
-42.0223,-20.75665,46,40,0,-6
-42.02185,-20.75665,46,40,0,-6
-42.02163,-20.75665,46,40,0,-6
-42.0214,-20.75665,46,40,0,-6
-42.02118,-20.75665,47,40,0,-7
-42.02073,-20.75665,47,40,0,-7
-42.0205,-20.75665,48,41,0,-7
-42.02028,-20.75665,48,41,0,-7
-42.02005,-20.75665,48,47,0,-1
-42.01983,-20.75665,49,47,0,-2
-42.01938,-20.75665,49,47,5,-2
-42.01915,-20.75665,50,40,5,-10
-42.01893,-20.75665,50,40,5,-10
-42.01871,-20.75665,50,40,5,-10
-42.01826,-20.75665,50,49,11,-1
-42.01803,-20.75665,50,48,5,-2
-42.01781,-20.75665,50,40,5,-10
-42.01758,-20.75665,50,40,5,-10
-42.01713,-20.75665,51,40,5,-11
-42.01691,-20.75665,51,40,5,-11
-42.01668,-20.75665,52,40,5,-12
-42.01646,-20.75665,52,41,5,-11
-42.01601,-20.75665,53,41,5,-12
-42.01578,-20.75665,54,42,5,-12
-42.01556,-20.75665,55,42,5,-13
-42.01533,-20.75665,55,41,5,-14
-42.01511,-20.75665,55,41,5,-14
-42.01466,-20.75665,56,41,5,-15
-42.01444,-20.75665,56,41,5,-15
-42.01421,-20.75665,57,41,5,-16
-42.01399,-20.75665,57,40,5,-17
-42.01354,-20.75665,58,40,5,-18
-42.01331,-20.75665,58,41,5,-17
-42.01309,-20.75665,58,42,5,-16
-42.01286,-20.75665,58,41,5,-17
-42.01241,-20.75665,58,42,5,-16
-42.01219,-20.75665,59,41,5,-18
-42.01196,-20.75665,59,41,5,-18
-42.01174,-20.75665,59,41,5,-18
-42.01129,-20.75665,58,41,5,-17
-42.01106,-20.75665,59,43,5,-16
-42.01084,-20.75665,59,45,5,-14
-42.01062,-20.75665,58,44,5,-14
-42.01017,-20.75665,58,46,0,-12
-42.00994,-20.75665,57,45,0,-12
-42.00972,-20.75665,61,45,0,-16
-42.00949,-20.75665,65,44,0,-21
-42.00927,-20.75665,64,45,0,-19
-42.00882,-20.75665,66,44,0,-22
-42.00859,-20.75665,65,44,0,-21
-42.00837,-20.75665,65,43,0,-22
-42.00814,-20.75665,67,43,0,-24
-42.00769,-20.75665,67,41,0,-26
-42.00747,-20.75665,67,42,0,-25
-42.00724,-20.75665,67,42,0,-25
-42.00702,-20.75665,66,41,0,-25
-42.00657,-20.75665,65,41,0,-24
-42.00635,-20.75665,63,41,0,-22
-42.00612,-20.75665,62,42,0,-20
-42.0059,-20.75665,61,42,0,-19
-42.00545,-20.75665,60,43,0,-17
-42.00522,-20.75665,60,43,0,-17
-42.005,-20.75665,60,44,0,-16
-42.00477,-20.75665,60,44,0,-16
-42.00455,-20.75665,60,45,0,-15
-42.0041,-20.75665,60,46,0,-14
-42.00387,-20.75665,60,47,0,-13
-42.00365,-20.75665,62,47,0,-15
-42.00342,-20.75665,62,48,0,-14
-42.00298,-20.75665,65,51,0,-14
-42.00275,-20.75665,65,52,0,-13
-42.00253,-20.75665,65,52,0,-13
-42.0023,-20.75665,65,53,0,-12
-42.00185,-20.75665,62,53,0,-9
-42.00163,-20.75665,62,53,0,-9
-42.0014,-20.75665,62,52,0,-10
-42.00118,-20.75665,66,51,0,-15
-42.00073,-20.75665,61,52,0,-9
-42.0005,-20.75665,61,53,0,-8
-42.00028,-20.75665,61,53,0,-8
-42.00005,-20.75665,61,53,0,-8
-41.99983,-20.75665,61,53,0,-8
-41.99938,-20.75665,64,40,0,-24
-41.99916,-20.75665,60,40,0,-20
-41.99893,-20.75665,60,39,0,-21
-41.99871,-20.75665,61,38,5,-23
-41.99826,-20.75665,66,32,5,-34
-41.99803,-20.75665,70,32,5,-38
-41.99781,-20.75665,71,32,5,-39
-41.99758,-20.75665,72,32,5,-40
-41.99713,-20.75665,72,31,5,-41
-41.99691,-20.75665,72,31,0,-41
-41.99668,-20.75665,72,31,11,-41
-41.99646,-20.75665,71,31,0,-40
-41.99601,-20.75665,71,32,5,-39
-41.99578,-20.75665,71,31,5,-40
-41.99556,-20.75665,70,31,5,-39
-41.99533,-20.75665,71,29,5,-42
-41.99511,-20.75665,71,28,5,-43
-41.99466,-20.75665,70,31,5,-39
-41.99444,-20.75665,68,31,5,-37
-41.99421,-20.75665,67,32,5,-35
-41.99399,-20.75665,66,34,6,-32
-41.99354,-20.75665,68,37,6,-31
-41.99331,-20.75665,68,38,0,-30
-41.99309,-20.75665,68,39,0,-29
-41.99286,-20.75665,68,40,0,-28
-41.99241,-20.75665,68,41,0,-27
-41.99219,-20.75665,68,42,6,-26
-41.99196,-20.75665,68,43,6,-25
-41.99174,-20.75665,68,42,6,-26
-41.99129,-20.75665,68,39,0,-29
-41.99107,-20.75665,68,39,0,-29
-41.99084,-20.75665,68,41,0,-27
-41.99062,-20.75665,65,43,0,-22
-41.99017,-20.75665,63,44,0,-19
-41.98994,-20.75665,63,45,0,-18
-41.98972,-20.75665,63,45,0,-18
-41.98949,-20.75665,62,45,11,-17
-41.98927,-20.75665,68,45,0,-23
-41.98882,-20.75665,70,45,0,-25
-41.98859,-20.75665,70,45,0,-25
-41.98837,-20.75665,71,45,0,-26
-41.98814,-20.75665,71,45,0,-26
-41.98769,-20.75665,70,46,0,-24
-41.98747,-20.75665,70,46,0,-24
-41.98725,-20.75665,69,46,0,-23
-41.98702,-20.75665,68,46,0,-22
-41.98657,-20.75665,67,46,0,-21
-41.98635,-20.75665,67,47,0,-20
-41.98612,-20.75665,67,47,0,-20
-41.9859,-20.75665,66,47,0,-19
-41.98545,-20.75665,66,48,0,-18
-41.98522,-20.75665,65,48,0,-17
-41.985,-20.75665,65,48,0,-17
-41.98477,-20.75665,65,48,0,-17
-41.98455,-20.75665,64,48,0,-16
-41.9841,-20.75665,64,48,0,-16
-41.98387,-20.75665,64,48,0,-16
-41.98365,-20.75665,63,48,0,-15
-41.98343,-20.75665,63,48,0,-15
-41.98298,-20.75665,62,47,0,-15
-41.98275,-20.75665,62,47,0,-15
-41.98253,-20.75665,62,48,0,-14
-41.9823,-20.75665,61,48,0,-13
-41.98185,-20.75665,61,48,0,-13
-41.98163,-20.75665,61,48,0,-13
-41.9814,-20.75665,60,48,0,-12
-41.98118,-20.75665,59,48,0,-11
-41.98073,-20.75665,58,48,0,-10
-41.9805,-20.75665,56,48,0,-8
-41.98028,-20.75665,56,48,0,-8
-41.98005,-20.75665,56,48,0,-8
-41.97983,-20.75665,56,48,5,-8
-41.97938,-20.75665,56,48,5,-8
-41.97916,-20.75665,56,48,5,-8
-41.97893,-20.75665,56,39,5,-17
-41.97871,-20.75665,56,37,5,-19
-41.97826,-20.75665,64,37,5,-27
-41.97803,-20.75665,56,37,5,-19
-41.97781,-20.75665,69,38,5,-31
-41.97758,-20.75665,65,39,5,-26
-41.97713,-20.75665,66,37,5,-29
-41.97691,-20.75665,62,38,5,-24
-41.97668,-20.75665,56,40,5,-16
-41.97646,-20.75665,56,47,5,-9
-41.97601,-20.75665,56,48,5,-8
-41.97578,-20.75665,56,48,5,-8
-41.97556,-20.75665,66,48,0,-18
-41.97534,-20.75665,56,48,0,-8
-41.97511,-20.75665,56,48,0,-8
-41.97466,-20.75665,56,48,5,-8
-41.97444,-20.75665,55,48,5,-7
-41.97421,-20.75665,55,48,5,-7
-41.97399,-20.75665,55,48,5,-7
-41.97354,-20.75665,55,48,5,-7
-41.97331,-20.75665,55,48,5,-7
-41.97309,-20.75665,55,45,5,-10
-41.97286,-20.75665,59,48,5,-11
-41.97241,-20.75665,66,45,5,-21
-41.97219,-20.75665,68,39,5,-29
-41.97196,-20.75665,70,39,5,-31
-41.97174,-20.75665,70,37,5,-33
-41.97129,-20.75665,69,37,5,-32
-41.97107,-20.75665,67,35,5,-32
-41.97084,-20.75665,65,38,5,-27
-41.97062,-20.75665,65,38,5,-27
-41.97017,-20.75665,63,36,5,-27
-41.96994,-20.75665,61,33,5,-28
-41.96972,-20.75665,59,35,5,-24
-41.96949,-20.75665,55,37,5,-18
-41.96927,-20.75665,55,35,5,-20
-42.1005,-20.75644,60,34,0,-26
-42.0978,-20.75644,60,26,5,-34
-42.09511,-20.75644,61,28,5,-33
-42.09219,-20.75644,64,29,5,-35
-42.08949,-20.75644,57,29,5,-28
-42.08657,-20.75644,63,31,5,-32
-42.08387,-20.75644,54,38,0,-16
-42.08118,-20.75644,57,38,0,-19
-42.07825,-20.75644,60,37,0,-23
-42.07556,-20.75644,64,35,5,-29
-42.07286,-20.75644,65,37,0,-28
-42.06994,-20.75644,55,36,5,-19
-42.06724,-20.75644,57,34,5,-23
-42.06455,-20.75644,59,36,5,-23
-42.06163,-20.75644,61,44,5,-17
-42.05893,-20.75644,60,37,5,-23
-42.05601,-20.75644,63,36,5,-27
-42.05331,-20.75644,59,41,5,-18
-42.05061,-20.75644,58,41,5,-17
-42.04769,-20.75644,56,30,5,-26
-42.045,-20.75644,50,29,5,-21
-42.0423,-20.75644,43,35,5,-8
-42.03938,-20.75644,49,39,5,-10
-42.03668,-20.75644,44,35,5,-9
-42.03399,-20.75644,40,38,5,-2
-42.03106,-20.75644,33,36,5,3
-42.02837,-20.75644,35,37,5,2
-42.02545,-20.75644,53,48,0,-5
-42.02275,-20.75644,46,40,0,-6
-42.02005,-20.75644,49,47,0,-2
-42.01713,-20.75644,51,41,5,-10
-42.01444,-20.75644,57,41,5,-16
-42.01174,-20.75644,59,45,5,-14
-42.00882,-20.75644,67,44,0,-23
-42.00612,-20.75644,63,42,0,-21
-42.00342,-20.75644,60,48,0,-12
-42.0005,-20.75644,61,53,0,-8
-41.99781,-20.75644,62,32,5,-30
-41.99511,-20.75644,71,29,5,-42
-41.99219,-20.75644,68,38,0,-30
-41.98949,-20.75644,63,45,0,-18
-41.98657,-20.75644,69,47,0,-22
-41.98387,-20.75644,64,48,0,-16
-41.98118,-20.75644,58,48,0,-10
-41.97826,-20.75644,55,40,5,-15
-41.97556,-20.75644,61,48,0,-13
-41.97286,-20.75644,55,48,5,-7
-41.96994,-20.75644,62,36,5,-26
-42.1005,-20.75601,58,34,0,-24
-42.0978,-20.75601,60,29,0,-31
-42.09511,-20.75601,62,29,5,-33
-42.09219,-20.75601,65,28,5,-37
-42.08949,-20.75601,57,29,5,-28
-42.08657,-20.75601,61,32,5,-29
-42.08387,-20.75601,55,38,0,-17
-42.08118,-20.75601,57,38,0,-19
-42.07825,-20.75601,59,32,5,-27
-42.07556,-20.75601,66,31,5,-35
-42.07286,-20.75601,63,37,0,-26
-42.06994,-20.75601,55,35,5,-20
-42.06724,-20.75601,57,35,5,-22
-42.06455,-20.75601,59,37,5,-22
-42.06163,-20.75601,61,43,5,-18
-42.05893,-20.75601,61,37,5,-24
-42.05601,-20.75601,62,37,5,-25
-42.05331,-20.75601,62,38,5,-24
-42.05061,-20.75601,59,41,5,-18
-42.04769,-20.75601,57,31,5,-26
-42.045,-20.75601,52,30,5,-22
-42.0423,-20.75601,44,35,5,-9
-42.03938,-20.75601,51,39,5,-12
-42.03668,-20.75601,46,36,5,-10
-42.03399,-20.75601,41,41,5,0
-42.03106,-20.75601,38,37,5,-1
-42.02837,-20.75601,36,44,0,8
-42.02545,-20.75601,52,47,0,-5
-42.02275,-20.75601,47,40,0,-7
-42.02005,-20.75601,49,47,0,-2
-42.01713,-20.75601,52,41,5,-11
-42.01444,-20.75601,57,43,5,-14
-42.01174,-20.75601,59,45,5,-14
-42.00882,-20.75601,64,43,0,-21
-42.00612,-20.75601,66,42,0,-24
-42.00342,-20.75601,61,45,0,-16
-42.0005,-20.75601,61,53,0,-8
-41.99781,-20.75601,60,34,5,-26
-41.99511,-20.75601,65,33,5,-32
-41.99219,-20.75601,68,38,0,-30
-41.98949,-20.75601,63,45,0,-18
-41.98657,-20.75601,70,47,0,-23
-41.98387,-20.75601,64,45,0,-19
-41.98118,-20.75601,58,48,0,-10
-41.97826,-20.75601,63,47,5,-16
-41.97556,-20.75601,56,47,0,-9
-41.97286,-20.75601,55,48,5,-7
-41.96994,-20.75601,61,37,5,-24
-42.1005,-20.7558,59,34,0,-25
-42.0978,-20.7558,60,29,0,-31
-42.09511,-20.7558,63,29,5,-34
-42.09219,-20.7558,66,29,5,-37
-42.08949,-20.7558,57,29,5,-28
-42.08657,-20.7558,59,32,5,-27
-42.08387,-20.7558,58,38,0,-20
-42.08118,-20.7558,57,38,0,-19
-42.07825,-20.7558,59,33,5,-26
-42.07556,-20.7558,67,31,5,-36
-42.07286,-20.7558,65,37,0,-28
-42.06994,-20.7558,55,35,5,-20
-42.06724,-20.7558,57,35,5,-22
-42.06455,-20.7558,59,38,5,-21
-42.06163,-20.7558,61,43,5,-18
-42.05893,-20.7558,61,38,5,-23
-42.05601,-20.7558,60,36,5,-24
-42.05331,-20.7558,58,38,5,-20
-42.05061,-20.7558,59,41,0,-18
-42.04769,-20.7558,57,31,5,-26
-42.045,-20.7558,54,30,5,-24
-42.0423,-20.7558,44,35,5,-9
-42.03938,-20.7558,52,56,5,4
-42.03668,-20.7558,47,38,5,-9
-42.03399,-20.7558,43,41,5,-2
-42.03106,-20.7558,43,39,5,-4
-42.02837,-20.7558,37,41,0,4
-42.02545,-20.7558,41,43,0,2
-42.02275,-20.7558,48,39,0,-9
-42.02005,-20.7558,50,47,0,-3
-42.01713,-20.7558,53,42,5,-11
-42.01444,-20.7558,58,41,5,-17
-42.01174,-20.7558,60,43,5,-17
-42.00882,-20.7558,60,42,0,-18
-42.00612,-20.7558,65,41,0,-24
-42.00342,-20.7558,62,43,0,-19
-42.0005,-20.7558,61,52,0,-9
-41.99781,-20.7558,60,34,5,-26
-41.99511,-20.7558,60,36,0,-24
-41.99219,-20.7558,67,38,0,-29
-41.98949,-20.7558,64,44,0,-20
-41.98657,-20.7558,71,47,0,-24
-41.98387,-20.7558,64,44,0,-20
-41.98118,-20.7558,59,45,0,-14
-41.97826,-20.7558,66,47,0,-19
-41.97556,-20.7558,56,47,5,-9
-41.97286,-20.7558,55,47,5,-8
-41.96994,-20.7558,62,42,5,-20
-42.1005,-20.75559,59,34,0,-25
-42.0978,-20.75559,60,30,0,-30
-42.09511,-20.75559,64,30,5,-34
-42.09219,-20.75559,66,28,5,-38
-42.08949,-20.75559,57,29,5,-28
-42.08657,-20.75559,58,32,5,-26
-42.08387,-20.75559,61,38,0,-23
-42.08118,-20.75559,57,38,0,-19
-42.07825,-20.75559,60,33,5,-27
-42.07556,-20.75559,64,31,5,-33
-42.07286,-20.75559,64,37,0,-27
-42.06994,-20.75559,54,35,5,-19
-42.06724,-20.75559,57,35,5,-22
-42.06455,-20.75559,59,38,5,-21
-42.06163,-20.75559,61,43,5,-18
-42.05893,-20.75559,61,37,5,-24
-42.05601,-20.75559,62,36,5,-26
-42.05331,-20.75559,56,39,5,-17
-42.05061,-20.75559,58,41,0,-17
-42.04769,-20.75559,58,32,5,-26
-42.045,-20.75559,55,31,5,-24
-42.0423,-20.75559,45,36,5,-9
-42.03938,-20.75559,53,56,5,3
-42.03668,-20.75559,50,41,5,-9
-42.03399,-20.75559,44,40,5,-4
-42.03106,-20.75559,49,40,5,-9
-42.02837,-20.75559,37,40,0,3
-42.02545,-20.75559,41,42,0,1
-42.02275,-20.75559,49,39,0,-10
-42.02005,-20.75559,50,47,0,-3
-42.01713,-20.75559,54,42,5,-12
-42.01444,-20.75559,58,44,5,-14
-42.01174,-20.75559,60,43,5,-17
-42.00882,-20.75559,57,41,5,-16
-42.00612,-20.75559,61,41,0,-20
-42.00342,-20.75559,61,40,0,-21
-42.0005,-20.75559,61,51,0,-10
-41.99781,-20.75559,60,35,5,-25
-41.99511,-20.75559,60,36,0,-24
-41.99219,-20.75559,66,39,0,-27
-41.98949,-20.75559,65,45,0,-20
-41.98657,-20.75559,69,47,0,-22
-41.98387,-20.75559,64,42,0,-22
-41.98118,-20.75559,59,43,0,-16
-41.97826,-20.75559,66,47,0,-19
-41.97556,-20.75559,56,47,5,-9
-41.97286,-20.75559,55,47,5,-8
-41.96994,-20.75559,62,47,5,-15
-42.1005,-20.75538,59,34,0,-25
-42.0978,-20.75538,61,30,0,-31
-42.09511,-20.75538,66,33,0,-33
-42.09219,-20.75538,65,28,5,-37
-42.08949,-20.75538,57,29,5,-28
-42.08657,-20.75538,58,32,5,-26
-42.08387,-20.75538,62,38,0,-24
-42.08118,-20.75538,59,38,0,-21
-42.07825,-20.75538,58,33,5,-25
-42.07556,-20.75538,64,31,5,-33
-42.07286,-20.75538,62,37,0,-25
-42.06994,-20.75538,54,35,5,-19
-42.06724,-20.75538,57,34,5,-23
-42.06455,-20.75538,58,37,5,-21
-42.06163,-20.75538,61,43,5,-18
-42.05893,-20.75538,61,37,5,-24
-42.05601,-20.75538,54,37,5,-17
-42.05331,-20.75538,55,39,5,-16
-42.05061,-20.75538,57,41,0,-16
-42.04769,-20.75538,58,32,5,-26
-42.045,-20.75538,56,32,5,-24
-42.0423,-20.75538,47,35,5,-12
-42.03938,-20.75538,54,56,5,2
-42.03668,-20.75538,51,44,5,-7
-42.03399,-20.75538,45,48,5,3
-42.03106,-20.75538,51,42,5,-9
-42.02837,-20.75538,38,40,0,2
-42.02545,-20.75538,43,43,0,0
-42.02275,-20.75538,50,39,0,-11
-42.02005,-20.75538,52,47,11,-5
-42.01713,-20.75538,55,43,5,-12
-42.01444,-20.75538,58,47,5,-11
-42.01174,-20.75538,61,39,5,-22
-42.00882,-20.75538,58,37,5,-21
-42.00612,-20.75538,60,41,0,-19
-42.00342,-20.75538,61,37,0,-24
-42.0005,-20.75538,61,50,0,-11
-41.99781,-20.75538,61,43,5,-18
-41.99511,-20.75538,60,41,0,-19
-41.99219,-20.75538,66,40,0,-26
-41.98949,-20.75538,65,45,0,-20
-41.98657,-20.75538,68,47,0,-21
-41.98387,-20.75538,64,39,0,-25
-41.98118,-20.75538,58,42,0,-16
-41.97826,-20.75538,67,47,0,-20
-41.97556,-20.75538,57,47,5,-10
-41.97286,-20.75538,54,47,5,-7
-41.96994,-20.75538,63,47,0,-16
-42.1005,-20.75496,59,34,0,-25
-42.0978,-20.75496,61,31,0,-30
-42.09511,-20.75496,65,29,5,-36
-42.09219,-20.75496,64,27,5,-37
-42.08949,-20.75496,57,30,5,-27
-42.08657,-20.75496,58,33,5,-25
-42.08387,-20.75496,63,38,0,-25
-42.08118,-20.75496,59,38,5,-21
-42.07825,-20.75496,58,33,5,-25
-42.07556,-20.75496,63,32,5,-31
-42.07286,-20.75496,62,37,0,-25
-42.06994,-20.75496,53,35,5,-18
-42.06724,-20.75496,57,35,5,-22
-42.06455,-20.75496,59,36,5,-23
-42.06163,-20.75496,62,42,5,-20
-42.05893,-20.75496,62,37,5,-25
-42.05601,-20.75496,54,37,5,-17
-42.05331,-20.75496,55,38,5,-17
-42.05061,-20.75496,57,41,0,-16
-42.04769,-20.75496,58,32,5,-26
-42.045,-20.75496,56,35,5,-21
-42.0423,-20.75496,49,36,5,-13
-42.03938,-20.75496,52,40,5,-12
-42.03668,-20.75496,46,44,5,-2
-42.03399,-20.75496,38,37,5,-1
-42.03106,-20.75496,53,42,5,-11
-42.02837,-20.75496,39,40,0,1
-42.02545,-20.75496,43,41,0,-2
-42.02275,-20.75496,50,39,0,-11
-42.02005,-20.75496,53,47,0,-6
-42.01713,-20.75496,56,43,5,-13
-42.01444,-20.75496,59,47,5,-12
-42.01174,-20.75496,61,39,5,-22
-42.00882,-20.75496,58,38,5,-20
-42.00612,-20.75496,63,40,0,-23
-42.00342,-20.75496,62,35,0,-27
-42.0005,-20.75496,61,43,0,-18
-41.99781,-20.75496,61,46,0,-15
-41.99511,-20.75496,60,44,0,-16
-41.99219,-20.75496,66,40,0,-26
-41.98949,-20.75496,65,45,0,-20
-41.98657,-20.75496,68,47,0,-21
-41.98387,-20.75496,65,33,5,-32
-41.98118,-20.75496,57,40,0,-17
-41.97826,-20.75496,68,47,0,-21
-41.97556,-20.75496,56,36,5,-20
-41.97286,-20.75496,54,47,5,-7
-41.96994,-20.75496,65,47,0,-18
-42.1005,-20.75474,59,34,0,-25
-42.0978,-20.75474,61,31,0,-30
-42.09511,-20.75474,66,28,5,-38
-42.09219,-20.75474,65,27,5,-38
-42.08949,-20.75474,57,30,5,-27
-42.08657,-20.75474,58,33,5,-25
-42.08387,-20.75474,62,38,5,-24
-42.08118,-20.75474,59,32,5,-27
-42.07825,-20.75474,58,32,5,-26
-42.07556,-20.75474,62,33,5,-29
-42.07286,-20.75474,61,37,0,-24
-42.06994,-20.75474,53,34,5,-19
-42.06724,-20.75474,57,34,5,-23
-42.06455,-20.75474,59,35,5,-24
-42.06163,-20.75474,62,40,5,-22
-42.05893,-20.75474,62,37,5,-25
-42.05601,-20.75474,54,37,5,-17
-42.05331,-20.75474,56,39,5,-17
-42.05061,-20.75474,56,41,0,-15
-42.04769,-20.75474,59,32,5,-27
-42.045,-20.75474,57,35,5,-22
-42.0423,-20.75474,53,36,5,-17
-42.03938,-20.75474,51,43,5,-8
-42.03668,-20.75474,43,44,5,1
-42.03399,-20.75474,31,36,5,5
-42.03106,-20.75474,54,45,5,-9
-42.02837,-20.75474,39,41,0,2
-42.02545,-20.75474,43,40,0,-3
-42.02275,-20.75474,51,38,0,-13
-42.02005,-20.75474,54,47,0,-7
-42.01713,-20.75474,55,42,5,-13
-42.01444,-20.75474,58,42,5,-16
-42.01174,-20.75474,62,39,5,-23
-42.00882,-20.75474,59,37,5,-22
-42.00612,-20.75474,64,40,0,-24
-42.00342,-20.75474,62,36,0,-26
-42.0005,-20.75474,62,42,0,-20
-41.99781,-20.75474,61,46,0,-15
-41.99511,-20.75474,60,43,0,-17
-41.99219,-20.75474,66,41,0,-25
-41.98949,-20.75474,66,46,0,-20
-41.98657,-20.75474,69,47,0,-22
-41.98387,-20.75474,65,32,5,-33
-41.98118,-20.75474,57,39,0,-18
-41.97826,-20.75474,65,44,0,-21
-41.97556,-20.75474,56,36,5,-20
-41.97286,-20.75474,54,38,5,-16
-41.96994,-20.75474,66,47,0,-19
-42.1005,-20.75453,59,34,0,-25
-42.0978,-20.75453,62,32,0,-30
-42.09511,-20.75453,65,28,5,-37
-42.09219,-20.75453,66,27,5,-39
-42.08949,-20.75453,57,30,5,-27
-42.08657,-20.75453,58,33,5,-25
-42.08387,-20.75453,64,38,5,-26
-42.08118,-20.75453,61,32,5,-29
-42.07825,-20.75453,57,33,5,-24
-42.07556,-20.75453,62,33,5,-29
-42.07286,-20.75453,63,37,0,-26
-42.06994,-20.75453,53,35,5,-18
-42.06724,-20.75453,56,34,5,-22
-42.06455,-20.75453,58,35,5,-23
-42.06163,-20.75453,62,41,5,-21
-42.05893,-20.75453,63,37,5,-26
-42.05601,-20.75453,54,37,5,-17
-42.05331,-20.75453,56,38,5,-18
-42.05061,-20.75453,57,41,0,-16
-42.04769,-20.75453,60,32,5,-28
-42.045,-20.75453,60,34,5,-26
-42.0423,-20.75453,55,37,5,-18
-42.03938,-20.75453,51,46,5,-5
-42.03668,-20.75453,38,40,5,2
-42.03399,-20.75453,22,40,5,18
-42.03106,-20.75453,58,45,5,-13
-42.02837,-20.75453,39,47,0,8
-42.02545,-20.75453,43,40,5,-3
-42.02275,-20.75453,51,37,5,-14
-42.02005,-20.75453,56,48,0,-8
-42.01713,-20.75453,56,42,5,-14
-42.01444,-20.75453,58,43,5,-15
-42.01174,-20.75453,62,40,5,-22
-42.00882,-20.75453,60,37,5,-23
-42.00612,-20.75453,61,39,0,-22
-42.00342,-20.75453,62,36,0,-26
-42.0005,-20.75453,62,42,0,-20
-41.99781,-20.75453,61,45,0,-16
-41.99511,-20.75453,61,43,0,-18
-41.99219,-20.75453,67,44,0,-23
-41.98949,-20.75453,66,46,0,-20
-41.98657,-20.75453,69,47,0,-22
-41.98387,-20.75453,66,32,5,-34
-41.98118,-20.75453,57,38,0,-19
-41.97826,-20.75453,63,44,0,-19
-41.97556,-20.75453,56,42,5,-14
-41.97286,-20.75453,54,46,5,-8
-41.96994,-20.75453,66,47,0,-19
-42.1005,-20.75411,59,34,0,-25
-42.0978,-20.75411,65,33,0,-32
-42.09511,-20.75411,64,27,5,-37
-42.09219,-20.75411,65,27,5,-38
-42.08949,-20.75411,57,31,5,-26
-42.08657,-20.75411,58,34,5,-24
-42.08387,-20.75411,64,36,5,-28
-42.08118,-20.75411,62,32,5,-30
-42.07825,-20.75411,58,31,5,-27
-42.07556,-20.75411,63,34,5,-29
-42.07286,-20.75411,61,32,5,-29
-42.06994,-20.75411,52,34,5,-18
-42.06724,-20.75411,56,35,5,-21
-42.06455,-20.75411,58,36,5,-22
-42.06163,-20.75411,62,33,5,-29
-42.05893,-20.75411,66,38,5,-28
-42.05601,-20.75411,54,39,5,-15
-42.05331,-20.75411,57,39,5,-18
-42.05061,-20.75411,61,42,0,-19
-42.04769,-20.75411,60,30,5,-30
-42.045,-20.75411,60,28,5,-32
-42.0423,-20.75411,51,37,5,-14
-42.03938,-20.75411,50,39,5,-11
-42.03668,-20.75411,38,44,0,6
-42.03399,-20.75411,22,45,0,23
-42.03106,-20.75411,56,43,5,-13
-42.02837,-20.75411,40,47,0,7
-42.02545,-20.75411,44,36,5,-8
-42.02275,-20.75411,52,34,5,-18
-42.02005,-20.75411,57,48,0,-9
-42.01713,-20.75411,59,42,5,-17
-42.01444,-20.75411,63,43,5,-20
-42.01174,-20.75411,63,40,5,-23
-42.00882,-20.75411,61,39,5,-22
-42.00612,-20.75411,62,42,0,-20
-42.00342,-20.75411,63,40,0,-23
-42.0005,-20.75411,62,39,0,-23
-41.99781,-20.75411,62,44,0,-18
-41.99511,-20.75411,63,41,0,-22
-41.99219,-20.75411,67,43,6,-24
-41.98949,-20.75411,67,46,0,-21
-41.98657,-20.75411,68,47,0,-21
-41.98387,-20.75411,67,33,5,-34
-41.98118,-20.75411,57,38,0,-19
-41.97826,-20.75411,63,42,0,-21
-41.97556,-20.75411,56,46,0,-10
-41.97286,-20.75411,61,40,5,-21
-41.96994,-20.75411,66,48,0,-18
-42.10297,-20.7539,67,28,0,-39
-42.10275,-20.7539,67,29,0,-38
-42.10252,-20.7539,68,29,0,-39
-42.1023,-20.7539,68,30,0,-38
-42.10185,-20.7539,66,34,0,-32
-42.10163,-20.7539,59,34,0,-25
-42.1014,-20.7539,59,34,0,-25
-42.10118,-20.7539,59,34,0,-25
-42.10073,-20.7539,59,34,0,-25
-42.1005,-20.7539,59,34,0,-25
-42.10028,-20.7539,59,34,0,-25
-42.10005,-20.7539,59,34,0,-25
-42.09983,-20.7539,59,33,0,-26
-42.09938,-20.7539,61,33,0,-28
-42.09915,-20.7539,62,33,0,-29
-42.09893,-20.7539,62,33,0,-29
-42.0987,-20.7539,63,33,0,-30
-42.09825,-20.7539,64,33,0,-31
-42.09803,-20.7539,65,33,0,-32
-42.0978,-20.7539,64,33,0,-31
-42.09758,-20.7539,62,33,0,-29
-42.09713,-20.7539,62,33,0,-29
-42.09691,-20.7539,62,33,0,-29
-42.09668,-20.7539,62,33,0,-29
-42.09646,-20.7539,63,30,5,-33
-42.09601,-20.7539,63,27,5,-36
-42.09578,-20.7539,63,27,5,-36
-42.09556,-20.7539,63,27,5,-36
-42.09533,-20.7539,63,27,5,-36
-42.09511,-20.7539,64,27,5,-37
-42.09466,-20.7539,64,27,5,-37
-42.09443,-20.7539,66,27,5,-39
-42.09421,-20.7539,66,27,5,-39
-42.09398,-20.7539,66,28,5,-38
-42.09354,-20.7539,66,27,5,-39
-42.09331,-20.7539,67,28,5,-39
-42.09309,-20.7539,67,28,5,-39
-42.09286,-20.7539,66,28,5,-38
-42.09241,-20.7539,66,28,5,-38
-42.09219,-20.7539,65,28,5,-37
-42.09196,-20.7539,63,28,5,-35
-42.09174,-20.7539,62,29,5,-33
-42.09129,-20.7539,59,27,5,-32
-42.09106,-20.7539,57,27,5,-30
-42.09084,-20.7539,56,27,5,-29
-42.09061,-20.7539,56,29,5,-27
-42.09039,-20.7539,56,30,5,-26
-42.08994,-20.7539,56,30,5,-26
-42.08972,-20.7539,57,31,5,-26
-42.08949,-20.7539,57,32,5,-25
-42.08927,-20.7539,58,32,5,-26
-42.08882,-20.7539,58,31,5,-27
-42.08859,-20.7539,58,31,5,-27
-42.08837,-20.7539,59,32,5,-27
-42.08814,-20.7539,59,32,5,-27
-42.08769,-20.7539,59,34,5,-25
-42.08747,-20.7539,59,35,5,-24
-42.08724,-20.7539,59,39,5,-20
-42.08702,-20.7539,59,39,5,-20
-42.08657,-20.7539,59,39,5,-20
-42.08634,-20.7539,59,39,5,-20
-42.08612,-20.7539,59,39,5,-20
-42.08589,-20.7539,58,39,5,-19
-42.08545,-20.7539,58,39,0,-19
-42.08522,-20.7539,58,38,0,-20
-42.085,-20.7539,58,38,0,-20
-42.08477,-20.7539,58,38,0,-20
-42.08455,-20.7539,61,38,0,-23
-42.0841,-20.7539,62,38,0,-24
-42.08387,-20.7539,64,38,5,-26
-42.08365,-20.7539,61,32,5,-29
-42.08342,-20.7539,62,34,5,-28
-42.08297,-20.7539,57,38,5,-19
-42.08275,-20.7539,57,38,5,-19
-42.08252,-20.7539,57,38,5,-19
-42.0823,-20.7539,57,38,5,-19
-42.08185,-20.7539,58,32,5,-26
-42.08163,-20.7539,59,32,5,-27
-42.0814,-20.7539,62,32,5,-30
-42.08118,-20.7539,62,32,5,-30
-42.08073,-20.7539,62,31,5,-31
-42.0805,-20.7539,63,31,5,-32
-42.08028,-20.7539,63,31,5,-32
-42.08005,-20.7539,63,33,5,-30
-42.07983,-20.7539,63,33,5,-30
-42.07938,-20.7539,63,34,5,-29
-42.07915,-20.7539,62,33,5,-29
-42.07893,-20.7539,62,32,5,-30
-42.0787,-20.7539,61,31,5,-30
-42.07825,-20.7539,56,31,5,-25
-42.07803,-20.7539,57,31,5,-26
-42.07781,-20.7539,57,32,5,-25
-42.07758,-20.7539,58,33,5,-25
-42.07713,-20.7539,58,36,5,-22
-42.07691,-20.7539,59,38,5,-21
-42.07668,-20.7539,60,38,5,-22
-42.07646,-20.7539,61,34,5,-27
-42.07601,-20.7539,62,34,5,-28
-42.07578,-20.7539,62,34,5,-28
-42.07556,-20.7539,63,34,5,-29
-42.07533,-20.7539,63,33,5,-30
-42.07511,-20.7539,64,33,5,-31
-42.07466,-20.7539,64,37,5,-27
-42.07443,-20.7539,64,37,5,-27
-42.07421,-20.7539,64,37,5,-27
-42.07399,-20.7539,61,37,5,-24
-42.07354,-20.7539,60,37,0,-23
-42.07331,-20.7539,62,37,5,-25
-42.07309,-20.7539,61,33,5,-28
-42.07286,-20.7539,60,32,5,-28
-42.07241,-20.7539,59,32,5,-27
-42.07219,-20.7539,56,32,5,-24
-42.07196,-20.7539,54,32,5,-22
-42.07174,-20.7539,50,32,5,-18
-42.07129,-20.7539,50,35,5,-15
-42.07106,-20.7539,51,35,5,-16
-42.07084,-20.7539,51,35,5,-16
-42.07061,-20.7539,51,35,5,-16
-42.07039,-20.7539,52,37,5,-15
-42.06994,-20.7539,52,36,5,-16
-42.06972,-20.7539,52,35,5,-17
-42.06949,-20.7539,53,34,5,-19
-42.06927,-20.7539,53,34,5,-19
-42.06882,-20.7539,53,34,5,-19
-42.06859,-20.7539,54,34,5,-20
-42.06837,-20.7539,54,34,5,-20
-42.06814,-20.7539,55,34,5,-21
-42.06769,-20.7539,55,34,5,-21
-42.06747,-20.7539,56,34,5,-22
-42.06724,-20.7539,56,35,5,-21
-42.06702,-20.7539,56,35,5,-21
-42.06657,-20.7539,56,35,5,-21
-42.06634,-20.7539,57,36,5,-21
-42.06612,-20.7539,57,36,5,-21
-42.0659,-20.7539,57,36,5,-21
-42.06545,-20.7539,57,36,5,-21
-42.06522,-20.7539,57,35,5,-22
-42.065,-20.7539,58,35,5,-23
-42.06477,-20.7539,58,36,5,-22
-42.06455,-20.7539,59,36,5,-23
-42.0641,-20.7539,59,38,5,-21
-42.06387,-20.7539,59,38,5,-21
-42.06365,-20.7539,60,38,5,-22
-42.06342,-20.7539,60,38,5,-22
-42.06297,-20.7539,60,40,5,-20
-42.06275,-20.7539,62,40,5,-22
-42.06252,-20.7539,62,40,5,-22
-42.0623,-20.7539,64,40,5,-24
-42.06185,-20.7539,64,39,5,-25
-42.06163,-20.7539,61,39,5,-22
-42.0614,-20.7539,63,31,5,-32
-42.06118,-20.7539,60,31,5,-29
-42.06073,-20.7539,60,32,5,-28
-42.0605,-20.7539,61,33,5,-28
-42.06028,-20.7539,62,35,5,-27
-42.06005,-20.7539,63,36,5,-27
-42.05983,-20.7539,63,36,5,-27
-42.05938,-20.7539,65,37,5,-28
-42.05915,-20.7539,67,37,5,-30
-42.05893,-20.7539,67,38,5,-29
-42.0587,-20.7539,65,37,5,-28
-42.05826,-20.7539,64,34,5,-30
-42.05803,-20.7539,63,35,5,-28
-42.05781,-20.7539,60,34,5,-26
-42.05758,-20.7539,53,34,5,-19
-42.05713,-20.7539,54,35,5,-19
-42.05691,-20.7539,54,37,5,-17
-42.05668,-20.7539,54,37,5,-17
-42.05646,-20.7539,54,37,5,-17
-42.05601,-20.7539,54,38,5,-16
-42.05578,-20.7539,54,39,5,-15
-42.05556,-20.7539,55,38,5,-17
-42.05533,-20.7539,55,36,5,-19
-42.05511,-20.7539,55,41,5,-14
-42.05466,-20.7539,56,39,5,-17
-42.05443,-20.7539,56,39,5,-17
-42.05421,-20.7539,56,39,5,-17
-42.05399,-20.7539,57,41,5,-16
-42.05354,-20.7539,57,39,5,-18
-42.05331,-20.7539,57,39,5,-18
-42.05309,-20.7539,57,39,5,-18
-42.05286,-20.7539,57,40,11,-17
-42.05241,-20.7539,57,40,5,-17
-42.05219,-20.7539,57,44,5,-13
-42.05196,-20.7539,57,44,0,-13
-42.05174,-20.7539,56,44,0,-12
-42.05129,-20.7539,56,44,0,-12
-42.05106,-20.7539,56,44,0,-12
-42.05084,-20.7539,56,42,0,-14
-42.05061,-20.7539,56,42,0,-14
-42.05039,-20.7539,56,42,0,-14
-42.04994,-20.7539,57,40,0,-17
-42.04972,-20.7539,57,39,0,-18
-42.04949,-20.7539,58,32,0,-26
-42.04927,-20.7539,59,31,0,-28
-42.04882,-20.7539,60,30,0,-30
-42.04859,-20.7539,60,29,0,-31
-42.04837,-20.7539,60,29,11,-31
-42.04814,-20.7539,60,29,11,-31
-42.04769,-20.7539,60,30,11,-30
-42.04747,-20.7539,60,30,11,-30
-42.04724,-20.7539,60,30,11,-30
-42.04702,-20.7539,60,30,11,-30
-42.04657,-20.7539,61,30,11,-31
-42.04635,-20.7539,60,29,0,-31
-42.04612,-20.7539,59,29,0,-30
-42.0459,-20.7539,58,29,0,-29
-42.04545,-20.7539,58,29,5,-29
-42.04522,-20.7539,58,29,5,-29
-42.045,-20.7539,57,28,5,-29
-42.04477,-20.7539,56,28,5,-28
-42.04455,-20.7539,56,28,11,-28
-42.0441,-20.7539,55,30,5,-25
-42.04387,-20.7539,54,33,5,-21
-42.04365,-20.7539,53,35,5,-18
-42.04342,-20.7539,51,39,11,-12
-42.04297,-20.7539,50,34,5,-16
-42.04275,-20.7539,49,35,5,-14
-42.04253,-20.7539,47,36,5,-11
-42.0423,-20.7539,47,37,5,-10
-42.04185,-20.7539,49,37,5,-12
-42.04163,-20.7539,48,36,5,-12
-42.0414,-20.7539,48,37,5,-11
-42.04118,-20.7539,48,38,5,-10
-42.04073,-20.7539,48,37,5,-11
-42.0405,-20.7539,47,38,5,-9
-42.04028,-20.7539,48,38,5,-10
-42.04005,-20.7539,44,38,5,-6
-42.03983,-20.7539,43,38,5,-5
-42.03938,-20.7539,42,39,5,-3
-42.03915,-20.7539,41,39,5,-2
-42.03893,-20.7539,41,39,5,-2
-42.0387,-20.7539,41,40,5,-1
-42.03826,-20.7539,41,40,5,-1
-42.03803,-20.7539,41,40,0,-1
-42.03781,-20.7539,41,43,0,2
-42.03758,-20.7539,40,46,0,6
-42.03713,-20.7539,40,62,0,22
-42.03691,-20.7539,39,62,0,23
-42.03668,-20.7539,38,62,0,24
-42.03646,-20.7539,38,44,0,6
-42.03601,-20.7539,37,45,0,8
-42.03578,-20.7539,35,45,0,10
-42.03556,-20.7539,34,44,0,10
-42.03533,-20.7539,31,44,0,13
-42.03511,-20.7539,28,44,0,16
-42.03466,-20.7539,28,44,0,16
-42.03444,-20.7539,24,43,0,19
-42.03421,-20.7539,23,43,0,20
-42.03399,-20.7539,23,45,0,22
-42.03354,-20.7539,24,45,0,21
-42.03331,-20.7539,25,44,0,19
-42.03309,-20.7539,27,44,0,17
-42.03286,-20.7539,30,44,0,14
-42.03241,-20.7539,31,45,0,14
-42.03219,-20.7539,31,45,0,14
-42.03196,-20.7539,35,45,0,10
-42.03174,-20.7539,35,39,0,4
-42.03129,-20.7539,42,39,5,-3
-42.03106,-20.7539,44,38,5,-6
-42.03084,-20.7539,44,39,5,-5
-42.03062,-20.7539,48,40,5,-8
-42.03017,-20.7539,47,41,5,-6
-42.02994,-20.7539,50,46,5,-4
-42.02972,-20.7539,48,47,0,-1
-42.02949,-20.7539,40,46,0,6
-42.02927,-20.7539,39,46,0,7
-42.02882,-20.7539,39,47,0,8
-42.02859,-20.7539,40,47,0,7
-42.02837,-20.7539,41,47,0,6
-42.02814,-20.7539,41,47,0,6
-42.02769,-20.7539,41,46,0,5
-42.02747,-20.7539,42,43,0,1
-42.02724,-20.7539,43,43,0,0
-42.02702,-20.7539,43,43,0,0
-42.02657,-20.7539,43,41,0,-2
-42.02635,-20.7539,43,40,0,-3
-42.02612,-20.7539,43,39,0,-4
-42.0259,-20.7539,43,38,0,-5
-42.02545,-20.7539,44,36,5,-8
-42.02522,-20.7539,44,36,5,-8
-42.025,-20.7539,44,36,5,-8
-42.02477,-20.7539,45,35,5,-10
-42.02455,-20.7539,46,35,5,-11
-42.0241,-20.7539,46,35,5,-11
-42.02387,-20.7539,48,35,5,-13
-42.02365,-20.7539,49,34,5,-15
-42.02342,-20.7539,51,34,5,-17
-42.02297,-20.7539,51,35,5,-16
-42.02275,-20.7539,53,35,5,-18
-42.02253,-20.7539,53,40,5,-13
-42.0223,-20.7539,54,40,0,-14
-42.02185,-20.7539,53,41,0,-12
-42.02163,-20.7539,52,40,0,-12
-42.0214,-20.7539,54,47,0,-7
-42.02118,-20.7539,57,47,0,-10
-42.02073,-20.7539,58,47,0,-11
-42.0205,-20.7539,59,47,0,-12
-42.02028,-20.7539,59,47,0,-12
-42.02005,-20.7539,59,48,0,-11
-42.01983,-20.7539,57,48,0,-9
-42.01938,-20.7539,57,49,0,-8
-42.01915,-20.7539,55,49,0,-6
-42.01893,-20.7539,55,49,0,-6
-42.01871,-20.7539,55,50,11,-5
-42.01826,-20.7539,55,50,0,-5
-42.01803,-20.7539,58,49,5,-9
-42.01781,-20.7539,57,47,5,-10
-42.01758,-20.7539,60,43,5,-17
-42.01713,-20.7539,62,42,5,-20
-42.01691,-20.7539,60,42,5,-18
-42.01668,-20.7539,61,41,5,-20
-42.01646,-20.7539,61,42,5,-19
-42.01601,-20.7539,61,42,5,-19
-42.01578,-20.7539,62,41,5,-21
-42.01556,-20.7539,59,42,5,-17
-42.01533,-20.7539,59,43,5,-16
-42.01511,-20.7539,61,43,5,-18
-42.01466,-20.7539,61,43,5,-18
-42.01444,-20.7539,64,45,5,-19
-42.01421,-20.7539,64,45,5,-19
-42.01399,-20.7539,62,45,5,-17
-42.01354,-20.7539,64,43,5,-21
-42.01331,-20.7539,61,41,5,-20
-42.01309,-20.7539,63,40,5,-23
-42.01286,-20.7539,63,40,5,-23
-42.01241,-20.7539,66,40,5,-26
-42.01219,-20.7539,64,40,5,-24
-42.01196,-20.7539,63,40,5,-23
-42.01174,-20.7539,63,39,5,-24
-42.01129,-20.7539,62,38,5,-24
-42.01106,-20.7539,62,39,5,-23
-42.01084,-20.7539,64,40,5,-24
-42.01062,-20.7539,65,39,5,-26
-42.01017,-20.7539,65,39,5,-26
-42.00994,-20.7539,64,40,5,-24
-42.00972,-20.7539,64,41,5,-23
-42.00949,-20.7539,63,40,5,-23
-42.00927,-20.7539,63,40,5,-23
-42.00882,-20.7539,63,41,5,-22
-42.00859,-20.7539,63,41,5,-22
-42.00837,-20.7539,63,51,0,-12
-42.00814,-20.7539,64,47,0,-17
-42.00769,-20.7539,63,45,0,-18
-42.00747,-20.7539,63,45,0,-18
-42.00724,-20.7539,62,45,0,-17
-42.00702,-20.7539,62,44,0,-18
-42.00657,-20.7539,63,44,0,-19
-42.00635,-20.7539,63,43,0,-20
-42.00612,-20.7539,64,43,0,-21
-42.0059,-20.7539,63,42,0,-21
-42.00545,-20.7539,64,44,0,-20
-42.00522,-20.7539,64,47,0,-17
-42.005,-20.7539,63,49,0,-14
-42.00477,-20.7539,63,49,0,-14
-42.00455,-20.7539,63,53,0,-10
-42.0041,-20.7539,63,43,0,-20
-42.00387,-20.7539,63,42,0,-21
-42.00365,-20.7539,63,44,0,-19
-42.00342,-20.7539,63,46,0,-17
-42.00298,-20.7539,63,38,0,-25
-42.00275,-20.7539,63,39,0,-24
-42.00253,-20.7539,63,41,0,-22
-42.0023,-20.7539,63,40,0,-23
-42.00185,-20.7539,62,40,0,-22
-42.00163,-20.7539,63,39,0,-24
-42.0014,-20.7539,63,38,0,-25
-42.00118,-20.7539,63,38,0,-25
-42.00073,-20.7539,63,38,0,-25
-42.0005,-20.7539,63,38,0,-25
-42.00028,-20.7539,64,39,0,-25
-42.00005,-20.7539,64,39,0,-25
-41.99983,-20.7539,64,41,0,-23
-41.99938,-20.7539,64,40,0,-24
-41.99916,-20.7539,64,40,0,-24
-41.99893,-20.7539,64,41,0,-23
-41.99871,-20.7539,63,42,0,-21
-41.99826,-20.7539,63,42,0,-21
-41.99803,-20.7539,63,43,0,-20
-41.99781,-20.7539,63,43,0,-20
-41.99758,-20.7539,63,43,0,-20
-41.99713,-20.7539,62,41,0,-21
-41.99691,-20.7539,62,41,0,-21
-41.99668,-20.7539,63,39,0,-24
-41.99646,-20.7539,64,39,0,-25
-41.99601,-20.7539,64,39,0,-25
-41.99578,-20.7539,65,39,11,-26
-41.99556,-20.7539,66,39,0,-27
-41.99533,-20.7539,66,40,0,-26
-41.99511,-20.7539,66,40,0,-26
-41.99466,-20.7539,66,41,0,-25
-41.99444,-20.7539,67,41,0,-26
-41.99421,-20.7539,67,42,0,-25
-41.99399,-20.7539,67,42,0,-25
-41.99354,-20.7539,67,43,0,-24
-41.99331,-20.7539,67,43,0,-24
-41.99309,-20.7539,68,43,0,-25
-41.99286,-20.7539,68,43,0,-25
-41.99241,-20.7539,67,43,0,-24
-41.99219,-20.7539,68,43,0,-25
-41.99196,-20.7539,68,43,0,-25
-41.99174,-20.7539,68,44,0,-24
-41.99129,-20.7539,68,45,0,-23
-41.99107,-20.7539,68,45,0,-23
-41.99084,-20.7539,68,45,0,-23
-41.99062,-20.7539,68,45,0,-23
-41.99017,-20.7539,68,45,0,-23
-41.98994,-20.7539,69,45,0,-24
-41.98972,-20.7539,69,46,0,-23
-41.98949,-20.7539,69,46,0,-23
-41.98927,-20.7539,69,46,0,-23
-41.98882,-20.7539,70,45,0,-25
-41.98859,-20.7539,71,46,0,-25
-41.98837,-20.7539,71,45,0,-26
-41.98814,-20.7539,70,45,0,-25
-41.98769,-20.7539,70,45,0,-25
-41.98747,-20.7539,69,45,0,-24
-41.98725,-20.7539,68,45,0,-23
-41.98702,-20.7539,67,45,0,-22
-41.98657,-20.7539,67,46,0,-21
-41.98635,-20.7539,68,47,0,-21
-41.98612,-20.7539,68,48,0,-20
-41.9859,-20.7539,69,48,0,-21
-41.98545,-20.7539,68,48,0,-20
-41.98522,-20.7539,68,48,0,-20
-41.985,-20.7539,69,48,0,-21
-41.98477,-20.7539,68,48,0,-20
-41.98455,-20.7539,68,46,5,-22
-41.9841,-20.7539,67,33,5,-34
-41.98387,-20.7539,67,33,5,-34
-41.98365,-20.7539,66,32,5,-34
-41.98343,-20.7539,64,32,5,-32
-41.98298,-20.7539,63,32,5,-31
-41.98275,-20.7539,62,33,5,-29
-41.98253,-20.7539,61,33,0,-28
-41.9823,-20.7539,60,33,0,-27
-41.98185,-20.7539,58,34,0,-24
-41.98163,-20.7539,57,35,0,-22
-41.9814,-20.7539,57,35,0,-22
-41.98118,-20.7539,57,37,0,-20
-41.98073,-20.7539,57,38,0,-19
-41.9805,-20.7539,57,39,0,-18
-41.98028,-20.7539,57,39,0,-18
-41.98005,-20.7539,57,40,0,-17
-41.97983,-20.7539,56,40,0,-16
-41.97938,-20.7539,56,40,0,-16
-41.97916,-20.7539,56,40,0,-16
-41.97893,-20.7539,56,41,0,-15
-41.97871,-20.7539,60,41,0,-19
-41.97826,-20.7539,63,42,0,-21
-41.97803,-20.7539,62,43,0,-19
-41.97781,-20.7539,68,44,0,-24
-41.97758,-20.7539,66,45,0,-21
-41.97713,-20.7539,64,46,0,-18
-41.97691,-20.7539,63,46,0,-17
-41.97668,-20.7539,62,46,0,-16
-41.97646,-20.7539,56,46,0,-10
-41.97601,-20.7539,56,46,0,-10
-41.97578,-20.7539,56,46,0,-10
-41.97556,-20.7539,56,46,0,-10
-41.97534,-20.7539,56,46,0,-10
-41.97511,-20.7539,56,46,0,-10
-41.97466,-20.7539,56,46,0,-10
-41.97444,-20.7539,55,39,5,-16
-41.97421,-20.7539,55,34,5,-21
-41.97399,-20.7539,55,37,5,-18
-41.97354,-20.7539,54,37,5,-17
-41.97331,-20.7539,59,38,5,-21
-41.97309,-20.7539,54,37,5,-17
-41.97286,-20.7539,54,36,5,-18
-41.97241,-20.7539,56,39,5,-17
-41.97219,-20.7539,58,39,5,-19
-41.97196,-20.7539,67,39,5,-28
-41.97174,-20.7539,67,36,5,-31
-41.97129,-20.7539,69,47,5,-22
-41.97107,-20.7539,70,47,0,-23
-41.97084,-20.7539,69,47,0,-22
-41.97062,-20.7539,68,47,0,-21
-41.97017,-20.7539,67,48,0,-19
-41.96994,-20.7539,66,48,0,-18
-41.96972,-20.7539,64,48,0,-16
-41.96949,-20.7539,63,48,0,-15
-41.96927,-20.7539,60,44,0,-16
-42.1005,-20.75369,59,34,0,-25
-42.0978,-20.75369,67,33,0,-34
-42.09511,-20.75369,63,27,5,-36
-42.09219,-20.75369,65,28,5,-37
-42.08949,-20.75369,57,31,5,-26
-42.08657,-20.75369,59,39,0,-20
-42.08387,-20.75369,64,38,0,-26
-42.08118,-20.75369,62,32,5,-30
-42.07825,-20.75369,58,31,5,-27
-42.07556,-20.75369,62,33,5,-29
-42.07286,-20.75369,60,32,5,-28
-42.06994,-20.75369,52,36,0,-16
-42.06724,-20.75369,56,35,5,-21
-42.06455,-20.75369,59,36,5,-23
-42.06163,-20.75369,60,39,5,-21
-42.05893,-20.75369,63,32,5,-31
-42.05601,-20.75369,54,38,5,-16
-42.05331,-20.75369,58,40,5,-18
-42.05061,-20.75369,56,42,0,-14
-42.04769,-20.75369,61,30,5,-31
-42.045,-20.75369,56,29,5,-27
-42.0423,-20.75369,47,37,5,-10
-42.03938,-20.75369,42,39,5,-3
-42.03668,-20.75369,40,49,0,9
-42.03399,-20.75369,26,43,0,17
-42.03106,-20.75369,34,38,5,4
-42.02837,-20.75369,41,47,0,6
-42.02545,-20.75369,44,35,5,-9
-42.02275,-20.75369,54,38,5,-16
-42.02005,-20.75369,60,47,0,-13
-42.01713,-20.75369,60,42,5,-18
-42.01444,-20.75369,61,45,5,-16
-42.01174,-20.75369,63,40,5,-23
-42.00882,-20.75369,64,56,5,-8
-42.00612,-20.75369,64,51,0,-13
-42.00342,-20.75369,63,46,0,-17
-42.0005,-20.75369,65,38,0,-27
-41.99781,-20.75369,63,42,0,-21
-41.99511,-20.75369,67,40,0,-27
-41.99219,-20.75369,68,43,0,-25
-41.98949,-20.75369,70,45,0,-25
-41.98657,-20.75369,66,46,0,-20
-41.98387,-20.75369,67,33,5,-34
-41.98118,-20.75369,57,36,0,-21
-41.97826,-20.75369,56,43,0,-13
-41.97556,-20.75369,56,46,0,-10
-41.97286,-20.75369,54,35,5,-19
-41.96994,-20.75369,66,48,0,-18
-42.1005,-20.75327,59,34,0,-25
-42.0978,-20.75327,67,33,0,-34
-42.09511,-20.75327,63,27,5,-36
-42.09219,-20.75327,66,28,5,-38
-42.08949,-20.75327,58,31,5,-27
-42.08657,-20.75327,60,39,0,-21
-42.08387,-20.75327,64,38,0,-26
-42.08118,-20.75327,62,32,5,-30
-42.07825,-20.75327,61,33,5,-28
-42.07556,-20.75327,61,33,5,-28
-42.07286,-20.75327,61,37,5,-24
-42.06994,-20.75327,52,36,0,-16
-42.06724,-20.75327,55,36,5,-19
-42.06455,-20.75327,59,38,5,-21
-42.06163,-20.75327,59,30,5,-29
-42.05893,-20.75327,61,34,5,-27
-42.05601,-20.75327,56,35,5,-21
-42.05331,-20.75327,58,44,11,-14
-42.05061,-20.75327,56,42,0,-14
-42.04769,-20.75327,62,28,5,-34
-42.045,-20.75327,58,28,5,-30
-42.0423,-20.75327,47,37,5,-10
-42.03938,-20.75327,42,39,5,-3
-42.03668,-20.75327,41,43,0,2
-42.03399,-20.75327,31,42,0,11
-42.03106,-20.75327,35,39,5,4
-42.02837,-20.75327,41,44,0,3
-42.02545,-20.75327,44,35,5,-9
-42.02275,-20.75327,54,40,0,-14
-42.02005,-20.75327,60,47,0,-13
-42.01713,-20.75327,62,42,5,-20
-42.01444,-20.75327,61,44,5,-17
-42.01174,-20.75327,62,44,5,-18
-42.00882,-20.75327,65,56,0,-9
-42.00612,-20.75327,64,55,0,-9
-42.00342,-20.75327,63,46,0,-17
-42.0005,-20.75327,65,36,5,-29
-41.99781,-20.75327,65,41,0,-24
-41.99511,-20.75327,67,40,6,-27
-41.99219,-20.75327,69,44,11,-25
-41.98949,-20.75327,71,43,0,-28
-41.98657,-20.75327,66,44,0,-22
-41.98387,-20.75327,67,34,5,-33
-41.98118,-20.75327,57,35,0,-22
-41.97826,-20.75327,56,43,0,-13
-41.97556,-20.75327,56,45,0,-11
-41.97286,-20.75327,54,43,5,-11
-41.96994,-20.75327,67,48,5,-19
-42.1005,-20.75305,59,34,0,-25
-42.0978,-20.75305,63,32,5,-31
-42.09511,-20.75305,63,26,5,-37
-42.09219,-20.75305,65,28,5,-37
-42.08949,-20.75305,59,32,5,-27
-42.08657,-20.75305,60,39,0,-21
-42.08387,-20.75305,60,38,0,-22
-42.08118,-20.75305,63,32,5,-31
-42.07825,-20.75305,59,33,5,-26
-42.07556,-20.75305,61,38,5,-23
-42.07286,-20.75305,61,36,5,-25
-42.06994,-20.75305,52,38,0,-14
-42.06724,-20.75305,55,35,5,-20
-42.06455,-20.75305,59,37,5,-22
-42.06163,-20.75305,59,30,5,-29
-42.05893,-20.75305,58,34,5,-24
-42.05601,-20.75305,56,36,5,-20
-42.05331,-20.75305,58,44,0,-14
-42.05061,-20.75305,56,44,0,-12
-42.04769,-20.75305,63,25,5,-38
-42.045,-20.75305,55,24,5,-31
-42.0423,-20.75305,48,37,5,-11
-42.03938,-20.75305,43,39,5,-4
-42.03668,-20.75305,41,46,0,5
-42.03399,-20.75305,34,40,0,6
-42.03106,-20.75305,37,42,0,5
-42.02837,-20.75305,41,44,0,3
-42.02545,-20.75305,44,35,5,-9
-42.02275,-20.75305,55,40,0,-15
-42.02005,-20.75305,61,47,0,-14
-42.01713,-20.75305,60,42,5,-18
-42.01444,-20.75305,62,44,5,-18
-42.01174,-20.75305,65,44,5,-21
-42.00882,-20.75305,66,56,0,-10
-42.00612,-20.75305,66,55,0,-11
-42.00342,-20.75305,64,46,0,-18
-42.0005,-20.75305,66,33,5,-33
-41.99781,-20.75305,66,42,0,-24
-41.99511,-20.75305,67,40,0,-27
-41.99219,-20.75305,70,44,0,-26
-41.98949,-20.75305,72,43,0,-29
-41.98657,-20.75305,66,44,0,-22
-41.98387,-20.75305,66,34,5,-32
-41.98118,-20.75305,57,35,0,-22
-41.97826,-20.75305,60,42,0,-18
-41.97556,-20.75305,56,44,0,-12
-41.97286,-20.75305,54,47,5,-7
-41.96994,-20.75305,67,48,5,-19
-42.1005,-20.75284,62,34,0,-28
-42.0978,-20.75284,65,25,5,-40
-42.09511,-20.75284,63,26,5,-37
-42.09219,-20.75284,65,27,5,-38
-42.08949,-20.75284,60,30,5,-30
-42.08657,-20.75284,61,38,0,-23
-42.08387,-20.75284,60,38,0,-22
-42.08118,-20.75284,62,32,5,-30
-42.07825,-20.75284,54,33,5,-21
-42.07556,-20.75284,61,38,0,-23
-42.07286,-20.75284,59,37,5,-22
-42.06994,-20.75284,51,38,0,-13
-42.06724,-20.75284,54,35,5,-19
-42.06455,-20.75284,57,39,5,-18
-42.06163,-20.75284,60,30,5,-30
-42.05893,-20.75284,56,34,5,-22
-42.05601,-20.75284,56,36,5,-20
-42.05331,-20.75284,58,44,0,-14
-42.05061,-20.75284,56,44,0,-12
-42.04769,-20.75284,62,24,5,-38
-42.045,-20.75284,53,22,5,-31
-42.0423,-20.75284,48,37,5,-11
-42.03938,-20.75284,44,39,5,-5
-42.03668,-20.75284,42,44,0,2
-42.03399,-20.75284,38,44,0,6
-42.03106,-20.75284,38,44,0,6
-42.02837,-20.75284,41,39,0,-2
-42.02545,-20.75284,44,35,5,-9
-42.02275,-20.75284,56,45,11,-11
-42.02005,-20.75284,60,47,0,-13
-42.01713,-20.75284,52,42,5,-10
-42.01444,-20.75284,61,52,5,-9
-42.01174,-20.75284,68,39,5,-29
-42.00882,-20.75284,66,56,0,-10
-42.00612,-20.75284,64,55,0,-9
-42.00342,-20.75284,64,42,0,-22
-42.0005,-20.75284,65,33,5,-32
-41.99781,-20.75284,66,42,0,-24
-41.99511,-20.75284,67,40,0,-27
-41.99219,-20.75284,70,46,0,-24
-41.98949,-20.75284,72,42,0,-30
-41.98657,-20.75284,66,43,0,-23
-41.98387,-20.75284,66,34,5,-32
-41.98118,-20.75284,57,36,0,-21
-41.97826,-20.75284,60,42,0,-18
-41.97556,-20.75284,56,44,5,-12
-41.97286,-20.75284,54,47,0,-7
-41.96994,-20.75284,67,48,5,-19
-42.1005,-20.75242,62,34,0,-28
-42.0978,-20.75242,66,25,5,-41
-42.09511,-20.75242,64,26,5,-38
-42.09219,-20.75242,62,28,5,-34
-42.08949,-20.75242,60,31,5,-29
-42.08657,-20.75242,62,38,0,-24
-42.08387,-20.75242,62,38,5,-24
-42.08118,-20.75242,62,33,5,-29
-42.07825,-20.75242,54,34,5,-20
-42.07556,-20.75242,61,38,0,-23
-42.07286,-20.75242,58,33,5,-25
-42.06994,-20.75242,51,38,0,-13
-42.06724,-20.75242,54,38,5,-16
-42.06455,-20.75242,57,40,5,-17
-42.06163,-20.75242,58,31,5,-27
-42.05893,-20.75242,53,33,5,-20
-42.05601,-20.75242,57,35,5,-22
-42.05331,-20.75242,58,40,0,-18
-42.05061,-20.75242,56,44,0,-12
-42.04769,-20.75242,63,26,5,-37
-42.045,-20.75242,52,20,5,-32
-42.0423,-20.75242,51,37,5,-14
-42.03938,-20.75242,44,44,5,0
-42.03668,-20.75242,43,42,0,-1
-42.03399,-20.75242,42,44,0,2
-42.03106,-20.75242,41,44,0,3
-42.02837,-20.75242,41,42,0,1
-42.02545,-20.75242,44,35,5,-9
-42.02275,-20.75242,57,45,11,-12
-42.02005,-20.75242,60,45,0,-15
-42.01713,-20.75242,53,43,5,-10
-42.01444,-20.75242,63,40,5,-23
-42.01174,-20.75242,70,39,5,-31
-42.00882,-20.75242,66,56,0,-10
-42.00612,-20.75242,64,55,0,-9
-42.00342,-20.75242,64,40,5,-24
-42.0005,-20.75242,64,33,5,-31
-41.99781,-20.75242,66,40,0,-26
-41.99511,-20.75242,67,40,0,-27
-41.99219,-20.75242,69,48,0,-21
-41.98949,-20.75242,71,44,0,-27
-41.98657,-20.75242,66,44,0,-22
-41.98387,-20.75242,66,34,5,-32
-41.98118,-20.75242,57,37,0,-20
-41.97826,-20.75242,65,42,0,-23
-41.97556,-20.75242,56,35,5,-21
-41.97286,-20.75242,54,47,0,-7
-41.96994,-20.75242,69,48,5,-21
-42.1005,-20.75221,63,33,0,-30
-42.0978,-20.75221,66,25,5,-41
-42.09511,-20.75221,66,26,5,-40
-42.09219,-20.75221,63,28,5,-35
-42.08949,-20.75221,60,30,5,-30
-42.08657,-20.75221,64,38,5,-26
-42.08387,-20.75221,62,38,5,-24
-42.08118,-20.75221,62,32,5,-30
-42.07825,-20.75221,54,33,5,-21
-42.07556,-20.75221,61,37,5,-24
-42.07286,-20.75221,57,33,5,-24
-42.06994,-20.75221,51,38,0,-13
-42.06724,-20.75221,53,38,5,-15
-42.06455,-20.75221,57,39,5,-18
-42.06163,-20.75221,60,37,5,-23
-42.05893,-20.75221,53,33,5,-20
-42.05601,-20.75221,58,34,5,-24
-42.05331,-20.75221,57,37,0,-20
-42.05061,-20.75221,57,44,0,-13
-42.04769,-20.75221,63,26,5,-37
-42.045,-20.75221,56,20,5,-36
-42.0423,-20.75221,50,37,5,-13
-42.03938,-20.75221,45,45,5,0
-42.03668,-20.75221,44,44,0,0
-42.03399,-20.75221,43,45,0,2
-42.03106,-20.75221,41,44,0,3
-42.02837,-20.75221,41,39,5,-2
-42.02545,-20.75221,44,36,5,-8
-42.02275,-20.75221,57,43,5,-14
-42.02005,-20.75221,60,45,0,-15
-42.01713,-20.75221,53,43,5,-10
-42.01444,-20.75221,60,38,5,-22
-42.01174,-20.75221,65,42,5,-23
-42.00882,-20.75221,66,54,5,-12
-42.00612,-20.75221,64,55,0,-9
-42.00342,-20.75221,64,37,5,-27
-42.0005,-20.75221,63,33,5,-30
-41.99781,-20.75221,66,39,11,-27
-41.99511,-20.75221,67,40,6,-27
-41.99219,-20.75221,69,49,0,-20
-41.98949,-20.75221,70,44,0,-26
-41.98657,-20.75221,66,45,0,-21
-41.98387,-20.75221,65,35,5,-30
-41.98118,-20.75221,57,38,0,-19
-41.97826,-20.75221,67,41,0,-26
-41.97556,-20.75221,56,34,5,-22
-41.97286,-20.75221,54,47,0,-7
-41.96994,-20.75221,69,42,5,-27
-42.1005,-20.752,64,33,0,-31
-42.0978,-20.752,64,25,5,-39
-42.09511,-20.752,64,25,5,-39
-42.09219,-20.752,61,28,5,-33
-42.08949,-20.752,61,30,5,-31
-42.08657,-20.752,64,34,5,-30
-42.08387,-20.752,63,35,5,-28
-42.08118,-20.752,61,38,5,-23
-42.07825,-20.752,54,34,5,-20
-42.07556,-20.752,61,33,5,-28
-42.07286,-20.752,57,33,5,-24
-42.06994,-20.752,50,37,0,-13
-42.06724,-20.752,53,38,0,-15
-42.06455,-20.752,57,39,5,-18
-42.06163,-20.752,60,39,5,-21
-42.05893,-20.752,53,34,5,-19
-42.05601,-20.752,59,33,5,-26
-42.05331,-20.752,58,39,5,-19
-42.05061,-20.752,57,44,0,-13
-42.04769,-20.752,60,26,5,-34
-42.045,-20.752,48,20,5,-28
-42.0423,-20.752,47,38,5,-9
-42.03938,-20.752,47,45,5,-2
-42.03668,-20.752,47,42,5,-5
-42.03399,-20.752,43,43,0,0
-42.03106,-20.752,43,43,0,0
-42.02837,-20.752,42,43,5,1
-42.02545,-20.752,45,38,5,-7
-42.02275,-20.752,57,42,5,-15
-42.02005,-20.752,60,45,0,-15
-42.01713,-20.752,53,42,5,-11
-42.01444,-20.752,51,39,5,-12
-42.01174,-20.752,53,42,5,-11
-42.00882,-20.752,67,49,5,-18
-42.00612,-20.752,64,55,0,-9
-42.00342,-20.752,64,37,5,-27
-42.0005,-20.752,62,33,5,-29
-41.99781,-20.752,66,39,5,-27
-41.99511,-20.752,68,40,6,-28
-41.99219,-20.752,67,50,0,-17
-41.98949,-20.752,70,44,0,-26
-41.98657,-20.752,67,45,0,-22
-41.98387,-20.752,65,34,5,-31
-41.98118,-20.752,58,39,0,-19
-41.97826,-20.752,69,41,0,-28
-41.97556,-20.752,59,39,5,-20
-41.97286,-20.752,54,47,0,-7
-41.96994,-20.752,67,42,5,-25
-42.1005,-20.75157,65,33,0,-32
-42.0978,-20.75157,63,32,5,-31
-42.09511,-20.75157,65,25,5,-40
-42.09219,-20.75157,60,26,5,-34
-42.08949,-20.75157,61,30,5,-31
-42.08657,-20.75157,64,34,5,-30
-42.08387,-20.75157,63,32,5,-31
-42.08118,-20.75157,59,38,5,-21
-42.07825,-20.75157,54,33,5,-21
-42.07556,-20.75157,62,33,5,-29
-42.07286,-20.75157,59,33,5,-26
-42.06994,-20.75157,50,33,5,-17
-42.06724,-20.75157,53,36,5,-17
-42.06455,-20.75157,57,39,5,-18
-42.06163,-20.75157,58,39,5,-19
-42.05893,-20.75157,53,31,5,-22
-42.05601,-20.75157,61,32,5,-29
-42.05331,-20.75157,58,41,5,-17
-42.05061,-20.75157,56,40,5,-16
-42.04769,-20.75157,53,25,5,-28
-42.045,-20.75157,47,23,5,-24
-42.0423,-20.75157,41,38,5,-3
-42.03938,-20.75157,50,44,5,-6
-42.03668,-20.75157,49,39,5,-10
-42.03399,-20.75157,44,42,0,-2
-42.03106,-20.75157,44,43,0,-1
-42.02837,-20.75157,42,42,5,0
-42.02545,-20.75157,46,39,5,-7
-42.02275,-20.75157,57,45,5,-12
-42.02005,-20.75157,51,48,5,-3
-42.01713,-20.75157,53,41,5,-12
-42.01444,-20.75157,50,37,5,-13
-42.01174,-20.75157,52,42,5,-10
-42.00882,-20.75157,67,41,5,-26
-42.00612,-20.75157,64,54,0,-10
-42.00342,-20.75157,65,37,5,-28
-42.0005,-20.75157,62,33,5,-29
-41.99781,-20.75157,65,37,5,-28
-41.99511,-20.75157,68,40,6,-28
-41.99219,-20.75157,67,50,0,-17
-41.98949,-20.75157,70,49,0,-21
-41.98657,-20.75157,67,45,0,-22
-41.98387,-20.75157,65,39,5,-26
-41.98118,-20.75157,59,39,0,-20
-41.97826,-20.75157,70,42,0,-28
-41.97556,-20.75157,60,40,0,-20
-41.97286,-20.75157,54,47,0,-7
-41.96994,-20.75157,67,38,5,-29
-42.1005,-20.75136,65,32,5,-33
-42.0978,-20.75136,64,32,0,-32
-42.09511,-20.75136,65,25,5,-40
-42.09219,-20.75136,61,27,5,-34
-42.08949,-20.75136,61,29,5,-32
-42.08657,-20.75136,65,38,5,-27
-42.08387,-20.75136,63,32,5,-31
-42.08118,-20.75136,57,33,5,-24
-42.07825,-20.75136,55,33,5,-22
-42.07556,-20.75136,62,32,5,-30
-42.07286,-20.75136,59,33,5,-26
-42.06994,-20.75136,50,33,5,-17
-42.06724,-20.75136,52,36,5,-16
-42.06455,-20.75136,56,39,5,-17
-42.06163,-20.75136,56,39,5,-17
-42.05893,-20.75136,53,30,5,-23
-42.05601,-20.75136,63,32,5,-31
-42.05331,-20.75136,58,39,5,-19
-42.05061,-20.75136,59,40,5,-19
-42.04769,-20.75136,55,25,5,-30
-42.045,-20.75136,45,23,5,-22
-42.0423,-20.75136,40,39,5,-1
-42.03938,-20.75136,53,42,5,-11
-42.03668,-20.75136,51,39,5,-12
-42.03399,-20.75136,45,49,0,4
-42.03106,-20.75136,47,43,0,-4
-42.02837,-20.75136,42,40,5,-2
-42.02545,-20.75136,46,40,5,-6
-42.02275,-20.75136,57,46,5,-11
-42.02005,-20.75136,52,48,11,-4
-42.01713,-20.75136,54,41,5,-13
-42.01444,-20.75136,58,36,5,-22
-42.01174,-20.75136,52,42,5,-10
-42.00882,-20.75136,68,43,5,-25
-42.00612,-20.75136,64,53,0,-11
-42.00342,-20.75136,65,37,5,-28
-42.0005,-20.75136,62,34,5,-28
-41.99781,-20.75136,65,37,11,-28
-41.99511,-20.75136,68,40,6,-28
-41.99219,-20.75136,67,50,0,-17
-41.98949,-20.75136,70,49,0,-21
-41.98657,-20.75136,68,45,0,-23
-41.98387,-20.75136,65,39,0,-26
-41.98118,-20.75136,61,39,0,-22
-41.97826,-20.75136,69,42,0,-27
-41.97556,-20.75136,60,40,0,-20
-41.97286,-20.75136,54,47,0,-7
-41.96994,-20.75136,65,35,5,-30
-42.10297,-20.75115,59,33,0,-26
-42.10275,-20.75115,59,33,0,-26
-42.10252,-20.75115,60,33,0,-27
-42.1023,-20.75115,61,33,0,-28
-42.10185,-20.75115,62,33,0,-29
-42.10163,-20.75115,63,33,0,-30
-42.1014,-20.75115,64,33,0,-31
-42.10118,-20.75115,64,33,0,-31
-42.10073,-20.75115,65,31,5,-34
-42.1005,-20.75115,66,30,5,-36
-42.10028,-20.75115,66,25,5,-41
-42.10005,-20.75115,67,29,5,-38
-42.09983,-20.75115,67,32,5,-35
-42.09938,-20.75115,68,32,0,-36
-42.09915,-20.75115,68,32,0,-36
-42.09893,-20.75115,66,32,0,-34
-42.0987,-20.75115,66,32,0,-34
-42.09825,-20.75115,67,32,0,-35
-42.09803,-20.75115,67,32,0,-35
-42.0978,-20.75115,65,32,0,-33
-42.09758,-20.75115,66,32,0,-34
-42.09713,-20.75115,66,32,0,-34
-42.09691,-20.75115,66,32,0,-34
-42.09668,-20.75115,65,32,0,-33
-42.09646,-20.75115,66,32,0,-34
-42.09601,-20.75115,66,29,5,-37
-42.09578,-20.75115,65,25,5,-40
-42.09556,-20.75115,65,25,5,-40
-42.09533,-20.75115,66,25,5,-41
-42.09511,-20.75115,65,25,5,-40
-42.09466,-20.75115,63,25,5,-38
-42.09443,-20.75115,64,26,5,-38
-42.09421,-20.75115,66,26,5,-40
-42.09398,-20.75115,61,26,5,-35
-42.09354,-20.75115,62,26,5,-36
-42.09331,-20.75115,64,26,5,-38
-42.09309,-20.75115,62,26,5,-36
-42.09286,-20.75115,58,26,5,-32
-42.09241,-20.75115,62,27,5,-35
-42.09219,-20.75115,58,27,5,-31
-42.09196,-20.75115,58,27,5,-31
-42.09174,-20.75115,58,27,5,-31
-42.09129,-20.75115,58,27,5,-31
-42.09106,-20.75115,58,27,5,-31
-42.09084,-20.75115,59,28,5,-31
-42.09061,-20.75115,59,28,5,-31
-42.09039,-20.75115,60,28,5,-32
-42.08994,-20.75115,60,28,5,-32
-42.08972,-20.75115,60,29,5,-31
-42.08949,-20.75115,60,30,5,-30
-42.08927,-20.75115,61,29,5,-32
-42.08882,-20.75115,61,33,5,-28
-42.08859,-20.75115,62,35,5,-27
-42.08837,-20.75115,62,38,5,-24
-42.08814,-20.75115,62,39,5,-23
-42.08769,-20.75115,63,39,5,-24
-42.08747,-20.75115,64,33,5,-31
-42.08724,-20.75115,64,35,5,-29
-42.08702,-20.75115,65,38,5,-27
-42.08657,-20.75115,65,38,0,-27
-42.08634,-20.75115,65,38,0,-27
-42.08612,-20.75115,65,38,0,-27
-42.08589,-20.75115,65,38,0,-27
-42.08545,-20.75115,66,32,5,-34
-42.08522,-20.75115,65,32,5,-33
-42.085,-20.75115,64,32,5,-32
-42.08477,-20.75115,62,32,5,-30
-42.08455,-20.75115,62,32,5,-30
-42.0841,-20.75115,63,31,5,-32
-42.08387,-20.75115,63,32,5,-31
-42.08365,-20.75115,64,32,5,-32
-42.08342,-20.75115,64,32,5,-32
-42.08297,-20.75115,63,32,5,-31
-42.08275,-20.75115,63,32,5,-31
-42.08252,-20.75115,63,32,5,-31
-42.0823,-20.75115,62,35,5,-27
-42.08185,-20.75115,61,36,0,-25
-42.08163,-20.75115,59,36,5,-23
-42.0814,-20.75115,61,34,5,-27
-42.08118,-20.75115,60,34,5,-26
-42.08073,-20.75115,58,33,5,-25
-42.0805,-20.75115,55,33,5,-22
-42.08028,-20.75115,56,32,5,-24
-42.08005,-20.75115,61,33,5,-28
-42.07983,-20.75115,55,33,5,-22
-42.07938,-20.75115,56,32,5,-24
-42.07915,-20.75115,54,32,5,-22
-42.07893,-20.75115,54,32,5,-22
-42.0787,-20.75115,55,32,5,-23
-42.07825,-20.75115,56,33,5,-23
-42.07803,-20.75115,56,34,5,-22
-42.07781,-20.75115,56,34,5,-22
-42.07758,-20.75115,57,34,5,-23
-42.07713,-20.75115,57,35,5,-22
-42.07691,-20.75115,58,35,5,-23
-42.07668,-20.75115,59,35,5,-24
-42.07646,-20.75115,60,34,5,-26
-42.07601,-20.75115,61,33,5,-28
-42.07578,-20.75115,61,33,5,-28
-42.07556,-20.75115,63,32,5,-31
-42.07533,-20.75115,63,33,5,-30
-42.07511,-20.75115,64,33,5,-31
-42.07466,-20.75115,64,33,5,-31
-42.07443,-20.75115,64,33,5,-31
-42.07421,-20.75115,64,34,5,-30
-42.07399,-20.75115,63,34,5,-29
-42.07354,-20.75115,61,32,5,-29
-42.07331,-20.75115,61,32,5,-29
-42.07309,-20.75115,53,32,5,-21
-42.07286,-20.75115,57,34,5,-23
-42.07241,-20.75115,55,34,5,-21
-42.07219,-20.75115,50,34,5,-16
-42.07196,-20.75115,53,34,5,-19
-42.07174,-20.75115,50,34,5,-16
-42.07129,-20.75115,50,34,5,-16
-42.07106,-20.75115,49,33,5,-16
-42.07084,-20.75115,49,33,5,-16
-42.07061,-20.75115,49,33,5,-16
-42.07039,-20.75115,50,34,5,-16
-42.06994,-20.75115,50,33,5,-17
-42.06972,-20.75115,50,33,5,-17
-42.06949,-20.75115,50,34,5,-16
-42.06927,-20.75115,51,34,5,-17
-42.06882,-20.75115,51,34,5,-17
-42.06859,-20.75115,51,34,5,-17
-42.06837,-20.75115,51,34,5,-17
-42.06814,-20.75115,51,34,5,-17
-42.06769,-20.75115,52,36,5,-16
-42.06747,-20.75115,52,36,5,-16
-42.06724,-20.75115,52,33,5,-19
-42.06702,-20.75115,53,33,5,-20
-42.06657,-20.75115,53,33,5,-20
-42.06634,-20.75115,53,36,5,-17
-42.06612,-20.75115,54,38,5,-16
-42.0659,-20.75115,54,38,5,-16
-42.06545,-20.75115,55,37,5,-18
-42.06522,-20.75115,55,37,5,-18
-42.065,-20.75115,55,38,5,-17
-42.06477,-20.75115,56,39,5,-17
-42.06455,-20.75115,56,39,5,-17
-42.0641,-20.75115,57,39,5,-18
-42.06387,-20.75115,57,39,5,-18
-42.06365,-20.75115,60,39,5,-21
-42.06342,-20.75115,59,39,5,-20
-42.06297,-20.75115,58,39,5,-19
-42.06275,-20.75115,60,39,5,-21
-42.06252,-20.75115,61,39,5,-22
-42.0623,-20.75115,61,38,5,-23
-42.06185,-20.75115,61,38,5,-23
-42.06163,-20.75115,56,39,5,-17
-42.0614,-20.75115,56,38,5,-18
-42.06118,-20.75115,56,38,5,-18
-42.06073,-20.75115,56,31,5,-25
-42.0605,-20.75115,55,31,5,-24
-42.06028,-20.75115,55,31,5,-24
-42.06005,-20.75115,55,31,5,-24
-42.05983,-20.75115,55,31,5,-24
-42.05938,-20.75115,56,31,5,-25
-42.05915,-20.75115,56,30,5,-26
-42.05893,-20.75115,53,30,5,-23
-42.0587,-20.75115,53,30,5,-23
-42.05826,-20.75115,53,29,5,-24
-42.05803,-20.75115,58,29,5,-29
-42.05781,-20.75115,57,30,5,-27
-42.05758,-20.75115,59,31,5,-28
-42.05713,-20.75115,62,32,5,-30
-42.05691,-20.75115,64,33,5,-31
-42.05668,-20.75115,64,33,5,-31
-42.05646,-20.75115,64,33,5,-31
-42.05601,-20.75115,64,32,5,-32
-42.05578,-20.75115,63,31,5,-32
-42.05556,-20.75115,62,34,5,-28
-42.05533,-20.75115,61,37,5,-24
-42.05511,-20.75115,60,37,5,-23
-42.05466,-20.75115,59,38,5,-21
-42.05443,-20.75115,55,38,5,-17
-42.05421,-20.75115,55,38,5,-17
-42.05399,-20.75115,56,38,5,-18
-42.05354,-20.75115,58,38,5,-20
-42.05331,-20.75115,58,40,5,-18
-42.05309,-20.75115,59,40,5,-19
-42.05286,-20.75115,59,40,0,-19
-42.05241,-20.75115,58,38,0,-20
-42.05219,-20.75115,60,44,0,-16
-42.05196,-20.75115,59,44,0,-15
-42.05174,-20.75115,55,42,5,-13
-42.05129,-20.75115,59,40,5,-19
-42.05106,-20.75115,57,40,5,-17
-42.05084,-20.75115,58,40,5,-18
-42.05061,-20.75115,56,40,5,-16
-42.05039,-20.75115,56,41,5,-15
-42.04994,-20.75115,56,40,5,-16
-42.04972,-20.75115,57,40,5,-17
-42.04949,-20.75115,58,38,5,-20
-42.04927,-20.75115,59,37,5,-22
-42.04882,-20.75115,59,36,5,-23
-42.04859,-20.75115,60,36,5,-24
-42.04837,-20.75115,57,35,5,-22
-42.04814,-20.75115,55,34,5,-21
-42.04769,-20.75115,55,24,5,-31
-42.04747,-20.75115,52,24,5,-28
-42.04724,-20.75115,45,24,5,-21
-42.04702,-20.75115,44,23,5,-21
-42.04657,-20.75115,44,25,5,-19
-42.04635,-20.75115,45,25,5,-20
-42.04612,-20.75115,44,26,5,-18
-42.0459,-20.75115,42,25,5,-17
-42.04545,-20.75115,42,25,5,-17
-42.04522,-20.75115,42,23,5,-19
-42.045,-20.75115,41,23,5,-18
-42.04477,-20.75115,41,23,5,-18
-42.04455,-20.75115,41,24,5,-17
-42.0441,-20.75115,39,30,5,-9
-42.04387,-20.75115,37,36,5,-1
-42.04365,-20.75115,37,36,5,-1
-42.04342,-20.75115,38,38,11,0
-42.04297,-20.75115,37,37,5,0
-42.04275,-20.75115,38,38,5,0
-42.04253,-20.75115,39,39,5,0
-42.0423,-20.75115,40,39,5,-1
-42.04185,-20.75115,43,42,5,-1
-42.04163,-20.75115,44,43,5,-1
-42.0414,-20.75115,48,45,5,-3
-42.04118,-20.75115,51,45,5,-6
-42.04073,-20.75115,54,45,5,-9
-42.0405,-20.75115,55,50,5,-5
-42.04028,-20.75115,56,55,5,-1
-42.04005,-20.75115,57,50,5,-7
-42.03983,-20.75115,56,46,5,-10
-42.03938,-20.75115,55,44,5,-11
-42.03915,-20.75115,55,43,5,-12
-42.03893,-20.75115,54,43,5,-11
-42.0387,-20.75115,52,45,5,-7
-42.03826,-20.75115,50,50,5,0
-42.03803,-20.75115,46,48,5,2
-42.03781,-20.75115,46,44,5,-2
-42.03758,-20.75115,45,44,5,-1
-42.03713,-20.75115,47,42,5,-5
-42.03691,-20.75115,51,39,5,-12
-42.03668,-20.75115,52,39,5,-13
-42.03646,-20.75115,51,39,5,-12
-42.03601,-20.75115,52,46,5,-6
-42.03578,-20.75115,50,48,0,-2
-42.03556,-20.75115,46,46,0,0
-42.03533,-20.75115,47,63,0,16
-42.03511,-20.75115,47,63,0,16
-42.03466,-20.75115,47,47,0,0
-42.03444,-20.75115,46,48,0,2
-42.03421,-20.75115,46,50,0,4
-42.03399,-20.75115,46,48,0,2
-42.03354,-20.75115,46,45,0,-1
-42.03331,-20.75115,46,45,0,-1
-42.03309,-20.75115,46,44,0,-2
-42.03286,-20.75115,46,44,0,-2
-42.03241,-20.75115,46,44,0,-2
-42.03219,-20.75115,47,43,0,-4
-42.03196,-20.75115,47,43,0,-4
-42.03174,-20.75115,47,43,0,-4
-42.03129,-20.75115,48,43,0,-5
-42.03106,-20.75115,49,43,0,-6
-42.03084,-20.75115,49,43,0,-6
-42.03062,-20.75115,46,44,0,-2
-42.03017,-20.75115,44,44,0,0
-42.02994,-20.75115,43,44,0,1
-42.02972,-20.75115,42,44,0,2
-42.02949,-20.75115,42,44,0,2
-42.02927,-20.75115,42,41,0,-1
-42.02882,-20.75115,47,41,5,-6
-42.02859,-20.75115,42,41,5,-1
-42.02837,-20.75115,42,40,5,-2
-42.02814,-20.75115,42,40,5,-2
-42.02769,-20.75115,42,41,5,-1
-42.02747,-20.75115,42,42,5,0
-42.02724,-20.75115,42,42,5,0
-42.02702,-20.75115,43,44,5,1
-42.02657,-20.75115,43,42,5,-1
-42.02635,-20.75115,44,43,5,-1
-42.02612,-20.75115,44,43,5,-1
-42.0259,-20.75115,46,43,5,-3
-42.02545,-20.75115,52,41,5,-11
-42.02522,-20.75115,52,40,5,-12
-42.025,-20.75115,55,46,5,-9
-42.02477,-20.75115,56,46,11,-10
-42.02455,-20.75115,55,53,5,-2
-42.0241,-20.75115,52,40,5,-12
-42.02387,-20.75115,54,40,5,-14
-42.02365,-20.75115,54,40,5,-14
-42.02342,-20.75115,56,40,5,-16
-42.02297,-20.75115,56,45,5,-11
-42.02275,-20.75115,57,46,5,-11
-42.02253,-20.75115,57,46,5,-11
-42.0223,-20.75115,55,46,5,-9
-42.02185,-20.75115,53,46,5,-7
-42.02163,-20.75115,53,47,5,-6
-42.0214,-20.75115,52,50,5,-2
-42.02118,-20.75115,51,48,5,-3
-42.02073,-20.75115,51,49,5,-2
-42.0205,-20.75115,50,46,5,-4
-42.02028,-20.75115,52,46,5,-6
-42.02005,-20.75115,53,48,5,-5
-42.01983,-20.75115,53,48,5,-5
-42.01938,-20.75115,54,44,5,-10
-42.01915,-20.75115,60,45,5,-15
-42.01893,-20.75115,57,47,5,-10
-42.01871,-20.75115,56,54,0,-2
-42.01826,-20.75115,56,54,5,-2
-42.01803,-20.75115,56,49,5,-7
-42.01781,-20.75115,56,53,11,-3
-42.01758,-20.75115,55,49,5,-6
-42.01713,-20.75115,54,43,5,-11
-42.01691,-20.75115,53,44,5,-9
-42.01668,-20.75115,53,45,5,-8
-42.01646,-20.75115,53,43,5,-10
-42.01601,-20.75115,53,40,5,-13
-42.01578,-20.75115,53,37,5,-16
-42.01556,-20.75115,52,37,5,-15
-42.01533,-20.75115,51,37,5,-14
-42.01511,-20.75115,51,35,5,-16
-42.01466,-20.75115,50,36,5,-14
-42.01444,-20.75115,51,35,5,-16
-42.01421,-20.75115,51,35,5,-16
-42.01399,-20.75115,51,35,5,-16
-42.01354,-20.75115,52,36,5,-16
-42.01331,-20.75115,52,40,5,-12
-42.01309,-20.75115,52,41,5,-11
-42.01286,-20.75115,52,41,5,-11
-42.01241,-20.75115,52,43,5,-9
-42.01219,-20.75115,52,43,5,-9
-42.01196,-20.75115,52,42,5,-10
-42.01174,-20.75115,52,41,5,-11
-42.01129,-20.75115,51,48,5,-3
-42.01106,-20.75115,51,50,0,-1
-42.01084,-20.75115,61,48,0,-13
-42.01062,-20.75115,64,49,5,-15
-42.01017,-20.75115,65,42,5,-23
-42.00994,-20.75115,65,40,5,-25
-42.00972,-20.75115,63,39,5,-24
-42.00949,-20.75115,66,38,5,-28
-42.00927,-20.75115,68,39,5,-29
-42.00882,-20.75115,67,43,5,-24
-42.00859,-20.75115,67,43,5,-24
-42.00837,-20.75115,68,43,5,-25
-42.00814,-20.75115,68,49,5,-19
-42.00769,-20.75115,68,55,0,-13
-42.00747,-20.75115,68,55,0,-13
-42.00724,-20.75115,68,55,0,-13
-42.00702,-20.75115,68,54,0,-14
-42.00657,-20.75115,66,53,0,-13
-42.00635,-20.75115,64,53,0,-11
-42.00612,-20.75115,64,53,0,-11
-42.0059,-20.75115,63,53,0,-10
-42.00545,-20.75115,63,48,5,-15
-42.00522,-20.75115,63,41,5,-22
-42.005,-20.75115,65,43,5,-22
-42.00477,-20.75115,65,49,5,-16
-42.00455,-20.75115,65,42,5,-23
-42.0041,-20.75115,65,39,5,-26
-42.00387,-20.75115,65,37,5,-28
-42.00365,-20.75115,65,37,5,-28
-42.00342,-20.75115,65,37,5,-28
-42.00298,-20.75115,65,38,5,-27
-42.00275,-20.75115,64,37,5,-27
-42.00253,-20.75115,64,37,5,-27
-42.0023,-20.75115,64,37,5,-27
-42.00185,-20.75115,64,36,5,-28
-42.00163,-20.75115,63,36,5,-27
-42.0014,-20.75115,63,34,5,-29
-42.00118,-20.75115,62,35,5,-27
-42.00073,-20.75115,61,35,5,-26
-42.0005,-20.75115,61,35,5,-26
-42.00028,-20.75115,61,35,5,-26
-42.00005,-20.75115,61,36,5,-25
-41.99983,-20.75115,65,36,5,-29
-41.99938,-20.75115,67,35,5,-32
-41.99916,-20.75115,67,35,5,-32
-41.99893,-20.75115,66,36,5,-30
-41.99871,-20.75115,66,36,5,-30
-41.99826,-20.75115,66,36,5,-30
-41.99803,-20.75115,65,35,5,-30
-41.99781,-20.75115,65,37,5,-28
-41.99758,-20.75115,65,38,11,-27
-41.99713,-20.75115,66,38,11,-28
-41.99691,-20.75115,66,39,11,-27
-41.99668,-20.75115,67,39,11,-28
-41.99646,-20.75115,67,39,0,-28
-41.99601,-20.75115,67,39,0,-28
-41.99578,-20.75115,68,39,0,-29
-41.99556,-20.75115,68,40,0,-28
-41.99533,-20.75115,68,40,0,-28
-41.99511,-20.75115,68,40,6,-28
-41.99466,-20.75115,68,41,0,-27
-41.99444,-20.75115,68,43,0,-25
-41.99421,-20.75115,68,44,0,-24
-41.99399,-20.75115,68,45,0,-23
-41.99354,-20.75115,67,47,0,-20
-41.99331,-20.75115,67,49,0,-18
-41.99309,-20.75115,66,50,0,-16
-41.99286,-20.75115,66,50,0,-16
-41.99241,-20.75115,66,50,0,-16
-41.99219,-20.75115,67,50,0,-17
-41.99196,-20.75115,67,50,0,-17
-41.99174,-20.75115,67,49,0,-18
-41.99129,-20.75115,67,49,0,-18
-41.99107,-20.75115,67,49,0,-18
-41.99084,-20.75115,68,49,0,-19
-41.99062,-20.75115,68,49,0,-19
-41.99017,-20.75115,69,49,0,-20
-41.98994,-20.75115,69,49,0,-20
-41.98972,-20.75115,70,49,0,-21
-41.98949,-20.75115,71,49,0,-22
-41.98927,-20.75115,70,49,0,-21
-41.98882,-20.75115,71,49,0,-22
-41.98859,-20.75115,75,48,0,-27
-41.98837,-20.75115,73,44,0,-29
-41.98814,-20.75115,73,42,0,-31
-41.98769,-20.75115,71,39,0,-32
-41.98747,-20.75115,70,38,0,-32
-41.98725,-20.75115,69,40,0,-29
-41.98702,-20.75115,69,42,0,-27
-41.98657,-20.75115,69,44,0,-25
-41.98635,-20.75115,69,46,0,-23
-41.98612,-20.75115,69,47,0,-22
-41.9859,-20.75115,69,47,0,-22
-41.98545,-20.75115,68,48,0,-20
-41.98522,-20.75115,68,48,5,-20
-41.985,-20.75115,68,48,5,-20
-41.98477,-20.75115,67,39,5,-28
-41.98455,-20.75115,67,36,5,-31
-41.9841,-20.75115,66,40,0,-26
-41.98387,-20.75115,66,40,0,-26
-41.98365,-20.75115,66,40,0,-26
-41.98343,-20.75115,65,41,0,-24
-41.98298,-20.75115,65,41,0,-24
-41.98275,-20.75115,64,37,0,-27
-41.98253,-20.75115,63,37,0,-26
-41.9823,-20.75115,63,39,0,-24
-41.98185,-20.75115,63,40,0,-23
-41.98163,-20.75115,62,40,0,-22
-41.9814,-20.75115,61,40,0,-21
-41.98118,-20.75115,60,39,0,-21
-41.98073,-20.75115,58,40,0,-18
-41.9805,-20.75115,57,40,0,-17
-41.98028,-20.75115,57,40,0,-17
-41.98005,-20.75115,56,40,0,-16
-41.97983,-20.75115,56,40,0,-16
-41.97938,-20.75115,56,41,0,-15
-41.97916,-20.75115,56,41,0,-15
-41.97893,-20.75115,61,42,0,-19
-41.97871,-20.75115,68,42,0,-26
-41.97826,-20.75115,69,42,0,-27
-41.97803,-20.75115,67,43,0,-24
-41.97781,-20.75115,66,41,0,-25
-41.97758,-20.75115,66,37,5,-29
-41.97713,-20.75115,65,32,5,-33
-41.97691,-20.75115,65,31,5,-34
-41.97668,-20.75115,65,32,5,-33
-41.97646,-20.75115,64,34,0,-30
-41.97601,-20.75115,63,37,0,-26
-41.97578,-20.75115,62,38,0,-24
-41.97556,-20.75115,60,39,0,-21
-41.97534,-20.75115,59,34,5,-25
-41.97511,-20.75115,56,32,5,-24
-41.97466,-20.75115,56,30,5,-26
-41.97444,-20.75115,56,35,5,-21
-41.97421,-20.75115,55,38,0,-17
-41.97399,-20.75115,55,39,0,-16
-41.97354,-20.75115,54,43,0,-11
-41.97331,-20.75115,54,47,0,-7
-41.97309,-20.75115,54,47,0,-7
-41.97286,-20.75115,54,47,0,-7
-41.97241,-20.75115,54,47,0,-7
-41.97219,-20.75115,54,47,0,-7
-41.97196,-20.75115,54,47,0,-7
-41.97174,-20.75115,54,48,0,-6
-41.97129,-20.75115,54,48,0,-6
-41.97107,-20.75115,54,48,0,-6
-41.97084,-20.75115,54,48,0,-6
-41.97062,-20.75115,54,48,0,-6
-41.97017,-20.75115,54,48,5,-6
-41.96994,-20.75115,54,48,5,-6
-41.96972,-20.75115,62,36,5,-26
-41.96949,-20.75115,67,36,5,-31
-41.96927,-20.75115,66,38,0,-28
-42.1005,-20.75073,65,26,5,-39
-42.0978,-20.75073,65,32,0,-33
-42.09511,-20.75073,63,25,5,-38
-42.09219,-20.75073,58,26,5,-32
-42.08949,-20.75073,60,30,5,-30
-42.08657,-20.75073,64,32,5,-32
-42.08387,-20.75073,61,32,5,-29
-42.08118,-20.75073,55,34,5,-21
-42.07825,-20.75073,56,34,5,-22
-42.07556,-20.75073,63,32,5,-31
-42.07286,-20.75073,54,34,5,-20
-42.06994,-20.75073,50,33,5,-17
-42.06724,-20.75073,52,34,5,-18
-42.06455,-20.75073,56,39,5,-17
-42.06163,-20.75073,56,38,5,-18
-42.05893,-20.75073,54,31,5,-23
-42.05601,-20.75073,52,33,5,-19
-42.05331,-20.75073,58,40,5,-18
-42.05061,-20.75073,54,40,5,-14
-42.04769,-20.75073,51,26,5,-25
-42.045,-20.75073,42,25,5,-17
-42.0423,-20.75073,40,40,5,0
-42.03938,-20.75073,49,45,5,-4
-42.03668,-20.75073,45,42,5,-3
-42.03399,-20.75073,46,46,0,0
-42.03106,-20.75073,50,43,0,-7
-42.02837,-20.75073,42,43,5,1
-42.02545,-20.75073,47,46,5,-1
-42.02275,-20.75073,56,43,5,-13
-42.02005,-20.75073,53,48,5,-5
-42.01713,-20.75073,55,49,5,-6
-42.01444,-20.75073,51,36,5,-15
-42.01174,-20.75073,52,44,5,-8
-42.00882,-20.75073,64,41,5,-23
-42.00612,-20.75073,64,51,0,-13
-42.00342,-20.75073,65,39,5,-26
-42.0005,-20.75073,61,37,5,-24
-41.99781,-20.75073,66,36,5,-30
-41.99511,-20.75073,68,41,0,-27
-41.99219,-20.75073,67,49,0,-18
-41.98949,-20.75073,71,49,0,-22
-41.98657,-20.75073,70,44,0,-26
-41.98387,-20.75073,67,46,0,-21
-41.98118,-20.75073,59,39,0,-20
-41.97826,-20.75073,69,44,0,-25
-41.97556,-20.75073,59,33,5,-26
-41.97286,-20.75073,54,47,0,-7
-41.96994,-20.75073,60,48,0,-12
-42.1005,-20.75052,66,30,5,-36
-42.0978,-20.75052,66,31,0,-35
-42.09511,-20.75052,63,25,5,-38
-42.09219,-20.75052,58,26,5,-32
-42.08949,-20.75052,61,29,5,-32
-42.08657,-20.75052,64,32,5,-32
-42.08387,-20.75052,61,33,5,-28
-42.08118,-20.75052,55,33,5,-22
-42.07825,-20.75052,56,34,5,-22
-42.07556,-20.75052,64,32,5,-32
-42.07286,-20.75052,51,34,5,-17
-42.06994,-20.75052,50,33,5,-17
-42.06724,-20.75052,52,34,5,-18
-42.06455,-20.75052,56,39,5,-17
-42.06163,-20.75052,56,38,5,-18
-42.05893,-20.75052,54,31,5,-23
-42.05601,-20.75052,52,33,5,-19
-42.05331,-20.75052,59,40,5,-19
-42.05061,-20.75052,54,40,5,-14
-42.04769,-20.75052,47,28,5,-19
-42.045,-20.75052,43,25,5,-18
-42.0423,-20.75052,41,41,5,0
-42.03938,-20.75052,44,43,5,-1
-42.03668,-20.75052,42,41,5,-1
-42.03399,-20.75052,47,47,0,0
-42.03106,-20.75052,50,42,0,-8
-42.02837,-20.75052,42,42,5,0
-42.02545,-20.75052,47,46,5,-1
-42.02275,-20.75052,57,44,5,-13
-42.02005,-20.75052,53,48,5,-5
-42.01713,-20.75052,55,49,5,-6
-42.01444,-20.75052,51,37,5,-14
-42.01174,-20.75052,52,43,5,-9
-42.00882,-20.75052,64,38,5,-26
-42.00612,-20.75052,64,50,11,-14
-42.00342,-20.75052,65,40,5,-25
-42.0005,-20.75052,61,37,5,-24
-41.99781,-20.75052,66,37,5,-29
-41.99511,-20.75052,68,41,0,-27
-41.99219,-20.75052,67,49,0,-18
-41.98949,-20.75052,70,49,0,-21
-41.98657,-20.75052,70,43,0,-27
-41.98387,-20.75052,68,41,0,-27
-41.98118,-20.75052,58,39,0,-19
-41.97826,-20.75052,69,44,0,-25
-41.97556,-20.75052,58,38,5,-20
-41.97286,-20.75052,54,47,0,-7
-41.96994,-20.75052,54,48,0,-6
-42.1005,-20.75031,65,30,0,-35
-42.0978,-20.75031,66,31,0,-35
-42.09511,-20.75031,58,25,5,-33
-42.09219,-20.75031,58,26,5,-32
-42.08949,-20.75031,61,27,5,-34
-42.08657,-20.75031,63,33,5,-30
-42.08387,-20.75031,63,32,5,-31
-42.08118,-20.75031,57,33,5,-24
-42.07825,-20.75031,56,33,5,-23
-42.07556,-20.75031,64,32,5,-32
-42.07286,-20.75031,51,34,5,-17
-42.06994,-20.75031,50,38,5,-12
-42.06724,-20.75031,52,34,5,-18
-42.06455,-20.75031,55,39,5,-16
-42.06163,-20.75031,56,38,5,-18
-42.05893,-20.75031,55,31,5,-24
-42.05601,-20.75031,52,33,5,-19
-42.05331,-20.75031,59,40,5,-19
-42.05061,-20.75031,54,41,5,-13
-42.04769,-20.75031,47,29,5,-18
-42.045,-20.75031,43,25,5,-18
-42.0423,-20.75031,41,41,5,0
-42.03938,-20.75031,44,43,5,-1
-42.03668,-20.75031,42,42,5,0
-42.03399,-20.75031,47,48,0,1
-42.03106,-20.75031,51,42,0,-9
-42.02837,-20.75031,42,42,0,0
-42.02545,-20.75031,48,45,5,-3
-42.02275,-20.75031,57,44,5,-13
-42.02005,-20.75031,54,51,5,-3
-42.01713,-20.75031,56,43,5,-13
-42.01444,-20.75031,51,39,5,-12
-42.01174,-20.75031,52,46,5,-6
-42.00882,-20.75031,66,41,5,-25
-42.00612,-20.75031,64,50,0,-14
-42.00342,-20.75031,64,40,5,-24
-42.0005,-20.75031,61,38,5,-23
-41.99781,-20.75031,66,37,5,-29
-41.99511,-20.75031,68,41,0,-27
-41.99219,-20.75031,67,49,0,-18
-41.98949,-20.75031,70,48,0,-22
-41.98657,-20.75031,71,43,0,-28
-41.98387,-20.75031,69,40,0,-29
-41.98118,-20.75031,57,38,0,-19
-41.97826,-20.75031,69,45,0,-24
-41.97556,-20.75031,57,34,5,-23
-41.97286,-20.75031,54,47,0,-7
-41.96994,-20.75031,54,48,0,-6
-42.1005,-20.75009,64,30,0,-34
-42.0978,-20.75009,65,30,0,-35
-42.09511,-20.75009,59,25,5,-34
-42.09219,-20.75009,58,26,5,-32
-42.08949,-20.75009,61,28,5,-33
-42.08657,-20.75009,63,32,5,-31
-42.08387,-20.75009,63,32,5,-31
-42.08118,-20.75009,54,33,5,-21
-42.07825,-20.75009,55,34,5,-21
-42.07556,-20.75009,64,32,5,-32
-42.07286,-20.75009,51,34,5,-17
-42.06994,-20.75009,50,38,0,-12
-42.06724,-20.75009,52,34,5,-18
-42.06455,-20.75009,55,39,5,-16
-42.06163,-20.75009,56,38,5,-18
-42.05893,-20.75009,55,31,5,-24
-42.05601,-20.75009,52,32,5,-20
-42.05331,-20.75009,58,41,5,-17
-42.05061,-20.75009,52,40,5,-12
-42.04769,-20.75009,48,34,5,-14
-42.045,-20.75009,44,25,5,-19
-42.0423,-20.75009,42,41,5,-1
-42.03938,-20.75009,44,43,5,-1
-42.03668,-20.75009,42,42,5,0
-42.03399,-20.75009,47,47,0,0
-42.03106,-20.75009,51,42,0,-9
-42.02837,-20.75009,42,42,0,0
-42.02545,-20.75009,48,47,5,-1
-42.02275,-20.75009,59,44,5,-15
-42.02005,-20.75009,54,51,5,-3
-42.01713,-20.75009,57,40,5,-17
-42.01444,-20.75009,52,39,5,-13
-42.01174,-20.75009,52,52,5,0
-42.00882,-20.75009,65,41,5,-24
-42.00612,-20.75009,64,50,0,-14
-42.00342,-20.75009,64,43,5,-21
-42.0005,-20.75009,63,39,5,-24
-41.99781,-20.75009,67,38,5,-29
-41.99511,-20.75009,68,41,5,-27
-41.99219,-20.75009,67,49,0,-18
-41.98949,-20.75009,69,47,0,-22
-41.98657,-20.75009,71,43,0,-28
-41.98387,-20.75009,70,39,0,-31
-41.98118,-20.75009,58,38,0,-20
-41.97826,-20.75009,69,45,0,-24
-41.97556,-20.75009,57,31,5,-26
-41.97286,-20.75009,54,47,0,-7
-41.96994,-20.75009,60,48,0,-12
-42.1005,-20.74967,65,30,0,-35
-42.0978,-20.74967,65,29,0,-36
-42.09511,-20.74967,59,25,5,-34
-42.09219,-20.74967,58,26,5,-32
-42.08949,-20.74967,61,28,5,-33
-42.08657,-20.74967,62,32,5,-30
-42.08387,-20.74967,62,34,5,-28
-42.08118,-20.74967,54,34,5,-20
-42.07825,-20.74967,55,34,5,-21
-42.07556,-20.74967,65,33,5,-32
-42.07286,-20.74967,51,34,5,-17
-42.06994,-20.74967,51,38,0,-13
-42.06724,-20.74967,54,35,5,-19
-42.06455,-20.74967,55,37,5,-18
-42.06163,-20.74967,56,38,5,-18
-42.05893,-20.74967,55,31,5,-24
-42.05601,-20.74967,52,32,5,-20
-42.05331,-20.74967,59,41,5,-18
-42.05061,-20.74967,52,41,5,-11
-42.04769,-20.74967,49,35,5,-14
-42.045,-20.74967,46,26,5,-20
-42.0423,-20.74967,43,42,5,-1
-42.03938,-20.74967,44,41,5,-3
-42.03668,-20.74967,43,43,5,0
-42.03399,-20.74967,47,48,0,1
-42.03106,-20.74967,51,42,0,-9
-42.02837,-20.74967,42,42,0,0
-42.02545,-20.74967,49,49,5,0
-42.02275,-20.74967,52,45,5,-7
-42.02005,-20.74967,56,51,11,-5
-42.01713,-20.74967,58,42,5,-16
-42.01444,-20.74967,52,39,5,-13
-42.01174,-20.74967,52,52,0,0
-42.00882,-20.74967,58,43,5,-15
-42.00612,-20.74967,64,51,0,-13
-42.00342,-20.74967,65,43,5,-22
-42.0005,-20.74967,61,40,5,-21
-41.99781,-20.74967,64,43,0,-21
-41.99511,-20.74967,67,42,11,-25
-41.99219,-20.74967,67,45,0,-22
-41.98949,-20.74967,68,45,0,-23
-41.98657,-20.74967,71,43,0,-28
-41.98387,-20.74967,71,35,0,-36
-41.98118,-20.74967,58,38,0,-20
-41.97826,-20.74967,71,45,0,-26
-41.97556,-20.74967,57,34,5,-23
-41.97286,-20.74967,54,47,0,-7
-41.96994,-20.74967,54,48,0,-6
-42.1005,-20.74946,61,30,0,-31
-42.0978,-20.74946,66,28,0,-38
-42.09511,-20.74946,59,25,5,-34
-42.09219,-20.74946,58,26,5,-32
-42.08949,-20.74946,60,28,5,-32
-42.08657,-20.74946,62,32,5,-30
-42.08387,-20.74946,62,33,5,-29
-42.08118,-20.74946,54,34,5,-20
-42.07825,-20.74946,55,34,5,-21
-42.07556,-20.74946,64,33,5,-31
-42.07286,-20.74946,51,35,5,-16
-42.06994,-20.74946,51,38,0,-13
-42.06724,-20.74946,56,35,5,-21
-42.06455,-20.74946,55,37,5,-18
-42.06163,-20.74946,56,38,5,-18
-42.05893,-20.74946,55,31,5,-24
-42.05601,-20.74946,53,36,5,-17
-42.05331,-20.74946,59,41,5,-18
-42.05061,-20.74946,52,40,5,-12
-42.04769,-20.74946,49,35,5,-14
-42.045,-20.74946,46,28,5,-18
-42.0423,-20.74946,44,42,5,-2
-42.03938,-20.74946,45,43,5,-2
-42.03668,-20.74946,44,45,5,1
-42.03399,-20.74946,46,45,0,-1
-42.03106,-20.74946,51,42,0,-9
-42.02837,-20.74946,42,42,0,0
-42.02545,-20.74946,49,50,0,1
-42.02275,-20.74946,48,45,5,-3
-42.02005,-20.74946,55,50,11,-5
-42.01713,-20.74946,58,42,5,-16
-42.01444,-20.74946,53,39,5,-14
-42.01174,-20.74946,52,54,0,2
-42.00882,-20.74946,54,47,11,-7
-42.00612,-20.74946,65,50,0,-15
-42.00342,-20.74946,64,51,5,-13
-42.0005,-20.74946,61,41,5,-20
-41.99781,-20.74946,64,44,0,-20
-41.99511,-20.74946,67,47,11,-20
-41.99219,-20.74946,67,42,0,-25
-41.98949,-20.74946,68,45,0,-23
-41.98657,-20.74946,71,44,0,-27
-41.98387,-20.74946,72,35,0,-37
-41.98118,-20.74946,58,38,0,-20
-41.97826,-20.74946,71,44,0,-27
-41.97556,-20.74946,57,38,5,-19
-41.97286,-20.74946,54,47,0,-7
-41.96994,-20.74946,64,39,0,-25
-42.1005,-20.74925,59,30,0,-29
-42.0978,-20.74925,66,28,0,-38
-42.09511,-20.74925,58,25,5,-33
-42.09219,-20.74925,59,26,5,-33
-42.08949,-20.74925,58,28,5,-30
-42.08657,-20.74925,62,32,5,-30
-42.08387,-20.74925,62,34,5,-28
-42.08118,-20.74925,54,34,5,-20
-42.07825,-20.74925,55,35,5,-20
-42.07556,-20.74925,64,34,5,-30
-42.07286,-20.74925,52,35,5,-17
-42.06994,-20.74925,51,38,0,-13
-42.06724,-20.74925,55,35,5,-20
-42.06455,-20.74925,54,37,5,-17
-42.06163,-20.74925,56,37,5,-19
-42.05893,-20.74925,56,31,5,-25
-42.05601,-20.74925,54,38,5,-16
-42.05331,-20.74925,53,41,5,-12
-42.05061,-20.74925,53,40,5,-13
-42.04769,-20.74925,50,35,5,-15
-42.045,-20.74925,47,30,5,-17
-42.0423,-20.74925,45,48,5,3
-42.03938,-20.74925,45,43,5,-2
-42.03668,-20.74925,44,45,5,1
-42.03399,-20.74925,47,47,0,0
-42.03106,-20.74925,52,40,5,-12
-42.02837,-20.74925,42,42,0,0
-42.02545,-20.74925,50,50,0,0
-42.02275,-20.74925,51,47,5,-4
-42.02005,-20.74925,56,49,0,-7
-42.01713,-20.74925,58,41,5,-17
-42.01444,-20.74925,53,41,5,-12
-42.01174,-20.74925,52,52,0,0
-42.00882,-20.74925,54,49,5,-5
-42.00612,-20.74925,67,51,0,-16
-42.00342,-20.74925,65,51,0,-14
-42.0005,-20.74925,59,42,5,-17
-41.99781,-20.74925,64,45,0,-19
-41.99511,-20.74925,67,47,11,-20
-41.99219,-20.74925,67,40,0,-27
-41.98949,-20.74925,68,45,0,-23
-41.98657,-20.74925,71,43,0,-28
-41.98387,-20.74925,75,35,0,-40
-41.98118,-20.74925,58,38,0,-20
-41.97826,-20.74925,71,44,0,-27
-41.97556,-20.74925,57,46,5,-11
-41.97286,-20.74925,54,47,0,-7
-41.96994,-20.74925,64,48,0,-16
-42.1005,-20.74883,59,30,5,-29
-42.0978,-20.74883,67,29,0,-38
-42.09511,-20.74883,59,25,5,-34
-42.09219,-20.74883,59,26,5,-33
-42.08949,-20.74883,58,27,5,-31
-42.08657,-20.74883,62,31,5,-31
-42.08387,-20.74883,63,34,5,-29
-42.08118,-20.74883,54,33,5,-21
-42.07825,-20.74883,55,36,5,-19
-42.07556,-20.74883,65,36,5,-29
-42.07286,-20.74883,52,34,5,-18
-42.06994,-20.74883,52,38,0,-14
-42.06724,-20.74883,53,35,5,-18
-42.06455,-20.74883,54,36,5,-18
-42.06163,-20.74883,56,37,5,-19
-42.05893,-20.74883,56,31,5,-25
-42.05601,-20.74883,54,38,5,-16
-42.05331,-20.74883,53,40,5,-13
-42.05061,-20.74883,53,36,5,-17
-42.04769,-20.74883,50,37,5,-13
-42.045,-20.74883,47,29,5,-18
-42.0423,-20.74883,45,53,0,8
-42.03938,-20.74883,46,46,5,0
-42.03668,-20.74883,45,45,5,0
-42.03399,-20.74883,46,43,5,-3
-42.03106,-20.74883,51,40,5,-11
-42.02837,-20.74883,42,39,5,-3
-42.02545,-20.74883,51,47,0,-4
-42.02275,-20.74883,53,45,5,-8
-42.02005,-20.74883,58,45,5,-13
-42.01713,-20.74883,58,42,5,-16
-42.01444,-20.74883,54,44,5,-10
-42.01174,-20.74883,53,50,0,-3
-42.00882,-20.74883,54,48,11,-6
-42.00612,-20.74883,66,51,0,-15
-42.00342,-20.74883,65,53,0,-12
-42.0005,-20.74883,59,42,5,-17
-41.99781,-20.74883,66,45,0,-21
-41.99511,-20.74883,67,48,5,-19
-41.99219,-20.74883,65,41,0,-24
-41.98949,-20.74883,68,45,0,-23
-41.98657,-20.74883,72,47,0,-25
-41.98387,-20.74883,81,34,0,-47
-41.98118,-20.74883,59,38,0,-21
-41.97826,-20.74883,72,42,0,-30
-41.97556,-20.74883,58,46,5,-12
-41.97286,-20.74883,54,47,0,-7
-41.96994,-20.74883,53,43,0,-10
-42.1005,-20.74861,62,29,5,-33
-42.0978,-20.74861,67,29,0,-38
-42.09511,-20.74861,59,25,5,-34
-42.09219,-20.74861,59,26,5,-33
-42.08949,-20.74861,58,27,5,-31
-42.08657,-20.74861,62,31,5,-31
-42.08387,-20.74861,64,36,5,-28
-42.08118,-20.74861,55,33,5,-22
-42.07825,-20.74861,55,36,5,-19
-42.07556,-20.74861,65,36,5,-29
-42.07286,-20.74861,52,34,5,-18
-42.06994,-20.74861,52,38,0,-14
-42.06724,-20.74861,53,34,5,-19
-42.06455,-20.74861,54,36,5,-18
-42.06163,-20.74861,56,37,5,-19
-42.05893,-20.74861,57,31,5,-26
-42.05601,-20.74861,55,38,5,-17
-42.05331,-20.74861,53,40,5,-13
-42.05061,-20.74861,53,37,5,-16
-42.04769,-20.74861,51,38,5,-13
-42.045,-20.74861,49,30,5,-19
-42.0423,-20.74861,46,53,0,7
-42.03938,-20.74861,48,47,11,-1
-42.03668,-20.74861,45,44,5,-1
-42.03399,-20.74861,46,43,5,-3
-42.03106,-20.74861,52,44,5,-8
-42.02837,-20.74861,42,39,5,-3
-42.02545,-20.74861,51,47,0,-4
-42.02275,-20.74861,48,46,5,-2
-42.02005,-20.74861,59,46,5,-13
-42.01713,-20.74861,57,41,5,-16
-42.01444,-20.74861,54,56,5,2
-42.01174,-20.74861,53,47,0,-6
-42.00882,-20.74861,54,47,11,-7
-42.00612,-20.74861,63,51,0,-12
-42.00342,-20.74861,65,53,0,-12
-42.0005,-20.74861,57,52,5,-5
-41.99781,-20.74861,65,48,0,-17
-41.99511,-20.74861,67,44,5,-23
-41.99219,-20.74861,64,41,0,-23
-41.98949,-20.74861,68,45,0,-23
-41.98657,-20.74861,72,48,0,-24
-41.98387,-20.74861,90,35,0,-55
-41.98118,-20.74861,63,38,0,-25
-41.97826,-20.74861,69,41,0,-28
-41.97556,-20.74861,57,44,5,-13
-41.97286,-20.74861,55,47,0,-8
-41.96994,-20.74861,53,37,0,-16
-42.10297,-20.7484,63,30,5,-33
-42.10275,-20.7484,63,31,5,-32
-42.10252,-20.7484,61,32,5,-29
-42.1023,-20.7484,58,31,5,-27
-42.10185,-20.7484,62,34,5,-28
-42.10163,-20.7484,59,34,5,-25
-42.1014,-20.7484,59,34,5,-25
-42.10118,-20.7484,58,29,5,-29
-42.10073,-20.7484,58,29,5,-29
-42.1005,-20.7484,59,30,5,-29
-42.10028,-20.7484,59,32,5,-27
-42.10005,-20.7484,59,32,0,-27
-42.09983,-20.7484,59,31,0,-28
-42.09938,-20.7484,61,30,0,-31
-42.09915,-20.7484,63,30,0,-33
-42.09893,-20.7484,64,29,0,-35
-42.0987,-20.7484,65,29,0,-36
-42.09825,-20.7484,66,29,0,-37
-42.09803,-20.7484,66,29,0,-37
-42.0978,-20.7484,66,29,0,-37
-42.09758,-20.7484,68,29,0,-39
-42.09713,-20.7484,61,28,5,-33
-42.09691,-20.7484,59,25,5,-34
-42.09668,-20.7484,58,25,5,-33
-42.09646,-20.7484,59,25,5,-34
-42.09601,-20.7484,59,25,5,-34
-42.09578,-20.7484,58,24,5,-34
-42.09556,-20.7484,59,25,5,-34
-42.09533,-20.7484,59,25,5,-34
-42.09511,-20.7484,59,25,5,-34
-42.09466,-20.7484,59,25,5,-34
-42.09443,-20.7484,59,25,5,-34
-42.09421,-20.7484,59,25,5,-34
-42.09398,-20.7484,59,25,5,-34
-42.09354,-20.7484,59,25,5,-34
-42.09331,-20.7484,59,25,5,-34
-42.09309,-20.7484,59,25,5,-34
-42.09286,-20.7484,59,26,5,-33
-42.09241,-20.7484,59,26,5,-33
-42.09219,-20.7484,59,25,5,-34
-42.09196,-20.7484,59,26,5,-33
-42.09174,-20.7484,59,26,5,-33
-42.09129,-20.7484,59,26,5,-33
-42.09106,-20.7484,59,26,5,-33
-42.09084,-20.7484,59,27,5,-32
-42.09061,-20.7484,59,27,5,-32
-42.09039,-20.7484,59,27,5,-32
-42.08994,-20.7484,61,26,5,-35
-42.08972,-20.7484,59,27,5,-32
-42.08949,-20.7484,59,28,5,-31
-42.08927,-20.7484,60,28,5,-32
-42.08882,-20.7484,59,29,5,-30
-42.08859,-20.7484,58,29,5,-29
-42.08837,-20.7484,58,30,5,-28
-42.08814,-20.7484,58,30,5,-28
-42.08769,-20.7484,60,30,5,-30
-42.08747,-20.7484,60,30,5,-30
-42.08724,-20.7484,61,30,5,-31
-42.08702,-20.7484,63,31,5,-32
-42.08657,-20.7484,62,31,5,-31
-42.08634,-20.7484,63,30,5,-33
-42.08612,-20.7484,66,30,5,-36
-42.08589,-20.7484,63,31,5,-32
-42.08545,-20.7484,65,31,5,-34
-42.08522,-20.7484,66,31,5,-35
-42.085,-20.7484,64,32,5,-32
-42.08477,-20.7484,67,33,5,-34
-42.08455,-20.7484,63,34,5,-29
-42.0841,-20.7484,62,36,5,-26
-42.08387,-20.7484,63,36,5,-27
-42.08365,-20.7484,58,36,5,-22
-42.08342,-20.7484,55,36,5,-19
-42.08297,-20.7484,55,36,5,-19
-42.08275,-20.7484,55,34,5,-21
-42.08252,-20.7484,55,33,5,-22
-42.0823,-20.7484,55,32,5,-23
-42.08185,-20.7484,55,32,5,-23
-42.08163,-20.7484,55,32,5,-23
-42.0814,-20.7484,55,33,5,-22
-42.08118,-20.7484,55,33,5,-22
-42.08073,-20.7484,55,35,5,-20
-42.0805,-20.7484,55,37,5,-18
-42.08028,-20.7484,55,35,5,-20
-42.08005,-20.7484,55,35,5,-20
-42.07983,-20.7484,55,33,5,-22
-42.07938,-20.7484,55,34,5,-21
-42.07915,-20.7484,55,34,5,-21
-42.07893,-20.7484,55,34,5,-21
-42.0787,-20.7484,55,35,5,-20
-42.07825,-20.7484,55,36,5,-19
-42.07803,-20.7484,55,36,5,-19
-42.07781,-20.7484,55,36,5,-19
-42.07758,-20.7484,55,34,5,-21
-42.07713,-20.7484,55,33,5,-22
-42.07691,-20.7484,56,33,5,-23
-42.07668,-20.7484,58,32,5,-26
-42.07646,-20.7484,61,33,5,-28
-42.07601,-20.7484,62,35,5,-27
-42.07578,-20.7484,62,36,5,-26
-42.07556,-20.7484,64,36,5,-28
-42.07533,-20.7484,63,36,5,-27
-42.07511,-20.7484,64,35,5,-29
-42.07466,-20.7484,62,33,5,-29
-42.07443,-20.7484,58,33,5,-25
-42.07421,-20.7484,56,33,5,-23
-42.07399,-20.7484,53,33,5,-20
-42.07354,-20.7484,53,32,5,-21
-42.07331,-20.7484,52,33,5,-19
-42.07309,-20.7484,52,34,5,-18
-42.07286,-20.7484,52,34,5,-18
-42.07241,-20.7484,53,34,5,-19
-42.07219,-20.7484,53,35,5,-18
-42.07196,-20.7484,53,35,5,-18
-42.07174,-20.7484,53,36,5,-17
-42.07129,-20.7484,53,35,5,-18
-42.07106,-20.7484,53,35,5,-18
-42.07084,-20.7484,53,36,5,-17
-42.07061,-20.7484,53,38,5,-15
-42.07039,-20.7484,52,38,0,-14
-42.06994,-20.7484,53,38,0,-15
-42.06972,-20.7484,53,38,0,-15
-42.06949,-20.7484,53,38,0,-15
-42.06927,-20.7484,53,37,5,-16
-42.06882,-20.7484,53,35,5,-18
-42.06859,-20.7484,53,34,5,-19
-42.06837,-20.7484,53,35,5,-18
-42.06814,-20.7484,54,35,5,-19
-42.06769,-20.7484,54,35,5,-19
-42.06747,-20.7484,54,35,5,-19
-42.06724,-20.7484,54,34,5,-20
-42.06702,-20.7484,54,35,5,-19
-42.06657,-20.7484,54,35,5,-19
-42.06634,-20.7484,54,34,5,-20
-42.06612,-20.7484,54,34,5,-20
-42.0659,-20.7484,54,35,5,-19
-42.06545,-20.7484,54,35,5,-19
-42.06522,-20.7484,53,35,5,-18
-42.065,-20.7484,53,35,5,-18
-42.06477,-20.7484,54,36,5,-18
-42.06455,-20.7484,54,36,5,-18
-42.0641,-20.7484,54,37,5,-17
-42.06387,-20.7484,54,37,5,-17
-42.06365,-20.7484,54,38,5,-16
-42.06342,-20.7484,55,38,5,-17
-42.06297,-20.7484,55,38,5,-17
-42.06275,-20.7484,55,38,5,-17
-42.06252,-20.7484,55,38,5,-17
-42.0623,-20.7484,55,38,5,-17
-42.06185,-20.7484,55,37,5,-18
-42.06163,-20.7484,56,37,5,-19
-42.0614,-20.7484,56,37,5,-19
-42.06118,-20.7484,56,37,5,-19
-42.06073,-20.7484,56,37,5,-19
-42.0605,-20.7484,57,37,5,-20
-42.06028,-20.7484,57,37,5,-20
-42.06005,-20.7484,57,37,5,-20
-42.05983,-20.7484,57,36,5,-21
-42.05938,-20.7484,57,36,5,-21
-42.05915,-20.7484,57,36,5,-21
-42.05893,-20.7484,57,31,5,-26
-42.0587,-20.7484,57,30,5,-27
-42.05826,-20.7484,57,30,5,-27
-42.05803,-20.7484,56,30,5,-26
-42.05781,-20.7484,56,30,5,-26
-42.05758,-20.7484,56,29,5,-27
-42.05713,-20.7484,56,29,5,-27
-42.05691,-20.7484,56,36,5,-20
-42.05668,-20.7484,56,36,5,-20
-42.05646,-20.7484,56,36,5,-20
-42.05601,-20.7484,56,34,5,-22
-42.05578,-20.7484,55,38,5,-17
-42.05556,-20.7484,55,38,5,-17
-42.05533,-20.7484,54,38,5,-16
-42.05511,-20.7484,54,37,5,-17
-42.05466,-20.7484,54,37,5,-17
-42.05443,-20.7484,53,38,5,-15
-42.05421,-20.7484,53,37,5,-16
-42.05399,-20.7484,53,40,5,-13
-42.05354,-20.7484,53,39,5,-14
-42.05331,-20.7484,53,40,5,-13
-42.05309,-20.7484,53,39,5,-14
-42.05286,-20.7484,53,38,5,-15
-42.05241,-20.7484,52,37,5,-15
-42.05219,-20.7484,52,37,5,-15
-42.05196,-20.7484,52,37,5,-15
-42.05174,-20.7484,52,37,5,-15
-42.05129,-20.7484,53,37,5,-16
-42.05106,-20.7484,53,37,5,-16
-42.05084,-20.7484,53,37,5,-16
-42.05061,-20.7484,53,36,5,-17
-42.05039,-20.7484,53,40,5,-13
-42.04994,-20.7484,53,41,5,-12
-42.04972,-20.7484,53,41,5,-12
-42.04949,-20.7484,52,41,5,-11
-42.04927,-20.7484,52,41,5,-11
-42.04882,-20.7484,52,41,5,-11
-42.04859,-20.7484,52,41,5,-11
-42.04837,-20.7484,52,41,5,-11
-42.04814,-20.7484,52,40,5,-12
-42.04769,-20.7484,51,37,5,-14
-42.04747,-20.7484,51,37,5,-14
-42.04724,-20.7484,51,37,5,-14
-42.04702,-20.7484,51,37,5,-14
-42.04657,-20.7484,50,32,5,-18
-42.04635,-20.7484,50,34,5,-16
-42.04612,-20.7484,50,34,5,-16
-42.0459,-20.7484,50,34,5,-16
-42.04545,-20.7484,52,31,5,-21
-42.04522,-20.7484,50,31,5,-19
-42.045,-20.7484,50,30,5,-20
-42.04477,-20.7484,52,35,5,-17
-42.04455,-20.7484,54,37,5,-17
-42.0441,-20.7484,53,41,5,-12
-42.04387,-20.7484,57,48,5,-9
-42.04365,-20.7484,57,49,11,-8
-42.04342,-20.7484,57,52,0,-5
-42.04297,-20.7484,57,52,0,-5
-42.04275,-20.7484,56,53,0,-3
-42.04253,-20.7484,56,53,0,-3
-42.0423,-20.7484,49,52,0,3
-42.04185,-20.7484,46,53,0,7
-42.04163,-20.7484,46,53,0,7
-42.0414,-20.7484,47,52,0,5
-42.04118,-20.7484,47,51,0,4
-42.04073,-20.7484,47,52,0,5
-42.0405,-20.7484,48,53,0,5
-42.04028,-20.7484,49,52,0,3
-42.04005,-20.7484,50,53,0,3
-42.03983,-20.7484,50,50,11,0
-42.03938,-20.7484,50,46,5,-4
-42.03915,-20.7484,48,47,5,-1
-42.03893,-20.7484,47,47,11,0
-42.0387,-20.7484,47,47,11,0
-42.03826,-20.7484,47,45,5,-2
-42.03803,-20.7484,47,47,5,0
-42.03781,-20.7484,46,46,5,0
-42.03758,-20.7484,46,46,5,0
-42.03713,-20.7484,46,45,5,-1
-42.03691,-20.7484,45,45,5,0
-42.03668,-20.7484,45,45,5,0
-42.03646,-20.7484,44,45,5,1
-42.03601,-20.7484,44,43,5,-1
-42.03578,-20.7484,43,42,5,-1
-42.03556,-20.7484,43,42,5,-1
-42.03533,-20.7484,41,41,5,0
-42.03511,-20.7484,39,42,5,3
-42.03466,-20.7484,41,41,5,0
-42.03444,-20.7484,44,44,5,0
-42.03421,-20.7484,46,44,5,-2
-42.03399,-20.7484,47,44,5,-3
-42.03354,-20.7484,48,42,5,-6
-42.03331,-20.7484,48,41,5,-7
-42.03309,-20.7484,49,39,5,-10
-42.03286,-20.7484,49,39,5,-10
-42.03241,-20.7484,50,39,5,-11
-42.03219,-20.7484,50,40,5,-10
-42.03196,-20.7484,52,41,5,-11
-42.03174,-20.7484,53,41,5,-12
-42.03129,-20.7484,54,44,5,-10
-42.03106,-20.7484,53,45,5,-8
-42.03084,-20.7484,52,45,5,-7
-42.03062,-20.7484,47,44,5,-3
-42.03017,-20.7484,47,45,0,-2
-42.02994,-20.7484,44,44,0,0
-42.02972,-20.7484,42,44,0,2
-42.02949,-20.7484,43,44,0,1
-42.02927,-20.7484,43,44,0,1
-42.02882,-20.7484,42,41,5,-1
-42.02859,-20.7484,42,40,5,-2
-42.02837,-20.7484,42,39,5,-3
-42.02814,-20.7484,42,39,5,-3
-42.02769,-20.7484,42,39,5,-3
-42.02747,-20.7484,49,39,5,-10
-42.02724,-20.7484,51,39,5,-12
-42.02702,-20.7484,52,39,5,-13
-42.02657,-20.7484,53,45,5,-8
-42.02635,-20.7484,53,46,0,-7
-42.02612,-20.7484,54,46,0,-8
-42.0259,-20.7484,53,46,0,-7
-42.02545,-20.7484,52,46,0,-6
-42.02522,-20.7484,52,46,0,-6
-42.025,-20.7484,51,46,0,-5
-42.02477,-20.7484,50,46,0,-4
-42.02455,-20.7484,49,46,0,-3
-42.0241,-20.7484,49,49,5,0
-42.02387,-20.7484,48,48,5,0
-42.02365,-20.7484,49,49,5,0
-42.02342,-20.7484,48,48,5,0
-42.02297,-20.7484,48,48,5,0
-42.02275,-20.7484,48,49,5,1
-42.02253,-20.7484,49,47,5,-2
-42.0223,-20.7484,48,46,5,-2
-42.02185,-20.7484,53,46,5,-7
-42.02163,-20.7484,54,45,5,-9
-42.0214,-20.7484,51,44,5,-7
-42.02118,-20.7484,54,45,5,-9
-42.02073,-20.7484,58,43,5,-15
-42.0205,-20.7484,59,46,5,-13
-42.02028,-20.7484,60,46,11,-14
-42.02005,-20.7484,60,46,5,-14
-42.01983,-20.7484,61,42,5,-19
-42.01938,-20.7484,61,43,5,-18
-42.01915,-20.7484,62,42,5,-20
-42.01893,-20.7484,60,43,5,-17
-42.01871,-20.7484,58,43,5,-15
-42.01826,-20.7484,57,44,5,-13
-42.01803,-20.7484,58,44,5,-14
-42.01781,-20.7484,58,44,5,-14
-42.01758,-20.7484,57,43,5,-14
-42.01713,-20.7484,57,38,5,-19
-42.01691,-20.7484,60,38,5,-22
-42.01668,-20.7484,57,38,5,-19
-42.01646,-20.7484,57,35,5,-22
-42.01601,-20.7484,57,35,5,-22
-42.01578,-20.7484,57,35,5,-22
-42.01556,-20.7484,56,36,5,-20
-42.01533,-20.7484,56,48,5,-8
-42.01511,-20.7484,55,48,11,-7
-42.01466,-20.7484,55,56,5,1
-42.01444,-20.7484,54,56,5,2
-42.01421,-20.7484,54,56,5,2
-42.01399,-20.7484,55,50,5,-5
-42.01354,-20.7484,54,47,5,-7
-42.01331,-20.7484,54,48,5,-6
-42.01309,-20.7484,54,51,5,-3
-42.01286,-20.7484,53,45,5,-8
-42.01241,-20.7484,53,41,5,-12
-42.01219,-20.7484,54,41,5,-13
-42.01196,-20.7484,53,43,5,-10
-42.01174,-20.7484,54,45,0,-9
-42.01129,-20.7484,54,49,0,-5
-42.01106,-20.7484,55,49,0,-6
-42.01084,-20.7484,55,48,11,-7
-42.01062,-20.7484,55,48,11,-7
-42.01017,-20.7484,55,45,0,-10
-42.00994,-20.7484,55,45,0,-10
-42.00972,-20.7484,55,46,0,-9
-42.00949,-20.7484,55,45,0,-10
-42.00927,-20.7484,55,46,0,-9
-42.00882,-20.7484,55,47,0,-8
-42.00859,-20.7484,54,47,0,-7
-42.00837,-20.7484,54,47,11,-7
-42.00814,-20.7484,54,47,11,-7
-42.00769,-20.7484,54,47,0,-7
-42.00747,-20.7484,54,47,0,-7
-42.00724,-20.7484,54,48,0,-6
-42.00702,-20.7484,54,48,0,-6
-42.00657,-20.7484,59,50,11,-9
-42.00635,-20.7484,58,51,0,-7
-42.00612,-20.7484,60,51,0,-9
-42.0059,-20.7484,61,51,0,-10
-42.00545,-20.7484,62,51,0,-11
-42.00522,-20.7484,64,51,0,-13
-42.005,-20.7484,64,51,0,-13
-42.00477,-20.7484,66,51,0,-15
-42.00455,-20.7484,65,53,0,-12
-42.0041,-20.7484,65,53,0,-12
-42.00387,-20.7484,65,53,0,-12
-42.00365,-20.7484,65,53,0,-12
-42.00342,-20.7484,65,52,0,-13
-42.00298,-20.7484,64,52,0,-12
-42.00275,-20.7484,63,52,0,-11
-42.00253,-20.7484,61,52,0,-9
-42.0023,-20.7484,61,52,0,-9
-42.00185,-20.7484,61,52,0,-9
-42.00163,-20.7484,55,52,0,-3
-42.0014,-20.7484,63,52,5,-11
-42.00118,-20.7484,59,52,5,-7
-42.00073,-20.7484,57,52,5,-5
-42.0005,-20.7484,59,52,5,-7
-42.00028,-20.7484,60,52,5,-8
-42.00005,-20.7484,61,52,5,-9
-41.99983,-20.7484,62,52,5,-10
-41.99938,-20.7484,63,52,5,-11
-41.99916,-20.7484,64,52,5,-12
-41.99893,-20.7484,64,52,5,-12
-41.99871,-20.7484,63,52,0,-11
-41.99826,-20.7484,64,52,0,-12
-41.99803,-20.7484,64,51,0,-13
-41.99781,-20.7484,65,51,0,-14
-41.99758,-20.7484,66,48,0,-18
-41.99713,-20.7484,67,46,0,-21
-41.99691,-20.7484,66,46,0,-20
-41.99668,-20.7484,65,44,0,-21
-41.99646,-20.7484,66,43,0,-23
-41.99601,-20.7484,66,43,6,-23
-41.99578,-20.7484,66,44,5,-22
-41.99556,-20.7484,67,48,5,-19
-41.99533,-20.7484,67,48,11,-19
-41.99511,-20.7484,67,48,5,-19
-41.99466,-20.7484,66,43,5,-23
-41.99444,-20.7484,66,47,0,-19
-41.99421,-20.7484,65,49,0,-16
-41.99399,-20.7484,64,49,0,-15
-41.99354,-20.7484,64,45,0,-19
-41.99331,-20.7484,63,42,0,-21
-41.99309,-20.7484,63,40,0,-23
-41.99286,-20.7484,63,40,0,-23
-41.99241,-20.7484,64,40,0,-24
-41.99219,-20.7484,66,42,0,-24
-41.99196,-20.7484,67,42,0,-25
-41.99174,-20.7484,66,42,0,-24
-41.99129,-20.7484,66,40,0,-26
-41.99107,-20.7484,66,41,0,-25
-41.99084,-20.7484,65,42,0,-23
-41.99062,-20.7484,65,43,0,-22
-41.99017,-20.7484,65,44,0,-21
-41.98994,-20.7484,65,45,0,-20
-41.98972,-20.7484,66,45,0,-21
-41.98949,-20.7484,67,45,0,-22
-41.98927,-20.7484,69,45,0,-24
-41.98882,-20.7484,69,45,0,-24
-41.98859,-20.7484,69,45,0,-24
-41.98837,-20.7484,69,45,0,-24
-41.98814,-20.7484,69,45,0,-24
-41.98769,-20.7484,70,46,0,-24
-41.98747,-20.7484,70,46,0,-24
-41.98725,-20.7484,70,47,0,-23
-41.98702,-20.7484,71,47,0,-24
-41.98657,-20.7484,72,48,0,-24
-41.98635,-20.7484,75,48,0,-27
-41.98612,-20.7484,77,48,0,-29
-41.9859,-20.7484,83,48,0,-35
-41.98545,-20.7484,91,44,0,-47
-41.98522,-20.7484,91,42,0,-49
-41.985,-20.7484,91,36,0,-55
-41.98477,-20.7484,92,35,0,-57
-41.98455,-20.7484,80,35,0,-45
-41.9841,-20.7484,82,35,0,-47
-41.98387,-20.7484,82,35,0,-47
-41.98365,-20.7484,89,35,0,-54
-41.98343,-20.7484,75,36,0,-39
-41.98298,-20.7484,73,37,0,-36
-41.98275,-20.7484,73,37,0,-36
-41.98253,-20.7484,72,38,0,-34
-41.9823,-20.7484,71,39,0,-32
-41.98185,-20.7484,70,39,0,-31
-41.98163,-20.7484,68,39,0,-29
-41.9814,-20.7484,68,38,0,-30
-41.98118,-20.7484,67,38,0,-29
-41.98073,-20.7484,63,38,0,-25
-41.9805,-20.7484,59,38,0,-21
-41.98028,-20.7484,58,38,0,-20
-41.98005,-20.7484,57,38,0,-19
-41.97983,-20.7484,57,38,0,-19
-41.97938,-20.7484,58,39,0,-19
-41.97916,-20.7484,66,40,0,-26
-41.97893,-20.7484,67,40,0,-27
-41.97871,-20.7484,70,40,0,-30
-41.97826,-20.7484,69,41,0,-28
-41.97803,-20.7484,65,41,0,-24
-41.97781,-20.7484,63,42,0,-21
-41.97758,-20.7484,60,42,0,-18
-41.97713,-20.7484,60,42,0,-18
-41.97691,-20.7484,59,42,0,-17
-41.97668,-20.7484,58,42,5,-16
-41.97646,-20.7484,58,42,5,-16
-41.97601,-20.7484,58,43,5,-15
-41.97578,-20.7484,57,44,5,-13
-41.97556,-20.7484,58,45,5,-13
-41.97534,-20.7484,57,45,5,-12
-41.97511,-20.7484,57,45,5,-12
-41.97466,-20.7484,57,46,0,-11
-41.97444,-20.7484,57,46,0,-11
-41.97421,-20.7484,57,46,0,-11
-41.97399,-20.7484,57,46,0,-11
-41.97354,-20.7484,57,47,0,-10
-41.97331,-20.7484,57,47,0,-10
-41.97309,-20.7484,56,47,0,-9
-41.97286,-20.7484,55,47,0,-8
-41.97241,-20.7484,54,47,0,-7
-41.97219,-20.7484,54,47,0,-7
-41.97196,-20.7484,53,48,11,-5
-41.97174,-20.7484,53,48,0,-5
-41.97129,-20.7484,53,48,0,-5
-41.97107,-20.7484,53,49,0,-4
-41.97084,-20.7484,53,49,0,-4
-41.97062,-20.7484,53,42,0,-11
-41.97017,-20.7484,53,41,0,-12
-41.96994,-20.7484,52,37,0,-15
-41.96972,-20.7484,52,37,5,-15
-41.96949,-20.7484,52,33,5,-19
-41.96927,-20.7484,52,34,5,-18
-42.1005,-20.74798,59,34,5,-25
-42.0978,-20.74798,67,26,5,-41
-42.09511,-20.74798,59,25,5,-34
-42.09219,-20.74798,59,26,5,-33
-42.08949,-20.74798,59,28,5,-31
-42.08657,-20.74798,62,30,5,-32
-42.08387,-20.74798,64,38,5,-26
-42.08118,-20.74798,55,34,5,-21
-42.07825,-20.74798,55,37,5,-18
-42.07556,-20.74798,64,38,5,-26
-42.07286,-20.74798,53,34,5,-19
-42.06994,-20.74798,53,37,5,-16
-42.06724,-20.74798,54,35,5,-19
-42.06455,-20.74798,54,36,5,-18
-42.06163,-20.74798,55,37,5,-18
-42.05893,-20.74798,57,35,5,-22
-42.05601,-20.74798,56,34,5,-22
-42.05331,-20.74798,53,38,5,-15
-42.05061,-20.74798,53,35,5,-18
-42.04769,-20.74798,52,38,5,-14
-42.045,-20.74798,51,30,5,-21
-42.0423,-20.74798,57,53,0,-4
-42.03938,-20.74798,48,44,0,-4
-42.03668,-20.74798,45,45,5,0
-42.03399,-20.74798,45,43,5,-2
-42.03106,-20.74798,52,45,0,-7
-42.02837,-20.74798,42,40,5,-2
-42.02545,-20.74798,54,45,0,-9
-42.02275,-20.74798,48,47,5,-1
-42.02005,-20.74798,62,46,11,-16
-42.01713,-20.74798,57,36,5,-21
-42.01444,-20.74798,55,49,5,-6
-42.01174,-20.74798,54,43,0,-11
-42.00882,-20.74798,55,45,0,-10
-42.00612,-20.74798,57,51,0,-6
-42.00342,-20.74798,64,52,0,-12
-42.0005,-20.74798,54,52,0,-2
-41.99781,-20.74798,66,51,0,-15
-41.99511,-20.74798,66,49,5,-17
-41.99219,-20.74798,67,43,0,-24
-41.98949,-20.74798,67,44,0,-23
-41.98657,-20.74798,74,47,0,-27
-41.98387,-20.74798,82,36,0,-46
-41.98118,-20.74798,67,38,0,-29
-41.97826,-20.74798,67,39,0,-28
-41.97556,-20.74798,58,45,5,-13
-41.97286,-20.74798,56,47,0,-9
-41.96994,-20.74798,52,37,0,-15
-42.1005,-20.74777,58,34,0,-24
-42.0978,-20.74777,66,26,5,-40
-42.09511,-20.74777,59,25,5,-34
-42.09219,-20.74777,59,26,5,-33
-42.08949,-20.74777,59,28,5,-31
-42.08657,-20.74777,61,30,5,-31
-42.08387,-20.74777,65,38,5,-27
-42.08118,-20.74777,55,34,5,-21
-42.07825,-20.74777,55,37,5,-18
-42.07556,-20.74777,64,38,5,-26
-42.07286,-20.74777,54,34,5,-20
-42.06994,-20.74777,54,37,5,-17
-42.06724,-20.74777,55,35,5,-20
-42.06455,-20.74777,54,36,5,-18
-42.06163,-20.74777,55,37,5,-18
-42.05893,-20.74777,57,33,5,-24
-42.05601,-20.74777,56,37,5,-19
-42.05331,-20.74777,54,38,5,-16
-42.05061,-20.74777,53,37,5,-16
-42.04769,-20.74777,53,39,5,-14
-42.045,-20.74777,51,31,5,-20
-42.0423,-20.74777,58,52,0,-6
-42.03938,-20.74777,48,53,11,5
-42.03668,-20.74777,48,46,5,-2
-42.03399,-20.74777,40,41,5,1
-42.03106,-20.74777,53,45,0,-8
-42.02837,-20.74777,42,40,5,-2
-42.02545,-20.74777,55,44,0,-11
-42.02275,-20.74777,48,46,5,-2
-42.02005,-20.74777,59,44,5,-15
-42.01713,-20.74777,57,35,5,-22
-42.01444,-20.74777,56,48,5,-8
-42.01174,-20.74777,55,41,0,-14
-42.00882,-20.74777,55,45,6,-10
-42.00612,-20.74777,54,50,0,-4
-42.00342,-20.74777,63,52,0,-11
-42.0005,-20.74777,54,52,0,-2
-41.99781,-20.74777,66,51,0,-15
-41.99511,-20.74777,66,47,5,-19
-41.99219,-20.74777,67,43,0,-24
-41.98949,-20.74777,66,43,0,-23
-41.98657,-20.74777,72,47,0,-25
-41.98387,-20.74777,78,35,0,-43
-41.98118,-20.74777,68,37,0,-31
-41.97826,-20.74777,68,39,5,-29
-41.97556,-20.74777,58,44,5,-14
-41.97286,-20.74777,55,47,0,-8
-41.96994,-20.74777,52,34,5,-18
-42.1005,-20.74756,58,34,0,-24
-42.0978,-20.74756,66,26,5,-40
-42.09511,-20.74756,59,25,5,-34
-42.09219,-20.74756,61,27,5,-34
-42.08949,-20.74756,59,28,5,-31
-42.08657,-20.74756,61,30,5,-31
-42.08387,-20.74756,66,38,5,-28
-42.08118,-20.74756,55,34,5,-21
-42.07825,-20.74756,58,36,5,-22
-42.07556,-20.74756,62,38,5,-24
-42.07286,-20.74756,54,34,5,-20
-42.06994,-20.74756,54,38,5,-16
-42.06724,-20.74756,56,35,5,-21
-42.06455,-20.74756,57,36,5,-21
-42.06163,-20.74756,55,37,5,-18
-42.05893,-20.74756,57,34,5,-23
-42.05601,-20.74756,57,39,5,-18
-42.05331,-20.74756,54,38,5,-16
-42.05061,-20.74756,54,36,5,-18
-42.04769,-20.74756,59,40,5,-19
-42.045,-20.74756,52,30,5,-22
-42.0423,-20.74756,60,52,0,-8
-42.03938,-20.74756,45,53,0,8
-42.03668,-20.74756,44,44,11,0
-42.03399,-20.74756,24,41,5,17
-42.03106,-20.74756,49,44,0,-5
-42.02837,-20.74756,42,40,5,-2
-42.02545,-20.74756,57,44,0,-13
-42.02275,-20.74756,49,48,5,-1
-42.02005,-20.74756,55,46,5,-9
-42.01713,-20.74756,58,38,5,-20
-42.01444,-20.74756,57,47,5,-10
-42.01174,-20.74756,55,41,0,-14
-42.00882,-20.74756,56,45,6,-11
-42.00612,-20.74756,54,50,11,-4
-42.00342,-20.74756,62,52,0,-10
-42.0005,-20.74756,54,51,0,-3
-41.99781,-20.74756,64,50,0,-14
-41.99511,-20.74756,65,40,5,-25
-41.99219,-20.74756,65,43,0,-22
-41.98949,-20.74756,66,43,0,-23
-41.98657,-20.74756,71,47,0,-24
-41.98387,-20.74756,76,34,5,-42
-41.98118,-20.74756,69,37,0,-32
-41.97826,-20.74756,67,36,5,-31
-41.97556,-20.74756,58,46,5,-12
-41.97286,-20.74756,55,47,0,-8
-41.96994,-20.74756,52,40,5,-12
-42.1005,-20.74714,61,34,0,-27
-42.0978,-20.74714,61,26,5,-35
-42.09511,-20.74714,59,25,5,-34
-42.09219,-20.74714,62,26,5,-36
-42.08949,-20.74714,59,28,5,-31
-42.08657,-20.74714,60,29,5,-31
-42.08387,-20.74714,66,38,5,-28
-42.08118,-20.74714,56,38,5,-18
-42.07825,-20.74714,58,36,5,-22
-42.07556,-20.74714,60,38,5,-22
-42.07286,-20.74714,55,34,5,-21
-42.06994,-20.74714,55,37,5,-18
-42.06724,-20.74714,57,35,5,-22
-42.06455,-20.74714,59,35,5,-24
-42.06163,-20.74714,55,36,5,-19
-42.05893,-20.74714,57,31,5,-26
-42.05601,-20.74714,57,50,5,-7
-42.05331,-20.74714,54,38,5,-16
-42.05061,-20.74714,54,37,5,-17
-42.04769,-20.74714,59,41,5,-18
-42.045,-20.74714,60,35,5,-25
-42.0423,-20.74714,63,49,0,-14
-42.03938,-20.74714,45,52,0,7
-42.03668,-20.74714,45,42,5,-3
-42.03399,-20.74714,24,40,5,16
-42.03106,-20.74714,42,43,0,1
-42.02837,-20.74714,42,39,5,-3
-42.02545,-20.74714,57,44,0,-13
-42.02275,-20.74714,49,50,5,1
-42.02005,-20.74714,50,52,0,2
-42.01713,-20.74714,59,46,0,-13
-42.01444,-20.74714,58,54,5,-4
-42.01174,-20.74714,55,41,0,-14
-42.00882,-20.74714,56,45,0,-11
-42.00612,-20.74714,56,51,0,-5
-42.00342,-20.74714,63,52,0,-11
-42.0005,-20.74714,54,51,0,-3
-41.99781,-20.74714,64,42,5,-22
-41.99511,-20.74714,64,41,5,-23
-41.99219,-20.74714,65,43,0,-22
-41.98949,-20.74714,66,42,0,-24
-41.98657,-20.74714,70,47,0,-23
-41.98387,-20.74714,74,34,5,-40
-41.98118,-20.74714,69,37,0,-32
-41.97826,-20.74714,64,35,5,-29
-41.97556,-20.74714,58,42,5,-16
-41.97286,-20.74714,55,46,0,-9
-41.96994,-20.74714,52,48,5,-4
-42.1005,-20.74692,58,34,5,-24
-42.0978,-20.74692,61,26,5,-35
-42.09511,-20.74692,59,25,5,-34
-42.09219,-20.74692,63,26,5,-37
-42.08949,-20.74692,59,28,5,-31
-42.08657,-20.74692,59,30,5,-29
-42.08387,-20.74692,65,38,5,-27
-42.08118,-20.74692,56,38,5,-18
-42.07825,-20.74692,56,35,5,-21
-42.07556,-20.74692,58,38,5,-20
-42.07286,-20.74692,56,34,5,-22
-42.06994,-20.74692,56,37,5,-19
-42.06724,-20.74692,58,36,5,-22
-42.06455,-20.74692,58,36,5,-22
-42.06163,-20.74692,54,36,5,-18
-42.05893,-20.74692,59,33,5,-26
-42.05601,-20.74692,57,43,5,-14
-42.05331,-20.74692,54,38,5,-16
-42.05061,-20.74692,54,38,5,-16
-42.04769,-20.74692,59,41,5,-18
-42.045,-20.74692,61,31,5,-30
-42.0423,-20.74692,59,49,0,-10
-42.03938,-20.74692,45,52,0,7
-42.03668,-20.74692,45,45,5,0
-42.03399,-20.74692,25,40,5,15
-42.03106,-20.74692,38,42,0,4
-42.02837,-20.74692,42,40,5,-2
-42.02545,-20.74692,58,43,0,-15
-42.02275,-20.74692,49,50,0,1
-42.02005,-20.74692,47,53,0,6
-42.01713,-20.74692,59,47,0,-12
-42.01444,-20.74692,59,54,6,-5
-42.01174,-20.74692,56,44,0,-12
-42.00882,-20.74692,56,46,0,-10
-42.00612,-20.74692,54,51,0,-3
-42.00342,-20.74692,63,52,0,-11
-42.0005,-20.74692,54,51,0,-3
-41.99781,-20.74692,63,43,5,-20
-41.99511,-20.74692,64,39,5,-25
-41.99219,-20.74692,65,43,0,-22
-41.98949,-20.74692,65,41,0,-24
-41.98657,-20.74692,71,47,0,-24
-41.98387,-20.74692,72,34,5,-38
-41.98118,-20.74692,70,36,0,-34
-41.97826,-20.74692,64,35,5,-29
-41.97556,-20.74692,58,39,5,-19
-41.97286,-20.74692,54,46,5,-8
-41.96994,-20.74692,52,48,5,-4
-42.1005,-20.74671,58,31,5,-27
-42.0978,-20.74671,58,30,5,-28
-42.09511,-20.74671,59,25,5,-34
-42.09219,-20.74671,63,26,5,-37
-42.08949,-20.74671,59,28,5,-31
-42.08657,-20.74671,59,31,5,-28
-42.08387,-20.74671,57,38,5,-19
-42.08118,-20.74671,56,38,5,-18
-42.07825,-20.74671,56,35,5,-21
-42.07556,-20.74671,56,38,5,-18
-42.07286,-20.74671,56,34,5,-22
-42.06994,-20.74671,57,36,5,-21
-42.06724,-20.74671,62,36,5,-26
-42.06455,-20.74671,56,36,5,-20
-42.06163,-20.74671,54,35,5,-19
-42.05893,-20.74671,58,37,5,-21
-42.05601,-20.74671,57,44,5,-13
-42.05331,-20.74671,55,38,5,-17
-42.05061,-20.74671,54,38,5,-16
-42.04769,-20.74671,59,41,5,-18
-42.045,-20.74671,58,38,5,-20
-42.0423,-20.74671,59,48,0,-11
-42.03938,-20.74671,45,51,0,6
-42.03668,-20.74671,46,47,5,1
-42.03399,-20.74671,26,41,5,15
-42.03106,-20.74671,38,42,0,4
-42.02837,-20.74671,42,42,5,0
-42.02545,-20.74671,58,43,0,-15
-42.02275,-20.74671,50,50,0,0
-42.02005,-20.74671,48,52,0,4
-42.01713,-20.74671,59,48,0,-11
-42.01444,-20.74671,59,54,0,-5
-42.01174,-20.74671,57,45,0,-12
-42.00882,-20.74671,56,46,0,-10
-42.00612,-20.74671,54,51,0,-3
-42.00342,-20.74671,64,52,11,-12
-42.0005,-20.74671,54,51,11,-3
-41.99781,-20.74671,61,46,5,-15
-41.99511,-20.74671,65,38,5,-27
-41.99219,-20.74671,66,43,0,-23
-41.98949,-20.74671,65,40,0,-25
-41.98657,-20.74671,68,46,0,-22
-41.98387,-20.74671,71,34,5,-37
-41.98118,-20.74671,70,36,0,-34
-41.97826,-20.74671,64,35,5,-29
-41.97556,-20.74671,58,44,5,-14
-41.97286,-20.74671,64,46,5,-18
-41.96994,-20.74671,53,48,0,-5
-42.1005,-20.74629,58,29,5,-29
-42.0978,-20.74629,58,30,5,-28
-42.09511,-20.74629,59,25,5,-34
-42.09219,-20.74629,62,26,5,-36
-42.08949,-20.74629,59,28,5,-31
-42.08657,-20.74629,59,31,5,-28
-42.08387,-20.74629,61,38,5,-23
-42.08118,-20.74629,57,36,5,-21
-42.07825,-20.74629,57,36,5,-21
-42.07556,-20.74629,57,34,5,-23
-42.07286,-20.74629,56,34,5,-22
-42.06994,-20.74629,59,37,5,-22
-42.06724,-20.74629,67,36,5,-31
-42.06455,-20.74629,56,36,5,-20
-42.06163,-20.74629,54,34,5,-20
-42.05893,-20.74629,56,38,5,-18
-42.05601,-20.74629,57,47,5,-10
-42.05331,-20.74629,56,40,5,-16
-42.05061,-20.74629,55,38,5,-17
-42.04769,-20.74629,61,42,5,-19
-42.045,-20.74629,61,40,5,-21
-42.0423,-20.74629,58,52,11,-6
-42.03938,-20.74629,45,49,0,4
-42.03668,-20.74629,46,46,5,0
-42.03399,-20.74629,28,41,5,13
-42.03106,-20.74629,39,39,5,0
-42.02837,-20.74629,42,45,0,3
-42.02545,-20.74629,56,49,0,-7
-42.02275,-20.74629,50,49,0,-1
-42.02005,-20.74629,48,51,0,3
-42.01713,-20.74629,59,50,0,-9
-42.01444,-20.74629,62,53,0,-9
-42.01174,-20.74629,57,46,0,-11
-42.00882,-20.74629,56,46,0,-10
-42.00612,-20.74629,54,48,6,-6
-42.00342,-20.74629,64,50,0,-14
-42.0005,-20.74629,54,49,0,-5
-41.99781,-20.74629,59,46,5,-13
-41.99511,-20.74629,63,39,5,-24
-41.99219,-20.74629,67,44,0,-23
-41.98949,-20.74629,66,39,0,-27
-41.98657,-20.74629,67,48,0,-19
-41.98387,-20.74629,70,38,0,-32
-41.98118,-20.74629,70,35,0,-35
-41.97826,-20.74629,63,38,5,-25
-41.97556,-20.74629,58,37,5,-21
-41.97286,-20.74629,53,46,5,-7
-41.96994,-20.74629,52,48,0,-4
-42.1005,-20.74608,58,28,5,-30
-42.0978,-20.74608,58,30,5,-28
-42.09511,-20.74608,59,27,5,-32
-42.09219,-20.74608,63,26,5,-37
-42.08949,-20.74608,59,28,5,-31
-42.08657,-20.74608,59,31,5,-28
-42.08387,-20.74608,64,38,5,-26
-42.08118,-20.74608,57,36,5,-21
-42.07825,-20.74608,57,36,5,-21
-42.07556,-20.74608,57,35,5,-22
-42.07286,-20.74608,57,34,5,-23
-42.06994,-20.74608,60,38,5,-22
-42.06724,-20.74608,58,36,5,-22
-42.06455,-20.74608,55,36,5,-19
-42.06163,-20.74608,54,34,5,-20
-42.05893,-20.74608,56,42,5,-14
-42.05601,-20.74608,57,53,5,-4
-42.05331,-20.74608,62,41,5,-21
-42.05061,-20.74608,56,39,5,-17
-42.04769,-20.74608,56,42,5,-14
-42.045,-20.74608,55,39,5,-16
-42.0423,-20.74608,60,52,0,-8
-42.03938,-20.74608,45,48,0,3
-42.03668,-20.74608,47,46,11,-1
-42.03399,-20.74608,33,41,5,8
-42.03106,-20.74608,42,40,5,-2
-42.02837,-20.74608,42,45,0,3
-42.02545,-20.74608,55,48,0,-7
-42.02275,-20.74608,50,48,0,-2
-42.02005,-20.74608,48,48,0,0
-42.01713,-20.74608,58,50,0,-8
-42.01444,-20.74608,65,53,0,-12
-42.01174,-20.74608,58,45,0,-13
-42.00882,-20.74608,56,46,0,-10
-42.00612,-20.74608,54,44,0,-10
-42.00342,-20.74608,60,50,0,-10
-42.0005,-20.74608,54,49,0,-5
-41.99781,-20.74608,54,39,5,-15
-41.99511,-20.74608,63,38,5,-25
-41.99219,-20.74608,67,44,0,-23
-41.98949,-20.74608,66,39,0,-27
-41.98657,-20.74608,68,47,0,-21
-41.98387,-20.74608,70,36,0,-34
-41.98118,-20.74608,71,34,0,-37
-41.97826,-20.74608,62,38,0,-24
-41.97556,-20.74608,58,36,5,-22
-41.97286,-20.74608,53,46,5,-7
-41.96994,-20.74608,52,48,0,-4
-42.1005,-20.74587,58,29,5,-29
-42.0978,-20.74587,58,29,5,-29
-42.09511,-20.74587,59,27,5,-32
-42.09219,-20.74587,63,26,5,-37
-42.08949,-20.74587,59,29,5,-30
-42.08657,-20.74587,59,31,5,-28
-42.08387,-20.74587,64,38,5,-26
-42.08118,-20.74587,57,37,5,-20
-42.07825,-20.74587,57,36,5,-21
-42.07556,-20.74587,57,34,5,-23
-42.07286,-20.74587,58,34,5,-24
-42.06994,-20.74587,61,38,5,-23
-42.06724,-20.74587,59,36,5,-23
-42.06455,-20.74587,55,36,5,-19
-42.06163,-20.74587,55,34,5,-21
-42.05893,-20.74587,57,42,5,-15
-42.05601,-20.74587,57,51,5,-6
-42.05331,-20.74587,62,42,5,-20
-42.05061,-20.74587,57,41,5,-16
-42.04769,-20.74587,59,42,5,-17
-42.045,-20.74587,56,40,5,-16
-42.0423,-20.74587,53,53,0,0
-42.03938,-20.74587,46,48,0,2
-42.03668,-20.74587,48,47,5,-1
-42.03399,-20.74587,36,43,5,7
-42.03106,-20.74587,44,40,5,-4
-42.02837,-20.74587,42,45,0,3
-42.02545,-20.74587,53,48,0,-5
-42.02275,-20.74587,50,48,0,-2
-42.02005,-20.74587,48,48,0,0
-42.01713,-20.74587,60,57,5,-3
-42.01444,-20.74587,66,51,11,-15
-42.01174,-20.74587,59,44,0,-15
-42.00882,-20.74587,57,46,0,-11
-42.00612,-20.74587,55,44,0,-11
-42.00342,-20.74587,60,47,0,-13
-42.0005,-20.74587,54,48,0,-6
-41.99781,-20.74587,55,40,5,-15
-41.99511,-20.74587,63,38,5,-25
-41.99219,-20.74587,66,44,0,-22
-41.98949,-20.74587,65,39,0,-26
-41.98657,-20.74587,67,47,0,-20
-41.98387,-20.74587,70,36,0,-34
-41.98118,-20.74587,71,34,0,-37
-41.97826,-20.74587,62,38,0,-24
-41.97556,-20.74587,60,41,5,-19
-41.97286,-20.74587,53,46,0,-7
-41.96994,-20.74587,52,48,0,-4
-42.10297,-20.74566,63,35,0,-28
-42.10275,-20.74566,64,35,5,-29
-42.10252,-20.74566,65,28,5,-37
-42.1023,-20.74566,66,25,5,-41
-42.10185,-20.74566,67,25,5,-42
-42.10163,-20.74566,66,25,5,-41
-42.1014,-20.74566,67,26,5,-41
-42.10118,-20.74566,67,26,5,-41
-42.10073,-20.74566,61,29,5,-32
-42.1005,-20.74566,58,28,5,-30
-42.10028,-20.74566,58,29,5,-29
-42.10005,-20.74566,58,28,5,-30
-42.09983,-20.74566,58,29,5,-29
-42.09938,-20.74566,58,28,5,-30
-42.09915,-20.74566,58,28,5,-30
-42.09893,-20.74566,58,28,5,-30
-42.0987,-20.74566,58,29,5,-29
-42.09825,-20.74566,58,30,0,-28
-42.09803,-20.74566,57,30,0,-27
-42.0978,-20.74566,58,30,5,-28
-42.09758,-20.74566,58,27,5,-31
-42.09713,-20.74566,58,29,5,-29
-42.09691,-20.74566,58,29,5,-29
-42.09668,-20.74566,58,26,5,-32
-42.09646,-20.74566,58,25,5,-33
-42.09601,-20.74566,58,26,5,-32
-42.09578,-20.74566,58,26,5,-32
-42.09556,-20.74566,59,26,5,-33
-42.09533,-20.74566,59,26,5,-33
-42.09511,-20.74566,59,27,5,-32
-42.09466,-20.74566,59,26,5,-33
-42.09443,-20.74566,59,26,5,-33
-42.09421,-20.74566,59,26,5,-33
-42.09398,-20.74566,59,25,5,-34
-42.09354,-20.74566,59,25,5,-34
-42.09331,-20.74566,59,25,5,-34
-42.09309,-20.74566,59,26,5,-33
-42.09286,-20.74566,61,26,5,-35
-42.09241,-20.74566,61,26,5,-35
-42.09219,-20.74566,62,26,5,-36
-42.09196,-20.74566,64,26,5,-38
-42.09174,-20.74566,65,27,5,-38
-42.09129,-20.74566,66,27,5,-39
-42.09106,-20.74566,67,26,5,-41
-42.09084,-20.74566,69,27,5,-42
-42.09061,-20.74566,68,28,5,-40
-42.09039,-20.74566,62,28,5,-34
-42.08994,-20.74566,61,28,5,-33
-42.08972,-20.74566,59,28,5,-31
-42.08949,-20.74566,59,28,5,-31
-42.08927,-20.74566,59,29,5,-30
-42.08882,-20.74566,59,27,5,-32
-42.08859,-20.74566,59,29,5,-30
-42.08837,-20.74566,59,30,5,-29
-42.08814,-20.74566,59,30,5,-29
-42.08769,-20.74566,59,30,5,-29
-42.08747,-20.74566,59,30,5,-29
-42.08724,-20.74566,59,31,5,-28
-42.08702,-20.74566,59,31,5,-28
-42.08657,-20.74566,59,31,5,-28
-42.08634,-20.74566,59,31,5,-28
-42.08612,-20.74566,59,31,5,-28
-42.08589,-20.74566,59,31,5,-28
-42.08545,-20.74566,59,36,5,-23
-42.08522,-20.74566,59,36,5,-23
-42.085,-20.74566,59,36,5,-23
-42.08477,-20.74566,59,34,5,-25
-42.08455,-20.74566,60,32,5,-28
-42.0841,-20.74566,61,39,5,-22
-42.08387,-20.74566,65,39,5,-26
-42.08365,-20.74566,62,38,5,-24
-42.08342,-20.74566,65,34,5,-31
-42.08297,-20.74566,66,33,5,-33
-42.08275,-20.74566,62,32,5,-30
-42.08252,-20.74566,62,32,5,-30
-42.0823,-20.74566,57,33,5,-24
-42.08185,-20.74566,57,37,5,-20
-42.08163,-20.74566,57,37,5,-20
-42.0814,-20.74566,57,37,5,-20
-42.08118,-20.74566,57,36,5,-21
-42.08073,-20.74566,57,35,5,-22
-42.0805,-20.74566,57,35,5,-22
-42.08028,-20.74566,57,35,5,-22
-42.08005,-20.74566,57,32,5,-25
-42.07983,-20.74566,57,32,5,-25
-42.07938,-20.74566,57,32,5,-25
-42.07915,-20.74566,57,32,5,-25
-42.07893,-20.74566,57,33,5,-24
-42.0787,-20.74566,57,36,5,-21
-42.07825,-20.74566,57,36,5,-21
-42.07803,-20.74566,57,34,5,-23
-42.07781,-20.74566,57,34,5,-23
-42.07758,-20.74566,57,34,5,-23
-42.07713,-20.74566,57,35,5,-22
-42.07691,-20.74566,57,35,5,-22
-42.07668,-20.74566,57,35,5,-22
-42.07646,-20.74566,57,35,5,-22
-42.07601,-20.74566,57,35,5,-22
-42.07578,-20.74566,57,35,5,-22
-42.07556,-20.74566,57,34,5,-23
-42.07533,-20.74566,58,34,5,-24
-42.07511,-20.74566,58,35,5,-23
-42.07466,-20.74566,58,34,5,-24
-42.07443,-20.74566,58,37,5,-21
-42.07421,-20.74566,59,36,5,-23
-42.07399,-20.74566,58,34,5,-24
-42.07354,-20.74566,58,33,5,-25
-42.07331,-20.74566,59,33,5,-26
-42.07309,-20.74566,59,34,5,-25
-42.07286,-20.74566,58,34,5,-24
-42.07241,-20.74566,59,35,5,-24
-42.07219,-20.74566,58,35,5,-23
-42.07196,-20.74566,59,35,5,-24
-42.07174,-20.74566,58,37,5,-21
-42.07129,-20.74566,59,38,0,-21
-42.07106,-20.74566,59,38,0,-21
-42.07084,-20.74566,59,38,0,-21
-42.07061,-20.74566,59,38,0,-21
-42.07039,-20.74566,59,38,0,-21
-42.06994,-20.74566,62,38,5,-24
-42.06972,-20.74566,60,36,5,-24
-42.06949,-20.74566,61,36,5,-25
-42.06927,-20.74566,60,36,5,-24
-42.06882,-20.74566,60,36,5,-24
-42.06859,-20.74566,62,35,5,-27
-42.06837,-20.74566,60,35,5,-25
-42.06814,-20.74566,63,36,5,-27
-42.06769,-20.74566,60,35,5,-25
-42.06747,-20.74566,66,36,5,-30
-42.06724,-20.74566,67,36,5,-31
-42.06702,-20.74566,66,36,5,-30
-42.06657,-20.74566,63,36,5,-27
-42.06634,-20.74566,63,35,5,-28
-42.06612,-20.74566,60,36,5,-24
-42.0659,-20.74566,59,36,5,-23
-42.06545,-20.74566,58,36,5,-22
-42.06522,-20.74566,57,36,5,-21
-42.065,-20.74566,56,36,5,-20
-42.06477,-20.74566,56,35,5,-21
-42.06455,-20.74566,56,36,5,-20
-42.0641,-20.74566,56,37,5,-19
-42.06387,-20.74566,56,37,5,-19
-42.06365,-20.74566,55,37,5,-18
-42.06342,-20.74566,55,37,5,-18
-42.06297,-20.74566,55,36,5,-19
-42.06275,-20.74566,55,35,5,-20
-42.06252,-20.74566,55,36,5,-19
-42.0623,-20.74566,55,35,5,-20
-42.06185,-20.74566,55,33,5,-22
-42.06163,-20.74566,55,39,5,-16
-42.0614,-20.74566,55,39,5,-16
-42.06118,-20.74566,55,39,5,-16
-42.06073,-20.74566,54,38,5,-16
-42.0605,-20.74566,54,38,5,-16
-42.06028,-20.74566,55,41,5,-14
-42.06005,-20.74566,55,41,5,-14
-42.05983,-20.74566,55,41,5,-14
-42.05938,-20.74566,55,40,5,-15
-42.05915,-20.74566,55,39,5,-16
-42.05893,-20.74566,55,41,5,-14
-42.0587,-20.74566,55,42,5,-13
-42.05826,-20.74566,55,44,5,-11
-42.05803,-20.74566,56,46,5,-10
-42.05781,-20.74566,56,49,5,-7
-42.05758,-20.74566,56,47,5,-9
-42.05713,-20.74566,57,49,5,-8
-42.05691,-20.74566,57,58,5,1
-42.05668,-20.74566,57,58,5,1
-42.05646,-20.74566,57,58,5,1
-42.05601,-20.74566,57,43,5,-14
-42.05578,-20.74566,57,51,5,-6
-42.05556,-20.74566,57,52,5,-5
-42.05533,-20.74566,57,51,5,-6
-42.05511,-20.74566,57,48,5,-9
-42.05466,-20.74566,59,44,5,-15
-42.05443,-20.74566,63,44,5,-19
-42.05421,-20.74566,64,43,5,-21
-42.05399,-20.74566,64,43,5,-21
-42.05354,-20.74566,64,42,5,-22
-42.05331,-20.74566,64,43,5,-21
-42.05309,-20.74566,58,44,5,-14
-42.05286,-20.74566,57,43,5,-14
-42.05241,-20.74566,57,43,5,-14
-42.05219,-20.74566,57,43,5,-14
-42.05196,-20.74566,58,43,5,-15
-42.05174,-20.74566,54,43,5,-11
-42.05129,-20.74566,54,44,5,-10
-42.05106,-20.74566,56,43,5,-13
-42.05084,-20.74566,55,42,5,-13
-42.05061,-20.74566,55,42,5,-13
-42.05039,-20.74566,56,41,5,-15
-42.04994,-20.74566,56,42,5,-14
-42.04972,-20.74566,55,38,5,-17
-42.04949,-20.74566,56,38,5,-18
-42.04927,-20.74566,56,38,5,-18
-42.04882,-20.74566,56,38,5,-18
-42.04859,-20.74566,56,37,5,-19
-42.04837,-20.74566,55,38,5,-17
-42.04814,-20.74566,60,41,5,-19
-42.04769,-20.74566,60,43,5,-17
-42.04747,-20.74566,55,43,5,-12
-42.04724,-20.74566,59,43,5,-16
-42.04702,-20.74566,58,43,5,-15
-42.04657,-20.74566,58,40,5,-18
-42.04635,-20.74566,56,40,5,-16
-42.04612,-20.74566,55,39,5,-16
-42.0459,-20.74566,57,40,5,-17
-42.04545,-20.74566,60,39,5,-21
-42.04522,-20.74566,60,41,5,-19
-42.045,-20.74566,60,43,5,-17
-42.04477,-20.74566,53,46,5,-7
-42.04455,-20.74566,53,53,5,0
-42.0441,-20.74566,53,53,0,0
-42.04387,-20.74566,52,53,0,1
-42.04365,-20.74566,51,53,0,2
-42.04342,-20.74566,51,53,0,2
-42.04297,-20.74566,50,52,0,2
-42.04275,-20.74566,48,52,0,4
-42.04253,-20.74566,48,52,0,4
-42.0423,-20.74566,54,53,0,-1
-42.04185,-20.74566,53,53,0,0
-42.04163,-20.74566,53,53,11,0
-42.0414,-20.74566,47,48,0,1
-42.04118,-20.74566,46,47,0,1
-42.04073,-20.74566,45,46,0,1
-42.0405,-20.74566,46,46,0,0
-42.04028,-20.74566,46,46,0,0
-42.04005,-20.74566,46,44,0,-2
-42.03983,-20.74566,46,45,0,-1
-42.03938,-20.74566,46,48,0,2
-42.03915,-20.74566,46,50,0,4
-42.03893,-20.74566,47,52,0,5
-42.0387,-20.74566,47,52,0,5
-42.03826,-20.74566,47,54,0,7
-42.03803,-20.74566,48,54,0,6
-42.03781,-20.74566,48,54,0,6
-42.03758,-20.74566,48,54,0,6
-42.03713,-20.74566,48,48,5,0
-42.03691,-20.74566,48,47,11,-1
-42.03668,-20.74566,48,46,5,-2
-42.03646,-20.74566,47,47,11,0
-42.03601,-20.74566,47,47,11,0
-42.03578,-20.74566,46,47,5,1
-42.03556,-20.74566,45,44,5,-1
-42.03533,-20.74566,44,43,5,-1
-42.03511,-20.74566,43,43,5,0
-42.03466,-20.74566,41,43,5,2
-42.03444,-20.74566,40,43,5,3
-42.03421,-20.74566,39,43,5,4
-42.03399,-20.74566,40,43,5,3
-42.03354,-20.74566,37,43,5,6
-42.03331,-20.74566,31,43,5,12
-42.03309,-20.74566,32,43,5,11
-42.03286,-20.74566,32,42,5,10
-42.03241,-20.74566,33,40,5,7
-42.03219,-20.74566,34,39,5,5
-42.03196,-20.74566,41,40,5,-1
-42.03174,-20.74566,45,39,5,-6
-42.03129,-20.74566,45,40,5,-5
-42.03106,-20.74566,47,39,5,-8
-42.03084,-20.74566,48,40,5,-8
-42.03062,-20.74566,46,40,5,-6
-42.03017,-20.74566,44,40,5,-4
-42.02994,-20.74566,43,39,5,-4
-42.02972,-20.74566,43,40,5,-3
-42.02949,-20.74566,42,43,5,1
-42.02927,-20.74566,42,43,0,1
-42.02882,-20.74566,42,44,0,2
-42.02859,-20.74566,42,45,0,3
-42.02837,-20.74566,44,46,0,2
-42.02814,-20.74566,44,45,0,1
-42.02769,-20.74566,44,44,0,0
-42.02747,-20.74566,45,44,0,-1
-42.02724,-20.74566,45,43,0,-2
-42.02702,-20.74566,46,43,0,-3
-42.02657,-20.74566,45,42,0,-3
-42.02635,-20.74566,45,41,0,-4
-42.02612,-20.74566,45,41,5,-4
-42.0259,-20.74566,47,44,5,-3
-42.02545,-20.74566,48,46,5,-2
-42.02522,-20.74566,48,47,5,-1
-42.025,-20.74566,49,48,0,-1
-42.02477,-20.74566,51,48,0,-3
-42.02455,-20.74566,57,48,0,-9
-42.0241,-20.74566,54,48,0,-6
-42.02387,-20.74566,57,48,0,-9
-42.02365,-20.74566,56,48,0,-8
-42.02342,-20.74566,54,48,0,-6
-42.02297,-20.74566,53,48,0,-5
-42.02275,-20.74566,51,48,0,-3
-42.02253,-20.74566,51,48,0,-3
-42.0223,-20.74566,50,49,0,-1
-42.02185,-20.74566,50,49,0,-1
-42.02163,-20.74566,50,50,0,0
-42.0214,-20.74566,49,49,0,0
-42.02118,-20.74566,48,50,0,2
-42.02073,-20.74566,48,51,0,3
-42.0205,-20.74566,48,52,0,4
-42.02028,-20.74566,48,45,0,-3
-42.02005,-20.74566,49,50,5,1
-42.01983,-20.74566,48,45,5,-3
-42.01938,-20.74566,49,44,5,-5
-42.01915,-20.74566,49,44,5,-5
-42.01893,-20.74566,51,49,5,-2
-42.01871,-20.74566,52,43,5,-9
-42.01826,-20.74566,59,44,5,-15
-42.01803,-20.74566,56,44,5,-12
-42.01781,-20.74566,58,45,5,-13
-42.01758,-20.74566,59,45,5,-14
-42.01713,-20.74566,60,57,5,-3
-42.01691,-20.74566,60,57,11,-3
-42.01668,-20.74566,61,57,0,-4
-42.01646,-20.74566,61,57,0,-4
-42.01601,-20.74566,61,55,0,-6
-42.01578,-20.74566,60,52,0,-8
-42.01556,-20.74566,61,52,6,-9
-42.01533,-20.74566,63,54,0,-9
-42.01511,-20.74566,63,53,0,-10
-42.01466,-20.74566,64,52,11,-12
-42.01444,-20.74566,62,50,0,-12
-42.01421,-20.74566,63,44,0,-19
-42.01399,-20.74566,61,44,11,-17
-42.01354,-20.74566,61,43,0,-18
-42.01331,-20.74566,60,42,0,-18
-42.01309,-20.74566,60,42,6,-18
-42.01286,-20.74566,59,42,0,-17
-42.01241,-20.74566,59,43,0,-16
-42.01219,-20.74566,59,43,0,-16
-42.01196,-20.74566,59,44,11,-15
-42.01174,-20.74566,60,44,11,-16
-42.01129,-20.74566,59,45,11,-14
-42.01106,-20.74566,59,44,0,-15
-42.01084,-20.74566,58,45,0,-13
-42.01062,-20.74566,59,45,0,-14
-42.01017,-20.74566,59,45,0,-14
-42.00994,-20.74566,59,46,0,-13
-42.00972,-20.74566,60,46,0,-14
-42.00949,-20.74566,60,46,0,-14
-42.00927,-20.74566,59,46,6,-13
-42.00882,-20.74566,59,47,0,-12
-42.00859,-20.74566,58,48,0,-10
-42.00837,-20.74566,58,50,0,-8
-42.00814,-20.74566,58,51,0,-7
-42.00769,-20.74566,57,51,0,-6
-42.00747,-20.74566,56,52,0,-4
-42.00724,-20.74566,56,52,0,-4
-42.00702,-20.74566,55,52,0,-3
-42.00657,-20.74566,55,52,0,-3
-42.00635,-20.74566,55,46,0,-9
-42.00612,-20.74566,55,45,0,-10
-42.0059,-20.74566,55,44,0,-11
-42.00545,-20.74566,55,45,6,-10
-42.00522,-20.74566,55,45,6,-10
-42.005,-20.74566,57,45,6,-12
-42.00477,-20.74566,57,45,0,-12
-42.00455,-20.74566,61,45,0,-16
-42.0041,-20.74566,61,47,0,-14
-42.00387,-20.74566,61,46,0,-15
-42.00365,-20.74566,61,46,0,-15
-42.00342,-20.74566,62,47,0,-15
-42.00298,-20.74566,61,49,0,-12
-42.00275,-20.74566,61,49,0,-12
-42.00253,-20.74566,61,49,0,-12
-42.0023,-20.74566,60,49,0,-11
-42.00185,-20.74566,57,49,0,-8
-42.00163,-20.74566,56,49,0,-7
-42.0014,-20.74566,55,47,0,-8
-42.00118,-20.74566,63,46,0,-17
-42.00073,-20.74566,58,47,0,-11
-42.0005,-20.74566,58,47,5,-11
-42.00028,-20.74566,57,45,5,-12
-42.00005,-20.74566,57,46,6,-11
-41.99983,-20.74566,57,45,6,-12
-41.99938,-20.74566,56,41,5,-15
-41.99916,-20.74566,56,38,5,-18
-41.99893,-20.74566,55,39,5,-16
-41.99871,-20.74566,55,40,5,-15
-41.99826,-20.74566,55,40,6,-15
-41.99803,-20.74566,55,40,6,-15
-41.99781,-20.74566,55,40,6,-15
-41.99758,-20.74566,55,40,5,-15
-41.99713,-20.74566,60,44,6,-16
-41.99691,-20.74566,61,46,5,-15
-41.99668,-20.74566,65,46,11,-19
-41.99646,-20.74566,64,47,5,-17
-41.99601,-20.74566,63,41,5,-22
-41.99578,-20.74566,62,43,5,-19
-41.99556,-20.74566,62,41,5,-21
-41.99533,-20.74566,63,40,5,-23
-41.99511,-20.74566,63,38,5,-25
-41.99466,-20.74566,62,38,5,-24
-41.99444,-20.74566,62,40,0,-22
-41.99421,-20.74566,62,41,0,-21
-41.99399,-20.74566,63,41,0,-22
-41.99354,-20.74566,66,42,0,-24
-41.99331,-20.74566,66,42,0,-24
-41.99309,-20.74566,66,42,0,-24
-41.99286,-20.74566,67,44,0,-23
-41.99241,-20.74566,66,44,0,-22
-41.99219,-20.74566,66,45,0,-21
-41.99196,-20.74566,67,45,0,-22
-41.99174,-20.74566,67,44,0,-23
-41.99129,-20.74566,67,41,0,-26
-41.99107,-20.74566,67,39,0,-28
-41.99084,-20.74566,67,37,0,-30
-41.99062,-20.74566,66,36,0,-30
-41.99017,-20.74566,65,36,0,-29
-41.98994,-20.74566,65,37,0,-28
-41.98972,-20.74566,64,38,0,-26
-41.98949,-20.74566,62,39,0,-23
-41.98927,-20.74566,60,39,0,-21
-41.98882,-20.74566,58,41,0,-17
-41.98859,-20.74566,57,42,0,-15
-41.98837,-20.74566,57,42,0,-15
-41.98814,-20.74566,57,43,0,-14
-41.98769,-20.74566,57,45,0,-12
-41.98747,-20.74566,60,46,0,-14
-41.98725,-20.74566,56,47,0,-9
-41.98702,-20.74566,64,47,0,-17
-41.98657,-20.74566,66,47,0,-19
-41.98635,-20.74566,67,49,0,-18
-41.98612,-20.74566,66,49,0,-17
-41.9859,-20.74566,67,49,0,-18
-41.98545,-20.74566,66,47,0,-19
-41.98522,-20.74566,65,46,0,-19
-41.985,-20.74566,65,45,0,-20
-41.98477,-20.74566,65,44,0,-21
-41.98455,-20.74566,69,40,0,-29
-41.9841,-20.74566,69,38,0,-31
-41.98387,-20.74566,69,36,0,-33
-41.98365,-20.74566,69,36,0,-33
-41.98343,-20.74566,69,38,0,-31
-41.98298,-20.74566,69,35,0,-34
-41.98275,-20.74566,69,36,0,-33
-41.98253,-20.74566,69,36,0,-33
-41.9823,-20.74566,70,36,0,-34
-41.98185,-20.74566,71,39,0,-32
-41.98163,-20.74566,71,37,0,-34
-41.9814,-20.74566,70,34,0,-36
-41.98118,-20.74566,70,33,0,-37
-41.98073,-20.74566,70,34,0,-36
-41.9805,-20.74566,70,33,0,-37
-41.98028,-20.74566,67,33,0,-34
-41.98005,-20.74566,66,34,0,-32
-41.97983,-20.74566,65,35,0,-30
-41.97938,-20.74566,64,37,0,-27
-41.97916,-20.74566,64,37,0,-27
-41.97893,-20.74566,63,37,0,-26
-41.97871,-20.74566,63,38,0,-25
-41.97826,-20.74566,62,38,0,-24
-41.97803,-20.74566,61,38,0,-23
-41.97781,-20.74566,60,39,0,-21
-41.97758,-20.74566,60,39,0,-21
-41.97713,-20.74566,59,40,0,-19
-41.97691,-20.74566,58,40,5,-18
-41.97668,-20.74566,58,41,5,-17
-41.97646,-20.74566,58,42,5,-16
-41.97601,-20.74566,58,37,5,-21
-41.97578,-20.74566,58,44,5,-14
-41.97556,-20.74566,59,45,5,-14
-41.97534,-20.74566,57,45,5,-12
-41.97511,-20.74566,57,45,5,-12
-41.97466,-20.74566,60,42,5,-18
-41.97444,-20.74566,57,45,5,-12
-41.97421,-20.74566,56,45,5,-11
-41.97399,-20.74566,55,45,5,-10
-41.97354,-20.74566,55,45,5,-10
-41.97331,-20.74566,54,45,5,-9
-41.97309,-20.74566,53,45,5,-8
-41.97286,-20.74566,52,46,0,-6
-41.97241,-20.74566,52,45,5,-7
-41.97219,-20.74566,52,37,5,-15
-41.97196,-20.74566,52,36,5,-16
-41.97174,-20.74566,64,36,5,-28
-41.97129,-20.74566,64,36,5,-28
-41.97107,-20.74566,63,40,5,-23
-41.97084,-20.74566,57,46,5,-11
-41.97062,-20.74566,52,46,0,-6
-41.97017,-20.74566,52,48,11,-4
-41.96994,-20.74566,52,48,0,-4
-41.96972,-20.74566,52,48,0,-4
-41.96949,-20.74566,52,48,0,-4
-41.96927,-20.74566,52,48,5,-4
-42.1005,-20.74523,60,29,5,-31
-42.0978,-20.74523,58,30,5,-28
-42.09511,-20.74523,59,26,5,-33
-42.09219,-20.74523,62,26,5,-36
-42.08949,-20.74523,59,29,5,-30
-42.08657,-20.74523,59,31,5,-28
-42.08387,-20.74523,63,39,5,-24
-42.08118,-20.74523,57,33,5,-24
-42.07825,-20.74523,57,33,5,-24
-42.07556,-20.74523,57,35,5,-22
-42.07286,-20.74523,59,34,5,-25
-42.06994,-20.74523,59,38,5,-21
-42.06724,-20.74523,60,36,5,-24
-42.06455,-20.74523,56,36,5,-20
-42.06163,-20.74523,55,37,5,-18
-42.05893,-20.74523,55,41,5,-14
-42.05601,-20.74523,57,49,5,-8
-42.05331,-20.74523,65,43,5,-22
-42.05061,-20.74523,55,43,5,-12
-42.04769,-20.74523,58,42,5,-16
-42.045,-20.74523,54,43,5,-11
-42.0423,-20.74523,46,52,0,6
-42.03938,-20.74523,46,50,0,4
-42.03668,-20.74523,49,51,11,2
-42.03399,-20.74523,42,43,5,1
-42.03106,-20.74523,49,42,5,-7
-42.02837,-20.74523,44,47,0,3
-42.02545,-20.74523,47,45,5,-2
-42.02275,-20.74523,52,48,0,-4
-42.02005,-20.74523,48,46,5,-2
-42.01713,-20.74523,60,48,11,-12
-42.01444,-20.74523,61,50,0,-11
-42.01174,-20.74523,61,41,0,-20
-42.00882,-20.74523,60,49,0,-11
-42.00612,-20.74523,55,52,0,-3
-42.00342,-20.74523,63,45,0,-18
-42.0005,-20.74523,59,42,5,-17
-41.99781,-20.74523,55,38,5,-17
-41.99511,-20.74523,62,40,5,-22
-41.99219,-20.74523,66,46,0,-20
-41.98949,-20.74523,59,38,0,-21
-41.98657,-20.74523,65,49,0,-16
-41.98387,-20.74523,67,40,0,-27
-41.98118,-20.74523,70,39,0,-31
-41.97826,-20.74523,62,38,0,-24
-41.97556,-20.74523,57,45,0,-12
-41.97286,-20.74523,53,38,5,-15
-41.96994,-20.74523,52,48,0,-4
-42.1005,-20.74502,60,28,5,-32
-42.0978,-20.74502,58,30,0,-28
-42.09511,-20.74502,59,27,5,-32
-42.09219,-20.74502,62,26,5,-36
-42.08949,-20.74502,59,29,5,-30
-42.08657,-20.74502,59,31,5,-28
-42.08387,-20.74502,63,38,5,-25
-42.08118,-20.74502,58,33,5,-25
-42.07825,-20.74502,58,33,5,-25
-42.07556,-20.74502,59,35,5,-24
-42.07286,-20.74502,59,34,5,-25
-42.06994,-20.74502,59,35,5,-24
-42.06724,-20.74502,57,36,5,-21
-42.06455,-20.74502,56,36,5,-20
-42.06163,-20.74502,54,38,5,-16
-42.05893,-20.74502,57,42,5,-15
-42.05601,-20.74502,56,48,5,-8
-42.05331,-20.74502,62,42,5,-20
-42.05061,-20.74502,57,44,5,-13
-42.04769,-20.74502,54,40,5,-14
-42.045,-20.74502,53,44,5,-9
-42.0423,-20.74502,48,51,0,3
-42.03938,-20.74502,46,45,0,-1
-42.03668,-20.74502,51,54,0,3
-42.03399,-20.74502,44,44,5,0
-42.03106,-20.74502,49,46,5,-3
-42.02837,-20.74502,49,49,0,0
-42.02545,-20.74502,48,45,5,-3
-42.02275,-20.74502,52,47,0,-5
-42.02005,-20.74502,48,47,5,-1
-42.01713,-20.74502,58,46,2,-12
-42.01444,-20.74502,61,48,0,-13
-42.01174,-20.74502,63,41,6,-22
-42.00882,-20.74502,61,49,0,-12
-42.00612,-20.74502,56,53,0,-3
-42.00342,-20.74502,65,45,0,-20
-42.0005,-20.74502,60,46,5,-14
-41.99781,-20.74502,55,39,5,-16
-41.99511,-20.74502,63,39,5,-24
-41.99219,-20.74502,67,46,0,-21
-41.98949,-20.74502,58,39,0,-19
-41.98657,-20.74502,63,49,0,-14
-41.98387,-20.74502,66,47,0,-19
-41.98118,-20.74502,70,39,0,-31
-41.97826,-20.74502,62,39,0,-23
-41.97556,-20.74502,57,41,5,-16
-41.97286,-20.74502,54,36,5,-18
-41.96994,-20.74502,52,48,0,-4
-42.1005,-20.74481,62,29,5,-33
-42.0978,-20.74481,58,29,5,-29
-42.09511,-20.74481,59,27,5,-32
-42.09219,-20.74481,62,26,5,-36
-42.08949,-20.74481,59,28,5,-31
-42.08657,-20.74481,59,33,5,-26
-42.08387,-20.74481,61,37,5,-24
-42.08118,-20.74481,58,33,5,-25
-42.07825,-20.74481,59,33,5,-26
-42.07556,-20.74481,58,34,5,-24
-42.07286,-20.74481,57,34,5,-23
-42.06994,-20.74481,59,35,5,-24
-42.06724,-20.74481,57,36,5,-21
-42.06455,-20.74481,56,36,5,-20
-42.06163,-20.74481,54,37,5,-17
-42.05893,-20.74481,56,42,5,-14
-42.05601,-20.74481,56,48,5,-8
-42.05331,-20.74481,58,42,5,-16
-42.05061,-20.74481,56,43,5,-13
-42.04769,-20.74481,53,40,5,-13
-42.045,-20.74481,55,47,5,-8
-42.0423,-20.74481,47,51,0,4
-42.03938,-20.74481,46,49,0,3
-42.03668,-20.74481,49,54,0,5
-42.03399,-20.74481,44,44,5,0
-42.03106,-20.74481,49,49,5,0
-42.02837,-20.74481,46,47,0,1
-42.02545,-20.74481,48,46,5,-2
-42.02275,-20.74481,51,47,0,-4
-42.02005,-20.74481,48,47,5,-1
-42.01713,-20.74481,52,52,2,0
-42.01444,-20.74481,62,47,0,-15
-42.01174,-20.74481,63,41,11,-22
-42.00882,-20.74481,62,49,6,-13
-42.00612,-20.74481,61,53,11,-8
-42.00342,-20.74481,69,45,0,-24
-42.0005,-20.74481,61,49,11,-12
-41.99781,-20.74481,56,40,5,-16
-41.99511,-20.74481,61,38,5,-23
-41.99219,-20.74481,67,46,0,-21
-41.98949,-20.74481,57,39,0,-18
-41.98657,-20.74481,61,48,0,-13
-41.98387,-20.74481,66,47,0,-19
-41.98118,-20.74481,68,39,0,-29
-41.97826,-20.74481,64,39,0,-25
-41.97556,-20.74481,56,37,5,-19
-41.97286,-20.74481,54,37,5,-17
-41.96994,-20.74481,52,47,0,-5
-42.1005,-20.74439,62,26,5,-36
-42.0978,-20.74439,58,26,5,-32
-42.09511,-20.74439,59,27,5,-32
-42.09219,-20.74439,62,26,5,-36
-42.08949,-20.74439,59,29,5,-30
-42.08657,-20.74439,61,39,0,-22
-42.08387,-20.74439,59,34,5,-25
-42.08118,-20.74439,58,33,5,-25
-42.07825,-20.74439,59,33,5,-26
-42.07556,-20.74439,57,34,5,-23
-42.07286,-20.74439,57,34,5,-23
-42.06994,-20.74439,59,35,5,-24
-42.06724,-20.74439,57,36,5,-21
-42.06455,-20.74439,56,35,5,-21
-42.06163,-20.74439,50,38,5,-12
-42.05893,-20.74439,53,43,5,-10
-42.05601,-20.74439,56,51,5,-5
-42.05331,-20.74439,59,42,5,-17
-42.05061,-20.74439,55,44,5,-11
-42.04769,-20.74439,53,39,5,-14
-42.045,-20.74439,53,47,0,-6
-42.0423,-20.74439,45,50,0,5
-42.03938,-20.74439,47,52,0,5
-42.03668,-20.74439,47,47,0,0
-42.03399,-20.74439,45,45,5,0
-42.03106,-20.74439,48,64,0,16
-42.02837,-20.74439,44,50,0,6
-42.02545,-20.74439,49,46,5,-3
-42.02275,-20.74439,51,48,0,-3
-42.02005,-20.74439,49,43,2,-6
-42.01713,-20.74439,52,53,6,1
-42.01444,-20.74439,61,48,0,-13
-42.01174,-20.74439,63,43,0,-20
-42.00882,-20.74439,62,50,0,-12
-42.00612,-20.74439,62,53,0,-9
-42.00342,-20.74439,83,44,0,-39
-42.0005,-20.74439,61,45,5,-16
-41.99781,-20.74439,56,39,5,-17
-41.99511,-20.74439,60,41,5,-19
-41.99219,-20.74439,68,48,0,-20
-41.98949,-20.74439,58,40,0,-18
-41.98657,-20.74439,56,47,0,-9
-41.98387,-20.74439,67,47,0,-20
-41.98118,-20.74439,68,46,0,-22
-41.97826,-20.74439,66,39,0,-27
-41.97556,-20.74439,56,34,5,-22
-41.97286,-20.74439,54,37,5,-17
-41.96994,-20.74439,51,47,0,-4
-42.1005,-20.74418,60,25,5,-35
-42.0978,-20.74418,58,25,5,-33
-42.09511,-20.74418,59,28,5,-31
-42.09219,-20.74418,61,26,5,-35
-42.08949,-20.74418,59,30,5,-29
-42.08657,-20.74418,63,38,0,-25
-42.08387,-20.74418,59,34,5,-25
-42.08118,-20.74418,59,33,5,-26
-42.07825,-20.74418,59,33,5,-26
-42.07556,-20.74418,57,34,5,-23
-42.07286,-20.74418,59,35,5,-24
-42.06994,-20.74418,59,35,5,-24
-42.06724,-20.74418,56,36,5,-20
-42.06455,-20.74418,58,35,5,-23
-42.06163,-20.74418,49,38,5,-11
-42.05893,-20.74418,53,44,5,-9
-42.05601,-20.74418,56,49,5,-7
-42.05331,-20.74418,56,42,5,-14
-42.05061,-20.74418,55,45,5,-10
-42.04769,-20.74418,52,39,5,-13
-42.045,-20.74418,53,48,0,-5
-42.0423,-20.74418,45,50,0,5
-42.03938,-20.74418,47,49,0,2
-42.03668,-20.74418,46,46,5,0
-42.03399,-20.74418,45,45,5,0
-42.03106,-20.74418,47,65,0,18
-42.02837,-20.74418,44,53,0,9
-42.02545,-20.74418,49,46,5,-3
-42.02275,-20.74418,51,49,0,-2
-42.02005,-20.74418,50,45,2,-5
-42.01713,-20.74418,52,47,2,-5
-42.01444,-20.74418,61,48,0,-13
-42.01174,-20.74418,62,43,0,-19
-42.00882,-20.74418,63,51,0,-12
-42.00612,-20.74418,63,53,0,-10
-42.00342,-20.74418,83,44,0,-39
-42.0005,-20.74418,63,44,5,-19
-41.99781,-20.74418,57,37,5,-20
-41.99511,-20.74418,55,41,0,-14
-41.99219,-20.74418,68,46,0,-22
-41.98949,-20.74418,58,40,0,-18
-41.98657,-20.74418,56,46,0,-10
-41.98387,-20.74418,67,46,0,-21
-41.98118,-20.74418,67,46,0,-21
-41.97826,-20.74418,62,39,0,-23
-41.97556,-20.74418,56,34,5,-22
-41.97286,-20.74418,55,36,5,-19
-41.96994,-20.74418,51,47,0,-4
-42.1005,-20.74396,58,25,5,-33
-42.0978,-20.74396,58,25,5,-33
-42.09511,-20.74396,58,28,5,-30
-42.09219,-20.74396,60,26,5,-34
-42.08949,-20.74396,59,39,5,-20
-42.08657,-20.74396,62,38,0,-24
-42.08387,-20.74396,59,33,5,-26
-42.08118,-20.74396,60,33,5,-27
-42.07825,-20.74396,58,35,5,-23
-42.07556,-20.74396,57,32,5,-25
-42.07286,-20.74396,59,35,5,-24
-42.06994,-20.74396,59,35,5,-24
-42.06724,-20.74396,58,36,5,-22
-42.06455,-20.74396,59,35,5,-24
-42.06163,-20.74396,49,40,5,-9
-42.05893,-20.74396,52,44,5,-8
-42.05601,-20.74396,56,49,5,-7
-42.05331,-20.74396,55,41,5,-14
-42.05061,-20.74396,57,45,5,-12
-42.04769,-20.74396,54,39,5,-15
-42.045,-20.74396,54,46,0,-8
-42.0423,-20.74396,45,52,0,7
-42.03938,-20.74396,47,52,0,5
-42.03668,-20.74396,48,45,5,-3
-42.03399,-20.74396,46,45,5,-1
-42.03106,-20.74396,48,64,0,16
-42.02837,-20.74396,45,53,0,8
-42.02545,-20.74396,50,47,5,-3
-42.02275,-20.74396,52,48,5,-4
-42.02005,-20.74396,51,46,2,-5
-42.01713,-20.74396,52,42,2,-10
-42.01444,-20.74396,63,48,0,-15
-42.01174,-20.74396,62,43,0,-19
-42.00882,-20.74396,63,51,6,-12
-42.00612,-20.74396,66,53,0,-13
-42.00342,-20.74396,83,44,0,-39
-42.0005,-20.74396,64,43,5,-21
-41.99781,-20.74396,57,37,5,-20
-41.99511,-20.74396,54,41,5,-13
-41.99219,-20.74396,68,46,0,-22
-41.98949,-20.74396,58,43,0,-15
-41.98657,-20.74396,61,46,0,-15
-41.98387,-20.74396,67,46,0,-21
-41.98118,-20.74396,66,46,0,-20
-41.97826,-20.74396,58,38,0,-20
-41.97556,-20.74396,56,36,5,-20
-41.97286,-20.74396,62,35,5,-27
-41.96994,-20.74396,51,47,0,-4
-42.1005,-20.74354,58,25,5,-33
-42.0978,-20.74354,58,25,5,-33
-42.09511,-20.74354,58,27,5,-31
-42.09219,-20.74354,60,27,5,-33
-42.08949,-20.74354,58,39,0,-19
-42.08657,-20.74354,62,38,0,-24
-42.08387,-20.74354,59,32,5,-27
-42.08118,-20.74354,61,32,5,-29
-42.07825,-20.74354,58,35,5,-23
-42.07556,-20.74354,57,36,5,-21
-42.07286,-20.74354,60,38,5,-22
-42.06994,-20.74354,59,35,5,-24
-42.06724,-20.74354,57,36,5,-21
-42.06455,-20.74354,61,35,5,-26
-42.06163,-20.74354,50,41,5,-9
-42.05893,-20.74354,51,44,5,-7
-42.05601,-20.74354,55,50,5,-5
-42.05331,-20.74354,52,44,5,-8
-42.05061,-20.74354,58,45,5,-13
-42.04769,-20.74354,51,45,5,-6
-42.045,-20.74354,52,45,5,-7
-42.0423,-20.74354,47,53,0,6
-42.03938,-20.74354,48,56,0,8
-42.03668,-20.74354,47,49,5,2
-42.03399,-20.74354,51,44,2,-7
-42.03106,-20.74354,47,46,0,-1
-42.02837,-20.74354,45,63,0,18
-42.02545,-20.74354,50,48,5,-2
-42.02275,-20.74354,50,46,5,-4
-42.02005,-20.74354,52,46,2,-6
-42.01713,-20.74354,52,49,2,-3
-42.01444,-20.74354,64,48,0,-16
-42.01174,-20.74354,62,45,11,-17
-42.00882,-20.74354,62,51,0,-11
-42.00612,-20.74354,65,53,0,-12
-42.00342,-20.74354,83,43,0,-40
-42.0005,-20.74354,64,45,5,-19
-41.99781,-20.74354,58,38,5,-20
-41.99511,-20.74354,54,38,5,-16
-41.99219,-20.74354,68,46,0,-22
-41.98949,-20.74354,58,49,0,-9
-41.98657,-20.74354,61,43,0,-18
-41.98387,-20.74354,67,45,0,-22
-41.98118,-20.74354,67,46,0,-21
-41.97826,-20.74354,58,37,0,-21
-41.97556,-20.74354,56,36,5,-20
-41.97286,-20.74354,64,35,5,-29
-41.96994,-20.74354,52,46,0,-6
-42.1005,-20.74333,58,25,5,-33
-42.0978,-20.74333,58,26,5,-32
-42.09511,-20.74333,58,27,5,-31
-42.09219,-20.74333,60,27,5,-33
-42.08949,-20.74333,58,39,0,-19
-42.08657,-20.74333,62,38,0,-24
-42.08387,-20.74333,60,32,5,-28
-42.08118,-20.74333,62,32,5,-30
-42.07825,-20.74333,58,35,5,-23
-42.07556,-20.74333,57,33,5,-24
-42.07286,-20.74333,59,38,0,-21
-42.06994,-20.74333,59,35,5,-24
-42.06724,-20.74333,54,36,5,-18
-42.06455,-20.74333,59,39,5,-20
-42.06163,-20.74333,50,40,5,-10
-42.05893,-20.74333,50,43,5,-7
-42.05601,-20.74333,54,51,5,-3
-42.05331,-20.74333,51,45,5,-6
-42.05061,-20.74333,56,45,5,-11
-42.04769,-20.74333,52,45,5,-7
-42.045,-20.74333,49,45,5,-4
-42.0423,-20.74333,45,52,0,7
-42.03938,-20.74333,47,56,0,9
-42.03668,-20.74333,44,43,5,-1
-42.03399,-20.74333,49,45,2,-4
-42.03106,-20.74333,38,62,0,24
-42.02837,-20.74333,44,63,0,19
-42.02545,-20.74333,50,51,5,1
-42.02275,-20.74333,50,46,5,-4
-42.02005,-20.74333,53,44,2,-9
-42.01713,-20.74333,52,50,5,-2
-42.01444,-20.74333,60,47,0,-13
-42.01174,-20.74333,62,46,11,-16
-42.00882,-20.74333,62,51,0,-11
-42.00612,-20.74333,66,52,0,-14
-42.00342,-20.74333,83,43,0,-40
-42.0005,-20.74333,63,48,5,-15
-41.99781,-20.74333,59,38,5,-21
-41.99511,-20.74333,60,38,5,-22
-41.99219,-20.74333,67,46,0,-21
-41.98949,-20.74333,59,49,0,-10
-41.98657,-20.74333,57,42,0,-15
-41.98387,-20.74333,68,44,0,-24
-41.98118,-20.74333,66,45,0,-21
-41.97826,-20.74333,58,37,0,-21
-41.97556,-20.74333,56,36,5,-20
-41.97286,-20.74333,63,44,5,-19
-41.96994,-20.74333,53,46,0,-7
-42.1005,-20.74312,58,26,5,-32
-42.0978,-20.74312,59,28,5,-31
-42.09511,-20.74312,58,27,5,-31
-42.09219,-20.74312,61,27,5,-34
-42.08949,-20.74312,58,39,0,-19
-42.08657,-20.74312,60,38,0,-22
-42.08387,-20.74312,60,33,5,-27
-42.08118,-20.74312,62,32,5,-30
-42.07825,-20.74312,58,36,5,-22
-42.07556,-20.74312,57,33,5,-24
-42.07286,-20.74312,58,38,0,-20
-42.06994,-20.74312,58,35,5,-23
-42.06724,-20.74312,54,35,5,-19
-42.06455,-20.74312,57,39,5,-18
-42.06163,-20.74312,51,41,5,-10
-42.05893,-20.74312,50,43,5,-7
-42.05601,-20.74312,53,51,5,-2
-42.05331,-20.74312,50,44,5,-6
-42.05061,-20.74312,54,46,5,-8
-42.04769,-20.74312,51,46,5,-5
-42.045,-20.74312,47,45,5,-2
-42.0423,-20.74312,46,51,0,5
-42.03938,-20.74312,46,55,0,9
-42.03668,-20.74312,43,43,5,0
-42.03399,-20.74312,47,44,2,-3
-42.03106,-20.74312,38,62,0,24
-42.02837,-20.74312,46,55,0,9
-42.02545,-20.74312,50,51,5,1
-42.02275,-20.74312,50,46,5,-4
-42.02005,-20.74312,52,48,2,-4
-42.01713,-20.74312,53,50,11,-3
-42.01444,-20.74312,58,47,0,-11
-42.01174,-20.74312,63,46,11,-17
-42.00882,-20.74312,62,52,11,-10
-42.00612,-20.74312,65,52,0,-13
-42.00342,-20.74312,83,43,0,-40
-42.0005,-20.74312,63,47,5,-16
-41.99781,-20.74312,60,41,5,-19
-41.99511,-20.74312,63,39,5,-24
-41.99219,-20.74312,66,48,5,-18
-41.98949,-20.74312,61,49,0,-12
-41.98657,-20.74312,58,42,0,-16
-41.98387,-20.74312,68,44,0,-24
-41.98118,-20.74312,66,45,0,-21
-41.97826,-20.74312,58,35,0,-23
-41.97556,-20.74312,56,35,5,-21
-41.97286,-20.74312,64,45,5,-19
-41.96994,-20.74312,53,46,0,-7
-42.10297,-20.7427,58,27,5,-31
-42.10275,-20.7427,58,26,5,-32
-42.10252,-20.7427,59,26,5,-33
-42.1023,-20.7427,59,26,5,-33
-42.10185,-20.7427,59,26,5,-33
-42.10163,-20.7427,59,24,5,-35
-42.1014,-20.7427,59,26,5,-33
-42.10118,-20.7427,59,26,5,-33
-42.10073,-20.7427,59,26,5,-33
-42.1005,-20.7427,59,29,5,-30
-42.10028,-20.7427,59,29,5,-30
-42.10005,-20.7427,59,29,5,-30
-42.09983,-20.7427,59,27,5,-32
-42.09938,-20.7427,59,26,5,-33
-42.09915,-20.7427,59,25,5,-34
-42.09893,-20.7427,59,26,5,-33
-42.0987,-20.7427,59,29,5,-30
-42.09825,-20.7427,59,29,5,-30
-42.09803,-20.7427,59,28,5,-31
-42.0978,-20.7427,59,26,5,-33
-42.09758,-20.7427,59,25,5,-34
-42.09713,-20.7427,59,25,5,-34
-42.09691,-20.7427,59,26,5,-33
-42.09668,-20.7427,59,26,5,-33
-42.09646,-20.7427,65,26,5,-39
-42.09601,-20.7427,67,26,5,-41
-42.09578,-20.7427,59,25,5,-34
-42.09556,-20.7427,58,26,5,-32
-42.09533,-20.7427,58,26,5,-32
-42.09511,-20.7427,58,26,5,-32
-42.09466,-20.7427,58,26,5,-32
-42.09443,-20.7427,58,27,5,-31
-42.09421,-20.7427,59,27,5,-32
-42.09398,-20.7427,59,27,5,-32
-42.09354,-20.7427,59,26,5,-33
-42.09331,-20.7427,59,27,5,-32
-42.09309,-20.7427,59,30,5,-29
-42.09286,-20.7427,59,30,5,-29
-42.09241,-20.7427,59,28,5,-31
-42.09219,-20.7427,61,28,5,-33
-42.09196,-20.7427,62,29,5,-33
-42.09174,-20.7427,64,29,5,-35
-42.09129,-20.7427,65,29,5,-36
-42.09106,-20.7427,65,30,5,-35
-42.09084,-20.7427,68,30,5,-38
-42.09061,-20.7427,67,33,5,-34
-42.09039,-20.7427,66,34,5,-32
-42.08994,-20.7427,68,39,5,-29
-42.08972,-20.7427,61,39,5,-22
-42.08949,-20.7427,60,39,5,-21
-42.08927,-20.7427,58,39,0,-19
-42.08882,-20.7427,58,38,0,-20
-42.08859,-20.7427,58,38,0,-20
-42.08837,-20.7427,59,38,0,-21
-42.08814,-20.7427,59,38,0,-21
-42.08769,-20.7427,59,38,0,-21
-42.08747,-20.7427,59,38,0,-21
-42.08724,-20.7427,60,38,0,-22
-42.08702,-20.7427,60,38,0,-22
-42.08657,-20.7427,60,38,0,-22
-42.08634,-20.7427,61,38,0,-23
-42.08612,-20.7427,67,38,0,-29
-42.08589,-20.7427,60,38,0,-22
-42.08545,-20.7427,64,38,0,-26
-42.08522,-20.7427,60,38,0,-22
-42.085,-20.7427,60,38,0,-22
-42.08477,-20.7427,60,38,0,-22
-42.08455,-20.7427,60,38,0,-22
-42.0841,-20.7427,60,37,5,-23
-42.08387,-20.7427,60,33,5,-27
-42.08365,-20.7427,61,32,5,-29
-42.08342,-20.7427,61,32,5,-29
-42.08297,-20.7427,61,32,5,-29
-42.08275,-20.7427,61,33,5,-28
-42.08252,-20.7427,61,33,5,-28
-42.0823,-20.7427,61,33,5,-28
-42.08185,-20.7427,61,32,5,-29
-42.08163,-20.7427,61,33,5,-28
-42.0814,-20.7427,61,32,5,-29
-42.08118,-20.7427,62,32,5,-30
-42.08073,-20.7427,63,32,5,-31
-42.0805,-20.7427,63,32,5,-31
-42.08028,-20.7427,64,30,5,-34
-42.08005,-20.7427,64,30,5,-34
-42.07983,-20.7427,60,30,5,-30
-42.07938,-20.7427,60,32,5,-28
-42.07915,-20.7427,59,34,5,-25
-42.07893,-20.7427,59,34,5,-25
-42.0787,-20.7427,59,34,5,-25
-42.07825,-20.7427,59,36,5,-23
-42.07803,-20.7427,60,36,5,-24
-42.07781,-20.7427,60,36,5,-24
-42.07758,-20.7427,60,35,5,-25
-42.07713,-20.7427,61,35,5,-26
-42.07691,-20.7427,61,35,5,-26
-42.07668,-20.7427,62,37,5,-25
-42.07646,-20.7427,63,37,5,-26
-42.07601,-20.7427,60,35,5,-25
-42.07578,-20.7427,59,35,5,-24
-42.07556,-20.7427,57,34,5,-23
-42.07533,-20.7427,57,33,5,-24
-42.07511,-20.7427,57,33,5,-24
-42.07466,-20.7427,57,35,5,-22
-42.07443,-20.7427,57,36,5,-21
-42.07421,-20.7427,57,34,5,-23
-42.07399,-20.7427,57,34,5,-23
-42.07354,-20.7427,58,33,5,-25
-42.07331,-20.7427,59,33,5,-26
-42.07309,-20.7427,58,33,5,-25
-42.07286,-20.7427,58,33,5,-25
-42.07241,-20.7427,57,37,5,-20
-42.07219,-20.7427,57,37,5,-20
-42.07196,-20.7427,57,37,0,-20
-42.07174,-20.7427,57,37,5,-20
-42.07129,-20.7427,57,35,5,-22
-42.07106,-20.7427,57,35,5,-22
-42.07084,-20.7427,58,36,5,-22
-42.07061,-20.7427,58,36,5,-22
-42.07039,-20.7427,58,36,5,-22
-42.06994,-20.7427,59,36,5,-23
-42.06972,-20.7427,59,36,5,-23
-42.06949,-20.7427,59,36,5,-23
-42.06927,-20.7427,59,36,5,-23
-42.06882,-20.7427,60,36,5,-24
-42.06859,-20.7427,59,36,5,-23
-42.06837,-20.7427,60,36,5,-24
-42.06814,-20.7427,60,36,5,-24
-42.06769,-20.7427,58,36,5,-22
-42.06747,-20.7427,57,35,5,-22
-42.06724,-20.7427,56,35,5,-21
-42.06702,-20.7427,54,35,5,-19
-42.06657,-20.7427,53,34,5,-19
-42.06634,-20.7427,54,33,5,-21
-42.06612,-20.7427,54,37,5,-17
-42.0659,-20.7427,54,37,5,-17
-42.06545,-20.7427,55,38,5,-17
-42.06522,-20.7427,57,38,5,-19
-42.065,-20.7427,56,38,5,-18
-42.06477,-20.7427,56,39,5,-17
-42.06455,-20.7427,56,40,5,-16
-42.0641,-20.7427,58,40,5,-18
-42.06387,-20.7427,57,40,5,-17
-42.06365,-20.7427,58,42,5,-16
-42.06342,-20.7427,56,42,5,-14
-42.06297,-20.7427,55,41,5,-14
-42.06275,-20.7427,55,41,5,-14
-42.06252,-20.7427,54,41,5,-13
-42.0623,-20.7427,51,42,5,-9
-42.06185,-20.7427,51,42,5,-9
-42.06163,-20.7427,51,41,5,-10
-42.0614,-20.7427,52,41,5,-11
-42.06118,-20.7427,53,42,5,-11
-42.06073,-20.7427,53,42,5,-11
-42.0605,-20.7427,52,40,5,-12
-42.06028,-20.7427,50,41,5,-9
-42.06005,-20.7427,48,43,5,-5
-42.05983,-20.7427,48,43,5,-5
-42.05938,-20.7427,49,43,5,-6
-42.05915,-20.7427,51,43,5,-8
-42.05893,-20.7427,51,43,5,-8
-42.0587,-20.7427,51,43,5,-8
-42.05826,-20.7427,51,43,5,-8
-42.05803,-20.7427,50,44,5,-6
-42.05781,-20.7427,48,44,5,-4
-42.05758,-20.7427,49,48,5,-1
-42.05713,-20.7427,50,48,5,-2
-42.05691,-20.7427,51,48,5,-3
-42.05668,-20.7427,51,50,0,-1
-42.05646,-20.7427,52,52,0,0
-42.05601,-20.7427,52,49,0,-3
-42.05578,-20.7427,54,46,5,-8
-42.05556,-20.7427,55,46,5,-9
-42.05533,-20.7427,56,46,5,-10
-42.05511,-20.7427,56,46,5,-10
-42.05466,-20.7427,56,47,5,-9
-42.05443,-20.7427,57,47,5,-10
-42.05421,-20.7427,56,47,5,-9
-42.05399,-20.7427,54,45,5,-9
-42.05354,-20.7427,52,45,5,-7
-42.05331,-20.7427,48,45,5,-3
-42.05309,-20.7427,45,45,5,0
-42.05286,-20.7427,44,44,5,0
-42.05241,-20.7427,45,45,5,0
-42.05219,-20.7427,46,46,5,0
-42.05196,-20.7427,46,46,5,0
-42.05174,-20.7427,47,46,5,-1
-42.05129,-20.7427,47,47,5,0
-42.05106,-20.7427,49,48,5,-1
-42.05084,-20.7427,49,48,5,-1
-42.05061,-20.7427,54,47,5,-7
-42.05039,-20.7427,55,48,5,-7
-42.04994,-20.7427,54,48,5,-6
-42.04972,-20.7427,53,47,5,-6
-42.04949,-20.7427,53,46,5,-7
-42.04927,-20.7427,51,47,5,-4
-42.04882,-20.7427,50,47,5,-3
-42.04859,-20.7427,52,47,5,-5
-42.04837,-20.7427,52,47,5,-5
-42.04814,-20.7427,51,47,5,-4
-42.04769,-20.7427,51,47,5,-4
-42.04747,-20.7427,53,47,5,-6
-42.04724,-20.7427,54,46,5,-8
-42.04702,-20.7427,55,47,5,-8
-42.04657,-20.7427,55,46,5,-9
-42.04635,-20.7427,53,47,5,-6
-42.04612,-20.7427,53,47,5,-6
-42.0459,-20.7427,50,47,5,-3
-42.04545,-20.7427,50,47,5,-3
-42.04522,-20.7427,47,47,5,0
-42.045,-20.7427,48,45,5,-3
-42.04477,-20.7427,48,46,5,-2
-42.04455,-20.7427,48,48,5,0
-42.0441,-20.7427,48,48,5,0
-42.04387,-20.7427,49,48,5,-1
-42.04365,-20.7427,48,46,5,-2
-42.04342,-20.7427,48,46,5,-2
-42.04297,-20.7427,48,48,5,0
-42.04275,-20.7427,47,47,5,0
-42.04253,-20.7427,47,47,5,0
-42.0423,-20.7427,47,47,0,0
-42.04185,-20.7427,46,52,0,6
-42.04163,-20.7427,49,52,0,3
-42.0414,-20.7427,48,52,0,4
-42.04118,-20.7427,46,52,0,6
-42.04073,-20.7427,45,54,0,9
-42.0405,-20.7427,41,52,11,11
-42.04028,-20.7427,41,51,0,10
-42.04005,-20.7427,42,51,0,9
-42.03983,-20.7427,44,49,0,5
-42.03938,-20.7427,46,53,0,7
-42.03915,-20.7427,45,56,0,11
-42.03893,-20.7427,45,57,0,12
-42.0387,-20.7427,43,56,0,13
-42.03826,-20.7427,44,56,0,12
-42.03803,-20.7427,40,55,0,15
-42.03781,-20.7427,37,55,0,18
-42.03758,-20.7427,39,54,0,15
-42.03713,-20.7427,38,54,0,16
-42.03691,-20.7427,39,45,0,6
-42.03668,-20.7427,41,42,5,1
-42.03646,-20.7427,42,42,5,0
-42.03601,-20.7427,41,43,5,2
-42.03578,-20.7427,42,44,5,2
-42.03556,-20.7427,42,44,0,2
-42.03533,-20.7427,41,54,0,13
-42.03511,-20.7427,36,48,0,12
-42.03466,-20.7427,37,43,2,6
-42.03444,-20.7427,39,43,2,4
-42.03421,-20.7427,43,43,2,0
-42.03399,-20.7427,46,43,2,-3
-42.03354,-20.7427,46,48,11,2
-42.03331,-20.7427,43,48,11,5
-42.03309,-20.7427,41,42,11,1
-42.03286,-20.7427,40,42,5,2
-42.03241,-20.7427,41,42,11,1
-42.03219,-20.7427,39,42,11,3
-42.03196,-20.7427,38,42,5,4
-42.03174,-20.7427,38,42,5,4
-42.03129,-20.7427,37,43,5,6
-42.03106,-20.7427,39,43,0,4
-42.03084,-20.7427,40,62,0,22
-42.03062,-20.7427,40,52,0,12
-42.03017,-20.7427,41,64,0,23
-42.02994,-20.7427,41,63,0,22
-42.02972,-20.7427,47,52,0,5
-42.02949,-20.7427,48,52,0,4
-42.02927,-20.7427,47,52,0,5
-42.02882,-20.7427,48,51,0,3
-42.02859,-20.7427,48,51,0,3
-42.02837,-20.7427,49,52,0,3
-42.02814,-20.7427,48,55,0,7
-42.02769,-20.7427,47,45,0,-2
-42.02747,-20.7427,46,45,5,-1
-42.02724,-20.7427,46,45,5,-1
-42.02702,-20.7427,46,47,5,1
-42.02657,-20.7427,47,50,5,3
-42.02635,-20.7427,50,50,5,0
-42.02612,-20.7427,49,50,5,1
-42.0259,-20.7427,50,50,5,0
-42.02545,-20.7427,50,71,0,21
-42.02522,-20.7427,51,71,0,20
-42.025,-20.7427,51,70,0,19
-42.02477,-20.7427,51,68,0,17
-42.02455,-20.7427,52,67,0,15
-42.0241,-20.7427,51,66,0,15
-42.02387,-20.7427,51,66,0,15
-42.02365,-20.7427,52,49,0,-3
-42.02342,-20.7427,51,50,5,-1
-42.02297,-20.7427,51,50,5,-1
-42.02275,-20.7427,51,48,5,-3
-42.02253,-20.7427,50,45,5,-5
-42.0223,-20.7427,49,47,5,-2
-42.02185,-20.7427,49,45,5,-4
-42.02163,-20.7427,51,45,5,-6
-42.0214,-20.7427,51,44,5,-7
-42.02118,-20.7427,53,45,5,-8
-42.02073,-20.7427,55,46,2,-9
-42.0205,-20.7427,54,47,11,-7
-42.02028,-20.7427,53,46,2,-7
-42.02005,-20.7427,52,47,11,-5
-42.01983,-20.7427,52,45,2,-7
-42.01938,-20.7427,52,43,2,-9
-42.01915,-20.7427,52,43,2,-9
-42.01893,-20.7427,52,47,2,-5
-42.01871,-20.7427,52,52,6,0
-42.01826,-20.7427,53,52,2,-1
-42.01803,-20.7427,56,47,11,-9
-42.01781,-20.7427,63,47,2,-16
-42.01758,-20.7427,54,53,2,-1
-42.01713,-20.7427,54,53,2,-1
-42.01691,-20.7427,54,55,2,1
-42.01668,-20.7427,54,54,11,0
-42.01646,-20.7427,54,54,2,0
-42.01601,-20.7427,54,55,11,1
-42.01578,-20.7427,54,54,11,0
-42.01556,-20.7427,54,54,2,0
-42.01533,-20.7427,53,49,2,-4
-42.01511,-20.7427,54,48,2,-6
-42.01466,-20.7427,58,46,0,-12
-42.01444,-20.7427,59,47,0,-12
-42.01421,-20.7427,57,47,0,-10
-42.01399,-20.7427,62,47,0,-15
-42.01354,-20.7427,61,46,0,-15
-42.01331,-20.7427,60,46,0,-14
-42.01309,-20.7427,61,45,0,-16
-42.01286,-20.7427,62,46,0,-16
-42.01241,-20.7427,64,46,0,-18
-42.01219,-20.7427,64,46,0,-18
-42.01196,-20.7427,65,46,0,-19
-42.01174,-20.7427,64,46,11,-18
-42.01129,-20.7427,63,46,0,-17
-42.01106,-20.7427,62,48,0,-14
-42.01084,-20.7427,63,49,0,-14
-42.01062,-20.7427,62,50,0,-12
-42.01017,-20.7427,61,51,0,-10
-42.00994,-20.7427,62,51,0,-11
-42.00972,-20.7427,62,51,0,-11
-42.00949,-20.7427,63,52,0,-11
-42.00927,-20.7427,62,52,0,-10
-42.00882,-20.7427,62,52,0,-10
-42.00859,-20.7427,63,52,0,-11
-42.00837,-20.7427,64,51,0,-13
-42.00814,-20.7427,64,51,0,-13
-42.00769,-20.7427,64,51,11,-13
-42.00747,-20.7427,64,51,0,-13
-42.00724,-20.7427,63,52,0,-11
-42.00702,-20.7427,63,52,0,-11
-42.00657,-20.7427,63,52,0,-11
-42.00635,-20.7427,64,52,0,-12
-42.00612,-20.7427,65,52,0,-13
-42.0059,-20.7427,65,52,0,-13
-42.00545,-20.7427,66,52,0,-14
-42.00522,-20.7427,66,52,0,-14
-42.005,-20.7427,67,52,0,-15
-42.00477,-20.7427,72,49,0,-23
-42.00455,-20.7427,84,44,0,-40
-42.0041,-20.7427,83,44,11,-39
-42.00387,-20.7427,83,44,0,-39
-42.00365,-20.7427,83,44,0,-39
-42.00342,-20.7427,74,46,0,-28
-42.00298,-20.7427,70,47,11,-23
-42.00275,-20.7427,66,47,0,-19
-42.00253,-20.7427,64,47,0,-17
-42.0023,-20.7427,62,47,0,-15
-42.00185,-20.7427,61,46,0,-15
-42.00163,-20.7427,61,46,0,-15
-42.0014,-20.7427,62,46,0,-16
-42.00118,-20.7427,64,47,0,-17
-42.00073,-20.7427,64,47,0,-17
-42.0005,-20.7427,63,47,0,-16
-42.00028,-20.7427,64,47,0,-17
-42.00005,-20.7427,64,48,5,-16
-41.99983,-20.7427,63,47,5,-16
-41.99938,-20.7427,63,44,5,-19
-41.99916,-20.7427,62,43,5,-19
-41.99893,-20.7427,62,42,5,-20
-41.99871,-20.7427,62,42,5,-20
-41.99826,-20.7427,63,40,5,-23
-41.99803,-20.7427,64,40,5,-24
-41.99781,-20.7427,61,41,5,-20
-41.99758,-20.7427,59,41,5,-18
-41.99713,-20.7427,56,41,5,-15
-41.99691,-20.7427,55,40,5,-15
-41.99668,-20.7427,54,39,5,-15
-41.99646,-20.7427,54,39,5,-15
-41.99601,-20.7427,54,40,5,-14
-41.99578,-20.7427,60,39,5,-21
-41.99556,-20.7427,56,39,5,-17
-41.99533,-20.7427,57,39,5,-18
-41.99511,-20.7427,62,38,5,-24
-41.99466,-20.7427,61,39,5,-22
-41.99444,-20.7427,64,40,5,-24
-41.99421,-20.7427,62,40,5,-22
-41.99399,-20.7427,63,40,5,-23
-41.99354,-20.7427,67,41,5,-26
-41.99331,-20.7427,65,44,5,-21
-41.99309,-20.7427,65,44,5,-21
-41.99286,-20.7427,66,46,5,-20
-41.99241,-20.7427,67,46,5,-21
-41.99219,-20.7427,67,48,5,-19
-41.99196,-20.7427,68,48,5,-20
-41.99174,-20.7427,70,44,5,-26
-41.99129,-20.7427,71,42,5,-29
-41.99107,-20.7427,70,47,5,-23
-41.99084,-20.7427,69,48,0,-21
-41.99062,-20.7427,66,48,0,-18
-41.99017,-20.7427,67,48,0,-19
-41.98994,-20.7427,65,49,0,-16
-41.98972,-20.7427,63,48,0,-15
-41.98949,-20.7427,62,48,0,-14
-41.98927,-20.7427,61,48,0,-13
-41.98882,-20.7427,60,48,0,-12
-41.98859,-20.7427,59,46,0,-13
-41.98837,-20.7427,59,45,0,-14
-41.98814,-20.7427,58,43,0,-15
-41.98769,-20.7427,58,43,0,-15
-41.98747,-20.7427,58,42,0,-16
-41.98725,-20.7427,58,42,0,-16
-41.98702,-20.7427,58,41,0,-17
-41.98657,-20.7427,58,42,0,-16
-41.98635,-20.7427,58,42,0,-16
-41.98612,-20.7427,58,42,0,-16
-41.9859,-20.7427,58,42,0,-16
-41.98545,-20.7427,58,43,0,-15
-41.98522,-20.7427,60,43,0,-17
-41.985,-20.7427,64,43,0,-21
-41.98477,-20.7427,64,44,0,-20
-41.98455,-20.7427,67,43,0,-24
-41.9841,-20.7427,67,43,0,-24
-41.98387,-20.7427,67,43,0,-24
-41.98365,-20.7427,68,44,0,-24
-41.98343,-20.7427,68,44,0,-24
-41.98298,-20.7427,68,44,0,-24
-41.98275,-20.7427,68,44,0,-24
-41.98253,-20.7427,68,44,0,-24
-41.9823,-20.7427,68,45,0,-23
-41.98185,-20.7427,68,45,0,-23
-41.98163,-20.7427,67,45,0,-22
-41.9814,-20.7427,67,45,0,-22
-41.98118,-20.7427,66,45,0,-21
-41.98073,-20.7427,64,45,0,-19
-41.9805,-20.7427,63,45,0,-18
-41.98028,-20.7427,61,45,0,-16
-41.98005,-20.7427,60,45,0,-15
-41.97983,-20.7427,58,45,0,-13
-41.97938,-20.7427,58,45,0,-13
-41.97916,-20.7427,58,45,0,-13
-41.97893,-20.7427,58,45,0,-13
-41.97871,-20.7427,58,45,0,-13
-41.97826,-20.7427,58,45,0,-13
-41.97803,-20.7427,58,39,5,-19
-41.97781,-20.7427,66,34,5,-32
-41.97758,-20.7427,66,32,5,-34
-41.97713,-20.7427,58,32,5,-26
-41.97691,-20.7427,58,32,5,-26
-41.97668,-20.7427,58,33,5,-25
-41.97646,-20.7427,58,33,5,-25
-41.97601,-20.7427,58,33,5,-25
-41.97578,-20.7427,57,33,5,-24
-41.97556,-20.7427,57,34,5,-23
-41.97534,-20.7427,56,34,5,-22
-41.97511,-20.7427,56,33,5,-23
-41.97466,-20.7427,55,35,5,-20
-41.97444,-20.7427,55,34,5,-21
-41.97421,-20.7427,63,34,5,-29
-41.97399,-20.7427,66,34,5,-32
-41.97354,-20.7427,66,36,5,-30
-41.97331,-20.7427,64,40,5,-24
-41.97309,-20.7427,67,44,0,-23
-41.97286,-20.7427,65,45,0,-20
-41.97241,-20.7427,60,45,0,-15
-41.97219,-20.7427,60,45,0,-15
-41.97196,-20.7427,58,45,0,-13
-41.97174,-20.7427,56,45,0,-11
-41.97129,-20.7427,56,45,0,-11
-41.97107,-20.7427,56,46,0,-10
-41.97084,-20.7427,55,46,0,-9
-41.97062,-20.7427,55,46,0,-9
-41.97017,-20.7427,54,46,11,-8
-41.96994,-20.7427,54,46,0,-8
-41.96972,-20.7427,53,46,0,-7
-41.96949,-20.7427,52,47,0,-5
-41.96927,-20.7427,52,47,0,-5
-42.1005,-20.74248,59,27,5,-32
-42.0978,-20.74248,59,25,5,-34
-42.09511,-20.74248,59,27,5,-32
-42.09219,-20.74248,61,28,5,-33
-42.08949,-20.74248,61,38,5,-23
-42.08657,-20.74248,60,38,0,-22
-42.08387,-20.74248,60,33,5,-27
-42.08118,-20.74248,62,32,5,-30
-42.07825,-20.74248,60,35,5,-25
-42.07556,-20.74248,59,34,5,-25
-42.07286,-20.74248,57,33,5,-24
-42.06994,-20.74248,58,36,5,-22
-42.06724,-20.74248,57,35,5,-22
-42.06455,-20.74248,56,39,5,-17
-42.06163,-20.74248,50,40,5,-10
-42.05893,-20.74248,51,44,5,-7
-42.05601,-20.74248,51,45,5,-6
-42.05331,-20.74248,45,45,5,0
-42.05061,-20.74248,55,48,5,-7
-42.04769,-20.74248,52,50,5,-2
-42.045,-20.74248,48,47,5,-1
-42.0423,-20.74248,47,46,0,-1
-42.03938,-20.74248,43,49,0,6
-42.03668,-20.74248,31,45,5,14
-42.03399,-20.74248,44,43,2,-1
-42.03106,-20.74248,39,46,0,7
-42.02837,-20.74248,49,50,0,1
-42.02545,-20.74248,50,71,0,21
-42.02275,-20.74248,51,46,5,-5
-42.02005,-20.74248,53,47,11,-6
-42.01713,-20.74248,54,51,2,-3
-42.01444,-20.74248,54,47,0,-7
-42.01174,-20.74248,64,46,11,-18
-42.00882,-20.74248,64,51,0,-13
-42.00612,-20.74248,64,52,0,-12
-42.00342,-20.74248,69,48,0,-21
-42.0005,-20.74248,65,47,0,-18
-41.99781,-20.74248,63,41,5,-22
-41.99511,-20.74248,62,39,5,-23
-41.99219,-20.74248,68,47,5,-21
-41.98949,-20.74248,65,48,0,-17
-41.98657,-20.74248,58,42,0,-16
-41.98387,-20.74248,68,43,0,-25
-41.98118,-20.74248,67,45,0,-22
-41.97826,-20.74248,58,45,0,-13
-41.97556,-20.74248,57,33,5,-24
-41.97286,-20.74248,65,44,0,-21
-41.96994,-20.74248,54,46,0,-8
-42.1005,-20.74227,59,29,5,-30
-42.0978,-20.74227,59,24,5,-35
-42.09511,-20.74227,59,27,5,-32
-42.09219,-20.74227,61,28,5,-33
-42.08949,-20.74227,61,38,5,-23
-42.08657,-20.74227,60,38,0,-22
-42.08387,-20.74227,61,33,5,-28
-42.08118,-20.74227,62,32,5,-30
-42.07825,-20.74227,61,35,5,-26
-42.07556,-20.74227,61,33,5,-28
-42.07286,-20.74227,57,34,5,-23
-42.06994,-20.74227,58,36,5,-22
-42.06724,-20.74227,56,35,5,-21
-42.06455,-20.74227,56,41,5,-15
-42.06163,-20.74227,50,41,5,-9
-42.05893,-20.74227,48,44,5,-4
-42.05601,-20.74227,51,43,5,-8
-42.05331,-20.74227,45,45,5,0
-42.05061,-20.74227,51,47,5,-4
-42.04769,-20.74227,51,50,5,-1
-42.045,-20.74227,48,49,5,1
-42.0423,-20.74227,48,48,0,0
-42.03938,-20.74227,29,47,5,18
-42.03668,-20.74227,22,46,5,24
-42.03399,-20.74227,41,43,2,2
-42.03106,-20.74227,39,46,0,7
-42.02837,-20.74227,49,49,0,0
-42.02545,-20.74227,50,70,0,20
-42.02275,-20.74227,51,51,5,0
-42.02005,-20.74227,54,47,11,-7
-42.01713,-20.74227,54,51,2,-3
-42.01444,-20.74227,54,49,0,-5
-42.01174,-20.74227,59,48,11,-11
-42.00882,-20.74227,62,50,0,-12
-42.00612,-20.74227,66,52,0,-14
-42.00342,-20.74227,68,49,11,-19
-42.0005,-20.74227,63,47,0,-16
-41.99781,-20.74227,59,42,5,-17
-41.99511,-20.74227,63,39,5,-24
-41.99219,-20.74227,69,47,5,-22
-41.98949,-20.74227,65,48,0,-17
-41.98657,-20.74227,58,42,0,-16
-41.98387,-20.74227,67,43,0,-24
-41.98118,-20.74227,67,44,0,-23
-41.97826,-20.74227,58,45,0,-13
-41.97556,-20.74227,57,33,5,-24
-41.97286,-20.74227,63,44,0,-19
-41.96994,-20.74227,55,46,0,-9
-42.1005,-20.74185,59,27,5,-32
-42.0978,-20.74185,59,25,5,-34
-42.09511,-20.74185,59,26,5,-33
-42.09219,-20.74185,60,28,5,-32
-42.08949,-20.74185,62,29,5,-33
-42.08657,-20.74185,60,38,0,-22
-42.08387,-20.74185,61,37,5,-24
-42.08118,-20.74185,62,32,5,-30
-42.07825,-20.74185,61,36,5,-25
-42.07556,-20.74185,60,34,5,-26
-42.07286,-20.74185,56,34,5,-22
-42.06994,-20.74185,58,35,5,-23
-42.06724,-20.74185,54,37,5,-17
-42.06455,-20.74185,57,41,5,-16
-42.06163,-20.74185,50,40,5,-10
-42.05893,-20.74185,48,44,5,-4
-42.05601,-20.74185,50,44,5,-6
-42.05331,-20.74185,44,46,5,2
-42.05061,-20.74185,46,46,5,0
-42.04769,-20.74185,51,51,5,0
-42.045,-20.74185,50,50,5,0
-42.0423,-20.74185,49,49,0,0
-42.03938,-20.74185,19,44,5,25
-42.03668,-20.74185,18,54,0,36
-42.03399,-20.74185,40,43,2,3
-42.03106,-20.74185,39,42,0,3
-42.02837,-20.74185,48,48,0,0
-42.02545,-20.74185,50,67,0,17
-42.02275,-20.74185,52,51,5,-1
-42.02005,-20.74185,53,46,2,-7
-42.01713,-20.74185,54,48,11,-6
-42.01444,-20.74185,54,49,0,-5
-42.01174,-20.74185,58,49,0,-9
-42.00882,-20.74185,58,53,0,-5
-42.00612,-20.74185,67,52,0,-15
-42.00342,-20.74185,66,49,0,-17
-42.0005,-20.74185,62,47,0,-15
-41.99781,-20.74185,58,41,5,-17
-41.99511,-20.74185,64,39,5,-25
-41.99219,-20.74185,70,47,5,-23
-41.98949,-20.74185,67,48,0,-19
-41.98657,-20.74185,59,42,0,-17
-41.98387,-20.74185,68,43,0,-25
-41.98118,-20.74185,67,44,0,-23
-41.97826,-20.74185,59,45,0,-14
-41.97556,-20.74185,57,33,5,-24
-41.97286,-20.74185,57,45,0,-12
-41.96994,-20.74185,55,46,0,-9
-42.1005,-20.74164,59,26,5,-33
-42.0978,-20.74164,59,26,5,-33
-42.09511,-20.74164,59,27,5,-32
-42.09219,-20.74164,60,28,5,-32
-42.08949,-20.74164,63,29,5,-34
-42.08657,-20.74164,60,38,0,-22
-42.08387,-20.74164,61,37,5,-24
-42.08118,-20.74164,62,32,5,-30
-42.07825,-20.74164,61,35,5,-26
-42.07556,-20.74164,61,33,5,-28
-42.07286,-20.74164,56,34,5,-22
-42.06994,-20.74164,58,35,5,-23
-42.06724,-20.74164,54,35,5,-19
-42.06455,-20.74164,56,41,5,-15
-42.06163,-20.74164,51,40,5,-11
-42.05893,-20.74164,48,44,5,-4
-42.05601,-20.74164,49,44,5,-5
-42.05331,-20.74164,40,43,5,3
-42.05061,-20.74164,39,46,5,7
-42.04769,-20.74164,51,51,0,0
-42.045,-20.74164,52,50,5,-2
-42.0423,-20.74164,51,51,0,0
-42.03938,-20.74164,10,45,5,35
-42.03668,-20.74164,8,54,0,46
-42.03399,-20.74164,40,43,11,3
-42.03106,-20.74164,40,47,0,7
-42.02837,-20.74164,51,44,2,-7
-42.02545,-20.74164,50,67,0,17
-42.02275,-20.74164,53,53,5,0
-42.02005,-20.74164,52,52,2,0
-42.01713,-20.74164,55,49,11,-6
-42.01444,-20.74164,54,48,0,-6
-42.01174,-20.74164,60,49,0,-11
-42.00882,-20.74164,57,51,0,-6
-42.00612,-20.74164,73,52,0,-21
-42.00342,-20.74164,65,48,0,-17
-42.0005,-20.74164,60,47,0,-13
-41.99781,-20.74164,60,44,5,-16
-41.99511,-20.74164,65,38,5,-27
-41.99219,-20.74164,69,46,5,-23
-41.98949,-20.74164,67,48,0,-19
-41.98657,-20.74164,59,42,0,-17
-41.98387,-20.74164,67,43,0,-24
-41.98118,-20.74164,64,37,5,-27
-41.97826,-20.74164,60,44,0,-16
-41.97556,-20.74164,57,33,5,-24
-41.97286,-20.74164,57,45,0,-12
-41.96994,-20.74164,55,46,0,-9
-42.1005,-20.74143,59,26,5,-33
-42.0978,-20.74143,60,25,5,-35
-42.09511,-20.74143,59,27,5,-32
-42.09219,-20.74143,60,30,5,-30
-42.08949,-20.74143,63,32,5,-31
-42.08657,-20.74143,60,38,0,-22
-42.08387,-20.74143,61,34,5,-27
-42.08118,-20.74143,62,32,5,-30
-42.07825,-20.74143,61,35,5,-26
-42.07556,-20.74143,61,34,5,-27
-42.07286,-20.74143,56,34,5,-22
-42.06994,-20.74143,58,33,5,-25
-42.06724,-20.74143,56,38,5,-18
-42.06455,-20.74143,55,42,5,-13
-42.06163,-20.74143,51,41,5,-10
-42.05893,-20.74143,47,44,5,-3
-42.05601,-20.74143,49,44,5,-5
-42.05331,-20.74143,38,43,5,5
-42.05061,-20.74143,27,46,5,19
-42.04769,-20.74143,52,51,5,-1
-42.045,-20.74143,52,51,5,-1
-42.0423,-20.74143,52,52,0,0
-42.03938,-20.74143,15,45,5,30
-42.03668,-20.74143,8,54,0,46
-42.03399,-20.74143,39,44,11,5
-42.03106,-20.74143,40,46,11,6
-42.02837,-20.74143,49,45,2,-4
-42.02545,-20.74143,50,66,0,16
-42.02275,-20.74143,57,53,5,-4
-42.02005,-20.74143,52,51,11,-1
-42.01713,-20.74143,63,49,11,-14
-42.01444,-20.74143,54,47,0,-7
-42.01174,-20.74143,57,49,0,-8
-42.00882,-20.74143,58,51,0,-7
-42.00612,-20.74143,82,51,0,-31
-42.00342,-20.74143,65,46,0,-19
-42.0005,-20.74143,54,47,0,-7
-41.99781,-20.74143,59,48,5,-11
-41.99511,-20.74143,65,40,5,-25
-41.99219,-20.74143,67,47,5,-20
-41.98949,-20.74143,67,48,0,-19
-41.98657,-20.74143,61,42,0,-19
-41.98387,-20.74143,67,43,0,-24
-41.98118,-20.74143,62,36,5,-26
-41.97826,-20.74143,64,44,0,-20
-41.97556,-20.74143,58,33,5,-25
-41.97286,-20.74143,57,45,0,-12
-41.96994,-20.74143,55,46,0,-9
-42.1005,-20.74122,59,26,5,-33
-42.0978,-20.74122,60,28,5,-32
-42.09511,-20.74122,59,27,5,-32
-42.09219,-20.74122,60,32,5,-28
-42.08949,-20.74122,63,31,5,-32
-42.08657,-20.74122,60,38,5,-22
-42.08387,-20.74122,61,33,5,-28
-42.08118,-20.74122,63,29,5,-34
-42.07825,-20.74122,61,35,5,-26
-42.07556,-20.74122,61,34,5,-27
-42.07286,-20.74122,56,34,5,-22
-42.06994,-20.74122,58,33,5,-25
-42.06724,-20.74122,57,39,5,-18
-42.06455,-20.74122,55,41,5,-14
-42.06163,-20.74122,47,42,5,-5
-42.05893,-20.74122,47,49,5,2
-42.05601,-20.74122,45,44,5,-1
-42.05331,-20.74122,41,43,5,2
-42.05061,-20.74122,27,46,5,19
-42.04769,-20.74122,48,48,5,0
-42.045,-20.74122,51,51,5,0
-42.0423,-20.74122,44,47,0,3
-42.03938,-20.74122,19,51,0,32
-42.03668,-20.74122,17,54,0,37
-42.03399,-20.74122,37,45,2,8
-42.03106,-20.74122,41,42,2,1
-42.02837,-20.74122,37,41,11,4
-42.02545,-20.74122,52,65,0,13
-42.02275,-20.74122,55,53,5,-2
-42.02005,-20.74122,52,51,11,-1
-42.01713,-20.74122,65,49,2,-16
-42.01444,-20.74122,54,47,0,-7
-42.01174,-20.74122,53,51,0,-2
-42.00882,-20.74122,59,51,0,-8
-42.00612,-20.74122,83,51,0,-32
-42.00342,-20.74122,65,45,0,-20
-42.0005,-20.74122,53,47,0,-6
-41.99781,-20.74122,60,48,5,-12
-41.99511,-20.74122,65,39,5,-26
-41.99219,-20.74122,66,45,5,-21
-41.98949,-20.74122,66,48,0,-18
-41.98657,-20.74122,61,43,0,-18
-41.98387,-20.74122,67,44,0,-23
-41.98118,-20.74122,63,36,5,-27
-41.97826,-20.74122,63,44,0,-19
-41.97556,-20.74122,58,32,5,-26
-41.97286,-20.74122,57,45,0,-12
-41.96994,-20.74122,55,44,0,-11
-42.1005,-20.74079,59,25,5,-34
-42.0978,-20.74079,60,28,0,-32
-42.09511,-20.74079,59,26,5,-33
-42.09219,-20.74079,61,32,5,-29
-42.08949,-20.74079,61,29,5,-32
-42.08657,-20.74079,60,33,5,-27
-42.08387,-20.74079,61,33,5,-28
-42.08118,-20.74079,63,28,5,-35
-42.07825,-20.74079,61,35,5,-26
-42.07556,-20.74079,62,34,5,-28
-42.07286,-20.74079,57,34,5,-23
-42.06994,-20.74079,58,34,5,-24
-42.06724,-20.74079,56,39,5,-17
-42.06455,-20.74079,54,42,5,-12
-42.06163,-20.74079,45,42,5,-3
-42.05893,-20.74079,46,46,0,0
-42.05601,-20.74079,44,43,5,-1
-42.05331,-20.74079,38,43,5,5
-42.05061,-20.74079,30,47,5,17
-42.04769,-20.74079,48,48,5,0
-42.045,-20.74079,51,51,5,0
-42.0423,-20.74079,41,50,0,9
-42.03938,-20.74079,24,53,0,29
-42.03668,-20.74079,17,54,0,37
-42.03399,-20.74079,34,44,2,10
-42.03106,-20.74079,41,42,2,1
-42.02837,-20.74079,37,45,11,8
-42.02545,-20.74079,52,57,0,5
-42.02275,-20.74079,53,53,2,0
-42.02005,-20.74079,54,47,2,-7
-42.01713,-20.74079,65,47,2,-18
-42.01444,-20.74079,55,46,0,-9
-42.01174,-20.74079,53,51,0,-2
-42.00882,-20.74079,60,52,0,-8
-42.00612,-20.74079,83,49,0,-34
-42.00342,-20.74079,65,44,0,-21
-42.0005,-20.74079,53,46,0,-7
-41.99781,-20.74079,60,44,5,-16
-41.99511,-20.74079,66,44,5,-22
-41.99219,-20.74079,65,41,5,-24
-41.98949,-20.74079,66,47,0,-19
-41.98657,-20.74079,62,42,0,-20
-41.98387,-20.74079,66,44,0,-22
-41.98118,-20.74079,66,44,5,-22
-41.97826,-20.74079,64,44,0,-20
-41.97556,-20.74079,58,45,5,-13
-41.97286,-20.74079,57,45,0,-12
-41.96994,-20.74079,56,45,0,-11
-42.1005,-20.74058,59,25,5,-34
-42.0978,-20.74058,60,29,0,-31
-42.09511,-20.74058,59,26,5,-33
-42.09219,-20.74058,61,32,5,-29
-42.08949,-20.74058,59,32,5,-27
-42.08657,-20.74058,61,33,5,-28
-42.08387,-20.74058,61,36,5,-25
-42.08118,-20.74058,61,28,5,-33
-42.07825,-20.74058,61,36,5,-25
-42.07556,-20.74058,62,34,5,-28
-42.07286,-20.74058,57,34,5,-23
-42.06994,-20.74058,57,34,5,-23
-42.06724,-20.74058,57,40,5,-17
-42.06455,-20.74058,53,42,5,-11
-42.06163,-20.74058,47,41,5,-6
-42.05893,-20.74058,46,47,0,1
-42.05601,-20.74058,42,42,5,0
-42.05331,-20.74058,34,43,5,9
-42.05061,-20.74058,31,47,5,16
-42.04769,-20.74058,47,47,5,0
-42.045,-20.74058,53,53,5,0
-42.0423,-20.74058,40,50,0,10
-42.03938,-20.74058,29,52,11,23
-42.03668,-20.74058,13,54,0,41
-42.03399,-20.74058,31,43,2,12
-42.03106,-20.74058,41,46,11,5
-42.02837,-20.74058,45,48,11,3
-42.02545,-20.74058,51,52,0,1
-42.02275,-20.74058,56,53,11,-3
-42.02005,-20.74058,58,45,2,-13
-42.01713,-20.74058,65,49,2,-16
-42.01444,-20.74058,55,47,0,-8
-42.01174,-20.74058,53,51,0,-2
-42.00882,-20.74058,60,45,5,-15
-42.00612,-20.74058,83,47,0,-36
-42.00342,-20.74058,63,45,0,-18
-42.0005,-20.74058,54,46,11,-8
-41.99781,-20.74058,61,46,5,-15
-41.99511,-20.74058,66,42,5,-24
-41.99219,-20.74058,64,41,5,-23
-41.98949,-20.74058,66,47,0,-19
-41.98657,-20.74058,64,42,0,-22
-41.98387,-20.74058,67,44,0,-23
-41.98118,-20.74058,72,44,11,-28
-41.97826,-20.74058,65,44,0,-21
-41.97556,-20.74058,58,45,0,-13
-41.97286,-20.74058,57,45,0,-12
-41.96994,-20.74058,56,45,0,-11
-42.1005,-20.74037,59,25,5,-34
-42.0978,-20.74037,60,29,0,-31
-42.09511,-20.74037,65,25,5,-40
-42.09219,-20.74037,60,33,5,-27
-42.08949,-20.74037,59,32,5,-27
-42.08657,-20.74037,60,32,5,-28
-42.08387,-20.74037,61,36,0,-25
-42.08118,-20.74037,60,31,5,-29
-42.07825,-20.74037,61,34,5,-27
-42.07556,-20.74037,62,34,5,-28
-42.07286,-20.74037,56,33,5,-23
-42.06994,-20.74037,56,35,5,-21
-42.06724,-20.74037,57,40,5,-17
-42.06455,-20.74037,52,42,5,-10
-42.06163,-20.74037,47,41,5,-6
-42.05893,-20.74037,45,45,0,0
-42.05601,-20.74037,41,41,5,0
-42.05331,-20.74037,36,43,5,7
-42.05061,-20.74037,31,48,5,17
-42.04769,-20.74037,38,47,5,9
-42.045,-20.74037,45,50,5,5
-42.0423,-20.74037,40,50,0,10
-42.03938,-20.74037,30,52,0,22
-42.03668,-20.74037,16,54,0,38
-42.03399,-20.74037,32,44,2,12
-42.03106,-20.74037,41,47,2,6
-42.02837,-20.74037,37,50,11,13
-42.02545,-20.74037,51,49,0,-2
-42.02275,-20.74037,54,53,2,-1
-42.02005,-20.74037,54,42,6,-12
-42.01713,-20.74037,67,46,2,-21
-42.01444,-20.74037,56,48,0,-8
-42.01174,-20.74037,53,49,5,-4
-42.00882,-20.74037,61,45,5,-16
-42.00612,-20.74037,83,45,5,-38
-42.00342,-20.74037,62,45,0,-17
-42.0005,-20.74037,54,46,11,-8
-41.99781,-20.74037,61,46,5,-15
-41.99511,-20.74037,65,44,5,-21
-41.99219,-20.74037,63,41,5,-22
-41.98949,-20.74037,67,47,0,-20
-41.98657,-20.74037,65,42,0,-23
-41.98387,-20.74037,68,44,0,-24
-41.98118,-20.74037,75,44,0,-31
-41.97826,-20.74037,74,42,0,-32
-41.97556,-20.74037,58,45,0,-13
-41.97286,-20.74037,57,42,0,-15
-41.96994,-20.74037,56,46,0,-10
-42.10297,-20.73995,60,34,5,-26
-42.10275,-20.73995,60,28,5,-32
-42.10252,-20.73995,60,27,5,-33
-42.1023,-20.73995,60,26,5,-34
-42.10185,-20.73995,60,25,5,-35
-42.10163,-20.73995,60,24,5,-36
-42.1014,-20.73995,60,25,5,-35
-42.10118,-20.73995,60,25,5,-35
-42.10073,-20.73995,60,25,5,-35
-42.1005,-20.73995,59,25,5,-34
-42.10028,-20.73995,59,26,5,-33
-42.10005,-20.73995,59,26,5,-33
-42.09983,-20.73995,59,26,5,-33
-42.09938,-20.73995,60,27,5,-33
-42.09915,-20.73995,60,27,5,-33
-42.09893,-20.73995,60,27,5,-33
-42.0987,-20.73995,60,30,5,-30
-42.09825,-20.73995,60,30,5,-30
-42.09803,-20.73995,60,30,5,-30
-42.0978,-20.73995,60,30,0,-30
-42.09758,-20.73995,60,30,5,-30
-42.09713,-20.73995,60,26,5,-34
-42.09691,-20.73995,60,26,5,-34
-42.09668,-20.73995,61,26,5,-35
-42.09646,-20.73995,62,25,5,-37
-42.09601,-20.73995,63,25,5,-38
-42.09578,-20.73995,66,25,5,-41
-42.09556,-20.73995,65,25,5,-40
-42.09533,-20.73995,65,27,5,-38
-42.09511,-20.73995,62,27,5,-35
-42.09466,-20.73995,63,26,5,-37
-42.09443,-20.73995,59,26,5,-33
-42.09421,-20.73995,59,26,5,-33
-42.09398,-20.73995,59,27,5,-32
-42.09354,-20.73995,59,29,5,-30
-42.09331,-20.73995,59,33,5,-26
-42.09309,-20.73995,60,33,5,-27
-42.09286,-20.73995,60,33,5,-27
-42.09241,-20.73995,60,33,5,-27
-42.09219,-20.73995,60,34,5,-26
-42.09196,-20.73995,62,33,5,-29
-42.09174,-20.73995,63,34,5,-29
-42.09129,-20.73995,66,35,5,-31
-42.09106,-20.73995,66,40,5,-26
-42.09084,-20.73995,67,34,5,-33
-42.09061,-20.73995,66,33,5,-33
-42.09039,-20.73995,65,33,5,-32
-42.08994,-20.73995,65,33,5,-32
-42.08972,-20.73995,60,28,5,-32
-42.08949,-20.73995,59,32,5,-27
-42.08927,-20.73995,59,33,5,-26
-42.08882,-20.73995,60,33,5,-27
-42.08859,-20.73995,60,32,5,-28
-42.08837,-20.73995,60,34,5,-26
-42.08814,-20.73995,60,34,5,-26
-42.08769,-20.73995,60,28,5,-32
-42.08747,-20.73995,60,30,5,-30
-42.08724,-20.73995,60,30,5,-30
-42.08702,-20.73995,60,33,5,-27
-42.08657,-20.73995,61,33,5,-28
-42.08634,-20.73995,61,32,5,-29
-42.08612,-20.73995,61,31,5,-30
-42.08589,-20.73995,60,33,5,-27
-42.08545,-20.73995,60,37,5,-23
-42.08522,-20.73995,61,37,0,-24
-42.085,-20.73995,61,37,0,-24
-42.08477,-20.73995,61,37,0,-24
-42.08455,-20.73995,61,37,0,-24
-42.0841,-20.73995,61,36,5,-25
-42.08387,-20.73995,62,34,5,-28
-42.08365,-20.73995,62,34,5,-28
-42.08342,-20.73995,63,33,5,-30
-42.08297,-20.73995,65,32,5,-33
-42.08275,-20.73995,65,30,5,-35
-42.08252,-20.73995,66,28,5,-38
-42.0823,-20.73995,62,28,5,-34
-42.08185,-20.73995,61,27,5,-34
-42.08163,-20.73995,60,28,5,-32
-42.0814,-20.73995,60,32,5,-28
-42.08118,-20.73995,60,32,5,-28
-42.08073,-20.73995,60,33,5,-27
-42.0805,-20.73995,60,34,5,-26
-42.08028,-20.73995,61,34,5,-27
-42.08005,-20.73995,61,34,5,-27
-42.07983,-20.73995,61,34,5,-27
-42.07938,-20.73995,62,34,5,-28
-42.07915,-20.73995,61,33,5,-28
-42.07893,-20.73995,62,32,5,-30
-42.0787,-20.73995,61,32,5,-29
-42.07825,-20.73995,61,34,5,-27
-42.07803,-20.73995,62,36,5,-26
-42.07781,-20.73995,61,37,5,-24
-42.07758,-20.73995,61,37,5,-24
-42.07713,-20.73995,61,36,5,-25
-42.07691,-20.73995,61,36,5,-25
-42.07668,-20.73995,62,36,5,-26
-42.07646,-20.73995,62,36,5,-26
-42.07601,-20.73995,63,34,5,-29
-42.07578,-20.73995,63,34,5,-29
-42.07556,-20.73995,63,34,5,-29
-42.07533,-20.73995,62,34,5,-28
-42.07511,-20.73995,61,34,5,-27
-42.07466,-20.73995,60,33,5,-27
-42.07443,-20.73995,58,34,5,-24
-42.07421,-20.73995,57,34,5,-23
-42.07399,-20.73995,56,34,5,-22
-42.07354,-20.73995,56,33,5,-23
-42.07331,-20.73995,56,33,5,-23
-42.07309,-20.73995,56,34,5,-22
-42.07286,-20.73995,56,34,5,-22
-42.07241,-20.73995,57,32,5,-25
-42.07219,-20.73995,56,32,5,-24
-42.07196,-20.73995,56,33,5,-23
-42.07174,-20.73995,56,33,5,-23
-42.07129,-20.73995,57,33,5,-24
-42.07106,-20.73995,57,34,5,-23
-42.07084,-20.73995,56,37,5,-19
-42.07061,-20.73995,56,37,5,-19
-42.07039,-20.73995,56,37,5,-19
-42.06994,-20.73995,56,35,5,-21
-42.06972,-20.73995,56,36,5,-20
-42.06949,-20.73995,58,36,5,-22
-42.06927,-20.73995,59,36,5,-23
-42.06882,-20.73995,61,36,5,-25
-42.06859,-20.73995,57,36,5,-21
-42.06837,-20.73995,57,37,5,-20
-42.06814,-20.73995,57,38,5,-19
-42.06769,-20.73995,57,38,5,-19
-42.06747,-20.73995,57,38,5,-19
-42.06724,-20.73995,58,38,5,-20
-42.06702,-20.73995,55,38,5,-17
-42.06657,-20.73995,54,39,5,-15
-42.06634,-20.73995,52,40,5,-12
-42.06612,-20.73995,52,40,5,-12
-42.0659,-20.73995,51,41,5,-10
-42.06545,-20.73995,51,42,5,-9
-42.06522,-20.73995,51,44,5,-7
-42.065,-20.73995,51,42,5,-9
-42.06477,-20.73995,51,41,5,-10
-42.06455,-20.73995,51,41,5,-10
-42.0641,-20.73995,52,42,5,-10
-42.06387,-20.73995,52,42,5,-10
-42.06365,-20.73995,53,41,5,-12
-42.06342,-20.73995,54,42,5,-12
-42.06297,-20.73995,54,42,5,-12
-42.06275,-20.73995,55,44,5,-11
-42.06252,-20.73995,53,44,5,-9
-42.0623,-20.73995,53,45,0,-8
-42.06185,-20.73995,52,41,5,-11
-42.06163,-20.73995,46,41,5,-5
-42.0614,-20.73995,44,41,5,-3
-42.06118,-20.73995,43,41,5,-2
-42.06073,-20.73995,43,42,5,-1
-42.0605,-20.73995,43,42,5,-1
-42.06028,-20.73995,44,42,5,-2
-42.06005,-20.73995,44,42,5,-2
-42.05983,-20.73995,44,45,5,1
-42.05938,-20.73995,45,45,0,0
-42.05915,-20.73995,45,46,0,1
-42.05893,-20.73995,45,46,0,1
-42.0587,-20.73995,44,43,0,-1
-42.05826,-20.73995,44,43,5,-1
-42.05803,-20.73995,44,42,5,-2
-42.05781,-20.73995,43,41,5,-2
-42.05758,-20.73995,43,43,5,0
-42.05713,-20.73995,43,43,5,0
-42.05691,-20.73995,43,41,5,-2
-42.05668,-20.73995,44,42,5,-2
-42.05646,-20.73995,43,43,5,0
-42.05601,-20.73995,41,42,5,1
-42.05578,-20.73995,38,42,5,4
-42.05556,-20.73995,33,42,5,9
-42.05533,-20.73995,25,42,5,17
-42.05511,-20.73995,25,42,5,17
-42.05466,-20.73995,26,44,5,18
-42.05443,-20.73995,28,43,5,15
-42.05421,-20.73995,28,43,5,15
-42.05399,-20.73995,35,43,5,8
-42.05354,-20.73995,34,43,5,9
-42.05331,-20.73995,37,42,5,5
-42.05309,-20.73995,39,42,5,3
-42.05286,-20.73995,44,43,5,-1
-42.05241,-20.73995,41,43,5,2
-42.05219,-20.73995,37,43,5,6
-42.05196,-20.73995,38,44,5,6
-42.05174,-20.73995,35,44,5,9
-42.05129,-20.73995,25,47,5,22
-42.05106,-20.73995,27,48,5,21
-42.05084,-20.73995,19,49,5,30
-42.05061,-20.73995,36,49,5,13
-42.05039,-20.73995,36,49,5,13
-42.04994,-20.73995,38,49,5,11
-42.04972,-20.73995,29,49,5,20
-42.04949,-20.73995,27,49,5,22
-42.04927,-20.73995,27,48,5,21
-42.04882,-20.73995,27,49,5,22
-42.04859,-20.73995,27,48,5,21
-42.04837,-20.73995,27,48,5,21
-42.04814,-20.73995,27,48,5,21
-42.04769,-20.73995,27,47,5,20
-42.04747,-20.73995,26,48,5,22
-42.04724,-20.73995,26,48,5,22
-42.04702,-20.73995,26,48,5,22
-42.04657,-20.73995,26,49,5,23
-42.04635,-20.73995,27,49,5,22
-42.04612,-20.73995,31,48,5,17
-42.0459,-20.73995,36,48,5,12
-42.04545,-20.73995,32,49,5,17
-42.04522,-20.73995,38,49,5,11
-42.045,-20.73995,39,49,5,10
-42.04477,-20.73995,36,49,5,13
-42.04455,-20.73995,37,49,0,12
-42.0441,-20.73995,37,57,0,20
-42.04387,-20.73995,37,57,0,20
-42.04365,-20.73995,38,51,0,13
-42.04342,-20.73995,38,56,0,18
-42.04297,-20.73995,37,68,0,31
-42.04275,-20.73995,40,60,0,20
-42.04253,-20.73995,39,55,0,16
-42.0423,-20.73995,41,51,0,10
-42.04185,-20.73995,42,51,0,9
-42.04163,-20.73995,41,53,0,12
-42.0414,-20.73995,40,52,0,12
-42.04118,-20.73995,41,52,0,11
-42.04073,-20.73995,40,52,0,12
-42.0405,-20.73995,38,52,0,14
-42.04028,-20.73995,36,52,0,16
-42.04005,-20.73995,36,51,0,15
-42.03983,-20.73995,36,51,0,15
-42.03938,-20.73995,34,52,0,18
-42.03915,-20.73995,33,55,0,22
-42.03893,-20.73995,33,56,0,23
-42.0387,-20.73995,31,57,0,26
-42.03826,-20.73995,27,56,0,29
-42.03803,-20.73995,24,56,0,32
-42.03781,-20.73995,27,53,0,26
-42.03758,-20.73995,24,53,0,29
-42.03713,-20.73995,17,54,0,37
-42.03691,-20.73995,17,54,0,37
-42.03668,-20.73995,19,54,0,35
-42.03646,-20.73995,17,54,0,37
-42.03601,-20.73995,18,46,0,28
-42.03578,-20.73995,16,46,5,30
-42.03556,-20.73995,16,46,5,30
-42.03533,-20.73995,19,48,5,29
-42.03511,-20.73995,19,48,5,29
-42.03466,-20.73995,20,48,5,28
-42.03444,-20.73995,24,47,11,23
-42.03421,-20.73995,28,47,5,19
-42.03399,-20.73995,33,44,2,11
-42.03354,-20.73995,37,44,2,7
-42.03331,-20.73995,38,41,11,3
-42.03309,-20.73995,41,40,11,-1
-42.03286,-20.73995,41,43,2,2
-42.03241,-20.73995,41,41,2,0
-42.03219,-20.73995,41,41,11,0
-42.03196,-20.73995,40,40,2,0
-42.03174,-20.73995,41,41,2,0
-42.03129,-20.73995,41,45,2,4
-42.03106,-20.73995,41,45,11,4
-42.03084,-20.73995,40,42,11,2
-42.03062,-20.73995,41,46,2,5
-42.03017,-20.73995,40,44,2,4
-42.02994,-20.73995,40,42,11,2
-42.02972,-20.73995,40,46,11,6
-42.02949,-20.73995,40,54,11,14
-42.02927,-20.73995,39,51,0,12
-42.02882,-20.73995,38,62,11,24
-42.02859,-20.73995,37,50,0,13
-42.02837,-20.73995,37,50,2,13
-42.02814,-20.73995,37,50,11,13
-42.02769,-20.73995,37,47,2,10
-42.02747,-20.73995,38,47,2,9
-42.02724,-20.73995,38,47,2,9
-42.02702,-20.73995,40,47,2,7
-42.02657,-20.73995,41,48,2,7
-42.02635,-20.73995,42,48,11,6
-42.02612,-20.73995,48,53,5,5
-42.0259,-20.73995,51,53,5,2
-42.02545,-20.73995,49,57,0,8
-42.02522,-20.73995,52,56,0,4
-42.025,-20.73995,50,47,0,-3
-42.02477,-20.73995,50,50,2,0
-42.02455,-20.73995,52,52,2,0
-42.0241,-20.73995,55,53,2,-2
-42.02387,-20.73995,55,52,11,-3
-42.02365,-20.73995,55,52,11,-3
-42.02342,-20.73995,54,52,2,-2
-42.02297,-20.73995,54,49,2,-5
-42.02275,-20.73995,55,50,11,-5
-42.02253,-20.73995,54,56,11,2
-42.0223,-20.73995,55,56,11,1
-42.02185,-20.73995,54,52,6,-2
-42.02163,-20.73995,54,51,6,-3
-42.0214,-20.73995,53,48,6,-5
-42.02118,-20.73995,52,47,6,-5
-42.02073,-20.73995,52,47,6,-5
-42.0205,-20.73995,53,43,6,-10
-42.02028,-20.73995,52,43,6,-9
-42.02005,-20.73995,54,40,2,-14
-42.01983,-20.73995,55,40,2,-15
-42.01938,-20.73995,55,41,11,-14
-42.01915,-20.73995,55,41,11,-14
-42.01893,-20.73995,59,42,2,-17
-42.01871,-20.73995,65,43,2,-22
-42.01826,-20.73995,67,44,2,-23
-42.01803,-20.73995,62,44,2,-18
-42.01781,-20.73995,68,42,2,-26
-42.01758,-20.73995,69,45,2,-24
-42.01713,-20.73995,68,47,2,-21
-42.01691,-20.73995,66,47,11,-19
-42.01668,-20.73995,68,49,2,-19
-42.01646,-20.73995,67,49,11,-18
-42.01601,-20.73995,66,53,11,-13
-42.01578,-20.73995,66,55,2,-11
-42.01556,-20.73995,68,55,11,-13
-42.01533,-20.73995,68,56,11,-12
-42.01511,-20.73995,69,52,2,-17
-42.01466,-20.73995,58,51,0,-7
-42.01444,-20.73995,56,49,0,-7
-42.01421,-20.73995,54,48,5,-6
-42.01399,-20.73995,54,45,5,-9
-42.01354,-20.73995,53,43,5,-10
-42.01331,-20.73995,53,43,5,-10
-42.01309,-20.73995,53,43,5,-10
-42.01286,-20.73995,56,43,5,-13
-42.01241,-20.73995,57,44,5,-13
-42.01219,-20.73995,57,44,5,-13
-42.01196,-20.73995,56,44,5,-12
-42.01174,-20.73995,52,43,5,-9
-42.01129,-20.73995,52,50,0,-2
-42.01106,-20.73995,53,52,0,-1
-42.01084,-20.73995,55,52,0,-3
-42.01062,-20.73995,56,53,0,-3
-42.01017,-20.73995,59,53,0,-6
-42.00994,-20.73995,60,53,0,-7
-42.00972,-20.73995,61,53,0,-8
-42.00949,-20.73995,61,53,5,-8
-42.00927,-20.73995,62,53,5,-9
-42.00882,-20.73995,62,44,5,-18
-42.00859,-20.73995,62,43,5,-19
-42.00837,-20.73995,63,43,5,-20
-42.00814,-20.73995,64,43,5,-21
-42.00769,-20.73995,66,42,5,-24
-42.00747,-20.73995,67,42,5,-25
-42.00724,-20.73995,68,42,5,-26
-42.00702,-20.73995,69,42,5,-27
-42.00657,-20.73995,70,42,5,-28
-42.00635,-20.73995,70,42,5,-28
-42.00612,-20.73995,73,42,5,-31
-42.0059,-20.73995,77,42,5,-35
-42.00545,-20.73995,83,45,0,-38
-42.00522,-20.73995,83,45,0,-38
-42.005,-20.73995,83,44,0,-39
-42.00477,-20.73995,83,45,0,-38
-42.00455,-20.73995,83,45,0,-38
-42.0041,-20.73995,83,46,0,-37
-42.00387,-20.73995,68,46,0,-22
-42.00365,-20.73995,63,46,0,-17
-42.00342,-20.73995,61,47,0,-14
-42.00298,-20.73995,60,47,0,-13
-42.00275,-20.73995,60,47,0,-13
-42.00253,-20.73995,61,47,0,-14
-42.0023,-20.73995,62,47,0,-15
-42.00185,-20.73995,60,44,0,-16
-42.00163,-20.73995,60,44,0,-16
-42.0014,-20.73995,59,44,0,-15
-42.00118,-20.73995,56,45,0,-11
-42.00073,-20.73995,55,46,0,-9
-42.0005,-20.73995,54,46,11,-8
-42.00028,-20.73995,57,46,0,-11
-42.00005,-20.73995,54,46,0,-8
-41.99983,-20.73995,54,46,11,-8
-41.99938,-20.73995,57,46,11,-11
-41.99916,-20.73995,54,46,11,-8
-41.99893,-20.73995,55,46,11,-9
-41.99871,-20.73995,55,46,11,-9
-41.99826,-20.73995,57,46,0,-11
-41.99803,-20.73995,64,46,0,-18
-41.99781,-20.73995,61,46,0,-15
-41.99758,-20.73995,65,46,0,-19
-41.99713,-20.73995,64,46,0,-18
-41.99691,-20.73995,63,46,0,-17
-41.99668,-20.73995,64,46,0,-18
-41.99646,-20.73995,63,46,0,-17
-41.99601,-20.73995,63,46,5,-17
-41.99578,-20.73995,64,46,5,-18
-41.99556,-20.73995,64,46,5,-18
-41.99533,-20.73995,64,46,5,-18
-41.99511,-20.73995,64,46,5,-18
-41.99466,-20.73995,65,44,5,-21
-41.99444,-20.73995,65,44,5,-21
-41.99421,-20.73995,65,44,5,-21
-41.99399,-20.73995,65,44,5,-21
-41.99354,-20.73995,65,40,5,-25
-41.99331,-20.73995,65,42,5,-23
-41.99309,-20.73995,65,42,5,-23
-41.99286,-20.73995,64,41,5,-23
-41.99241,-20.73995,64,42,5,-22
-41.99219,-20.73995,64,41,5,-23
-41.99196,-20.73995,63,41,5,-22
-41.99174,-20.73995,63,46,5,-17
-41.99129,-20.73995,62,47,0,-15
-41.99107,-20.73995,60,47,0,-13
-41.99084,-20.73995,59,47,0,-12
-41.99062,-20.73995,64,47,0,-17
-41.99017,-20.73995,64,47,0,-17
-41.98994,-20.73995,66,47,0,-19
-41.98972,-20.73995,67,46,0,-21
-41.98949,-20.73995,67,45,0,-22
-41.98927,-20.73995,68,43,0,-25
-41.98882,-20.73995,68,42,0,-26
-41.98859,-20.73995,68,40,0,-28
-41.98837,-20.73995,68,41,0,-27
-41.98814,-20.73995,69,41,0,-28
-41.98769,-20.73995,70,42,0,-28
-41.98747,-20.73995,70,42,0,-28
-41.98725,-20.73995,69,42,0,-27
-41.98702,-20.73995,68,43,0,-25
-41.98657,-20.73995,67,43,0,-24
-41.98635,-20.73995,66,43,0,-23
-41.98612,-20.73995,66,43,0,-23
-41.9859,-20.73995,69,43,0,-26
-41.98545,-20.73995,69,44,0,-25
-41.98522,-20.73995,65,44,0,-21
-41.985,-20.73995,66,44,0,-22
-41.98477,-20.73995,65,44,0,-21
-41.98455,-20.73995,65,44,0,-21
-41.9841,-20.73995,66,44,0,-22
-41.98387,-20.73995,68,44,0,-24
-41.98365,-20.73995,69,44,0,-25
-41.98343,-20.73995,69,44,0,-25
-41.98298,-20.73995,69,44,11,-25
-41.98275,-20.73995,70,44,0,-26
-41.98253,-20.73995,71,44,0,-27
-41.9823,-20.73995,80,44,0,-36
-41.98185,-20.73995,75,44,0,-31
-41.98163,-20.73995,75,44,0,-31
-41.9814,-20.73995,75,44,0,-31
-41.98118,-20.73995,75,44,0,-31
-41.98073,-20.73995,75,44,0,-31
-41.9805,-20.73995,74,45,0,-29
-41.98028,-20.73995,74,41,0,-33
-41.98005,-20.73995,74,41,0,-33
-41.97983,-20.73995,74,38,0,-36
-41.97938,-20.73995,74,39,0,-35
-41.97916,-20.73995,68,40,0,-28
-41.97893,-20.73995,66,40,0,-26
-41.97871,-20.73995,75,40,0,-35
-41.97826,-20.73995,73,41,11,-32
-41.97803,-20.73995,73,41,0,-32
-41.97781,-20.73995,64,41,0,-23
-41.97758,-20.73995,60,42,0,-18
-41.97713,-20.73995,59,42,0,-17
-41.97691,-20.73995,59,43,0,-16
-41.97668,-20.73995,58,44,0,-14
-41.97646,-20.73995,58,45,0,-13
-41.97601,-20.73995,59,45,0,-14
-41.97578,-20.73995,59,45,0,-14
-41.97556,-20.73995,58,45,0,-13
-41.97534,-20.73995,58,42,0,-16
-41.97511,-20.73995,58,42,0,-16
-41.97466,-20.73995,58,43,0,-15
-41.97444,-20.73995,57,43,0,-14
-41.97421,-20.73995,57,42,0,-15
-41.97399,-20.73995,57,42,0,-15
-41.97354,-20.73995,57,43,0,-14
-41.97331,-20.73995,57,43,0,-14
-41.97309,-20.73995,57,43,0,-14
-41.97286,-20.73995,57,43,0,-14
-41.97241,-20.73995,57,44,0,-13
-41.97219,-20.73995,57,44,0,-13
-41.97196,-20.73995,57,44,0,-13
-41.97174,-20.73995,56,44,0,-12
-41.97129,-20.73995,56,44,0,-12
-41.97107,-20.73995,56,44,0,-12
-41.97084,-20.73995,56,45,0,-11
-41.97062,-20.73995,56,45,11,-11
-41.97017,-20.73995,56,46,0,-10
-41.96994,-20.73995,56,46,0,-10
-41.96972,-20.73995,56,46,0,-10
-41.96949,-20.73995,56,46,0,-10
-41.96927,-20.73995,55,46,0,-9
-42.1005,-20.73974,60,25,5,-35
-42.0978,-20.73974,60,30,5,-30
-42.09511,-20.73974,61,27,5,-34
-42.09219,-20.73974,60,37,5,-23
-42.08949,-20.73974,60,32,5,-28
-42.08657,-20.73974,61,32,5,-29
-42.08387,-20.73974,62,34,5,-28
-42.08118,-20.73974,60,32,5,-28
-42.07825,-20.73974,62,34,5,-28
-42.07556,-20.73974,64,34,5,-30
-42.07286,-20.73974,56,34,5,-22
-42.06994,-20.73974,56,35,5,-21
-42.06724,-20.73974,59,38,5,-21
-42.06455,-20.73974,51,41,5,-10
-42.06163,-20.73974,47,49,5,2
-42.05893,-20.73974,45,46,5,1
-42.05601,-20.73974,40,41,5,1
-42.05331,-20.73974,30,43,5,13
-42.05061,-20.73974,28,49,5,21
-42.04769,-20.73974,9,48,5,39
-42.045,-20.73974,32,49,5,17
-42.0423,-20.73974,41,56,0,15
-42.03938,-20.73974,36,52,0,16
-42.03668,-20.73974,21,54,0,33
-42.03399,-20.73974,35,43,11,8
-42.03106,-20.73974,40,42,11,2
-42.02837,-20.73974,37,50,2,13
-42.02545,-20.73974,44,55,0,11
-42.02275,-20.73974,55,49,2,-6
-42.02005,-20.73974,58,40,2,-18
-42.01713,-20.73974,68,50,11,-18
-42.01444,-20.73974,55,48,0,-7
-42.01174,-20.73974,52,44,5,-8
-42.00882,-20.73974,63,44,5,-19
-42.00612,-20.73974,70,43,5,-27
-42.00342,-20.73974,59,47,0,-12
-42.0005,-20.73974,60,46,11,-14
-41.99781,-20.73974,61,46,0,-15
-41.99511,-20.73974,64,46,0,-18
-41.99219,-20.73974,64,44,5,-20
-41.98949,-20.73974,68,44,0,-24
-41.98657,-20.73974,76,43,0,-33
-41.98387,-20.73974,75,44,0,-31
-41.98118,-20.73974,66,45,0,-21
-41.97826,-20.73974,63,41,0,-22
-41.97556,-20.73974,59,42,0,-17
-41.97286,-20.73974,57,44,0,-13
-41.96994,-20.73974,56,46,0,-10
-42.1005,-20.73953,60,25,5,-35
-42.0978,-20.73953,60,27,5,-33
-42.09511,-20.73953,60,27,5,-33
-42.09219,-20.73953,60,40,5,-20
-42.08949,-20.73953,60,30,5,-30
-42.08657,-20.73953,61,31,5,-30
-42.08387,-20.73953,62,32,5,-30
-42.08118,-20.73953,60,32,5,-28
-42.07825,-20.73953,62,33,5,-29
-42.07556,-20.73953,64,34,5,-30
-42.07286,-20.73953,56,33,5,-23
-42.06994,-20.73953,57,34,5,-23
-42.06724,-20.73953,60,39,5,-21
-42.06455,-20.73953,51,40,5,-11
-42.06163,-20.73953,50,49,0,-1
-42.05893,-20.73953,45,42,5,-3
-42.05601,-20.73953,33,41,5,8
-42.05331,-20.73953,30,42,5,12
-42.05061,-20.73953,26,50,5,24
-42.04769,-20.73953,16,48,5,32
-42.045,-20.73953,31,48,5,17
-42.0423,-20.73953,41,59,0,18
-42.03938,-20.73953,38,53,0,15
-42.03668,-20.73953,23,54,11,31
-42.03399,-20.73953,36,43,11,7
-42.03106,-20.73953,41,41,11,0
-42.02837,-20.73953,38,50,2,12
-42.02545,-20.73953,44,48,2,4
-42.02275,-20.73953,53,49,2,-4
-42.02005,-20.73953,58,40,2,-18
-42.01713,-20.73953,75,50,11,-25
-42.01444,-20.73953,56,49,0,-7
-42.01174,-20.73953,53,43,5,-10
-42.00882,-20.73953,62,43,5,-19
-42.00612,-20.73953,72,46,5,-26
-42.00342,-20.73953,59,48,0,-11
-42.0005,-20.73953,55,46,11,-9
-41.99781,-20.73953,61,46,11,-15
-41.99511,-20.73953,64,46,0,-18
-41.99219,-20.73953,63,46,5,-17
-41.98949,-20.73953,68,46,0,-22
-41.98657,-20.73953,84,43,0,-41
-41.98387,-20.73953,75,44,0,-31
-41.98118,-20.73953,69,45,0,-24
-41.97826,-20.73953,62,39,0,-23
-41.97556,-20.73953,60,41,0,-19
-41.97286,-20.73953,57,44,0,-13
-41.96994,-20.73953,56,46,0,-10
-42.1005,-20.7391,62,25,5,-37
-42.0978,-20.7391,60,28,5,-32
-42.09511,-20.7391,60,26,5,-34
-42.09219,-20.7391,60,40,5,-20
-42.08949,-20.7391,60,32,5,-28
-42.08657,-20.7391,61,26,5,-35
-42.08387,-20.7391,62,30,5,-32
-42.08118,-20.7391,60,33,5,-27
-42.07825,-20.7391,62,35,5,-27
-42.07556,-20.7391,63,35,5,-28
-42.07286,-20.7391,56,33,5,-23
-42.06994,-20.7391,57,36,5,-21
-42.06724,-20.7391,61,40,5,-21
-42.06455,-20.7391,52,41,5,-11
-42.06163,-20.7391,51,42,5,-9
-42.05893,-20.7391,45,42,5,-3
-42.05601,-20.7391,24,41,5,17
-42.05331,-20.7391,29,42,5,13
-42.05061,-20.7391,26,50,5,24
-42.04769,-20.7391,26,49,5,23
-42.045,-20.7391,33,51,5,18
-42.0423,-20.7391,41,59,0,18
-42.03938,-20.7391,38,57,0,19
-42.03668,-20.7391,28,54,0,26
-42.03399,-20.7391,38,44,11,6
-42.03106,-20.7391,41,41,2,0
-42.02837,-20.7391,39,51,14,12
-42.02545,-20.7391,45,50,11,5
-42.02275,-20.7391,54,52,2,-2
-42.02005,-20.7391,53,40,11,-13
-42.01713,-20.7391,77,51,11,-26
-42.01444,-20.7391,56,49,0,-7
-42.01174,-20.7391,51,43,5,-8
-42.00882,-20.7391,61,45,5,-16
-42.00612,-20.7391,74,48,0,-26
-42.00342,-20.7391,60,47,0,-13
-42.0005,-20.7391,50,46,0,-4
-41.99781,-20.7391,61,46,0,-15
-41.99511,-20.7391,64,46,0,-18
-41.99219,-20.7391,64,46,5,-18
-41.98949,-20.7391,67,45,0,-22
-41.98657,-20.7391,84,44,0,-40
-41.98387,-20.7391,75,44,0,-31
-41.98118,-20.7391,68,45,0,-23
-41.97826,-20.7391,62,35,0,-27
-41.97556,-20.7391,60,39,0,-21
-41.97286,-20.7391,57,42,0,-15
-41.96994,-20.7391,56,46,0,-10
-42.1005,-20.73889,65,25,5,-40
-42.0978,-20.73889,60,31,5,-29
-42.09511,-20.73889,60,26,5,-34
-42.09219,-20.73889,61,40,5,-21
-42.08949,-20.73889,60,32,5,-28
-42.08657,-20.73889,61,29,5,-32
-42.08387,-20.73889,62,27,5,-35
-42.08118,-20.73889,60,33,5,-27
-42.07825,-20.73889,61,35,5,-26
-42.07556,-20.73889,62,33,5,-29
-42.07286,-20.73889,56,33,5,-23
-42.06994,-20.73889,57,35,5,-22
-42.06724,-20.73889,55,39,5,-16
-42.06455,-20.73889,53,41,5,-12
-42.06163,-20.73889,51,43,5,-8
-42.05893,-20.73889,46,42,5,-4
-42.05601,-20.73889,16,41,5,25
-42.05331,-20.73889,31,42,5,11
-42.05061,-20.73889,26,50,0,24
-42.04769,-20.73889,26,50,5,24
-42.045,-20.73889,33,50,5,17
-42.0423,-20.73889,40,57,0,17
-42.03938,-20.73889,40,56,0,16
-42.03668,-20.73889,23,53,0,30
-42.03399,-20.73889,40,43,2,3
-42.03106,-20.73889,41,41,2,0
-42.02837,-20.73889,41,51,2,10
-42.02545,-20.73889,45,49,6,4
-42.02275,-20.73889,54,51,11,-3
-42.02005,-20.73889,57,42,11,-15
-42.01713,-20.73889,67,52,2,-15
-42.01444,-20.73889,54,47,0,-7
-42.01174,-20.73889,52,44,5,-8
-42.00882,-20.73889,61,45,5,-16
-42.00612,-20.73889,69,48,0,-21
-42.00342,-20.73889,60,47,0,-13
-42.0005,-20.73889,49,46,0,-3
-41.99781,-20.73889,61,45,0,-16
-41.99511,-20.73889,64,45,0,-19
-41.99219,-20.73889,64,45,5,-19
-41.98949,-20.73889,68,44,0,-24
-41.98657,-20.73889,82,44,0,-38
-41.98387,-20.73889,66,44,11,-22
-41.98118,-20.73889,68,45,0,-23
-41.97826,-20.73889,63,35,0,-28
-41.97556,-20.73889,60,39,0,-21
-41.97286,-20.73889,58,41,0,-17
-41.96994,-20.73889,56,42,5,-14
-42.1005,-20.73868,67,25,5,-42
-42.0978,-20.73868,60,31,0,-29
-42.09511,-20.73868,61,26,5,-35
-42.09219,-20.73868,61,39,5,-22
-42.08949,-20.73868,62,34,5,-28
-42.08657,-20.73868,62,30,5,-32
-42.08387,-20.73868,61,27,5,-34
-42.08118,-20.73868,60,33,5,-27
-42.07825,-20.73868,61,37,5,-24
-42.07556,-20.73868,62,33,5,-29
-42.07286,-20.73868,56,35,5,-21
-42.06994,-20.73868,57,37,5,-20
-42.06724,-20.73868,55,40,5,-15
-42.06455,-20.73868,53,39,5,-14
-42.06163,-20.73868,51,42,5,-9
-42.05893,-20.73868,46,43,5,-3
-42.05601,-20.73868,13,41,5,28
-42.05331,-20.73868,24,43,5,19
-42.05061,-20.73868,25,51,0,26
-42.04769,-20.73868,9,50,5,41
-42.045,-20.73868,27,50,5,23
-42.0423,-20.73868,42,58,0,16
-42.03938,-20.73868,39,57,0,18
-42.03668,-20.73868,22,53,11,31
-42.03399,-20.73868,42,42,2,0
-42.03106,-20.73868,41,42,11,1
-42.02837,-20.73868,42,51,2,9
-42.02545,-20.73868,45,48,2,3
-42.02275,-20.73868,54,51,11,-3
-42.02005,-20.73868,59,42,11,-17
-42.01713,-20.73868,61,54,2,-7
-42.01444,-20.73868,54,47,0,-7
-42.01174,-20.73868,54,44,5,-10
-42.00882,-20.73868,61,45,5,-16
-42.00612,-20.73868,66,48,0,-18
-42.00342,-20.73868,59,47,0,-12
-42.0005,-20.73868,50,45,0,-5
-41.99781,-20.73868,62,44,0,-18
-41.99511,-20.73868,63,45,11,-18
-41.99219,-20.73868,63,44,5,-19
-41.98949,-20.73868,68,45,0,-23
-41.98657,-20.73868,84,44,0,-40
-41.98387,-20.73868,62,45,0,-17
-41.98118,-20.73868,68,45,0,-23
-41.97826,-20.73868,63,34,0,-29
-41.97556,-20.73868,59,38,0,-21
-41.97286,-20.73868,58,42,0,-16
-41.96994,-20.73868,57,45,5,-12
-42.1005,-20.73826,69,25,5,-44
-42.0978,-20.73826,60,31,5,-29
-42.09511,-20.73826,61,27,5,-34
-42.09219,-20.73826,61,39,5,-22
-42.08949,-20.73826,63,34,5,-29
-42.08657,-20.73826,64,31,5,-33
-42.08387,-20.73826,61,25,5,-36
-42.08118,-20.73826,60,33,5,-27
-42.07825,-20.73826,61,37,5,-24
-42.07556,-20.73826,63,34,5,-29
-42.07286,-20.73826,56,35,5,-21
-42.06994,-20.73826,57,37,5,-20
-42.06724,-20.73826,56,39,5,-17
-42.06455,-20.73826,54,39,5,-15
-42.06163,-20.73826,50,41,5,-9
-42.05893,-20.73826,46,45,5,-1
-42.05601,-20.73826,14,42,5,28
-42.05331,-20.73826,24,47,0,23
-42.05061,-20.73826,25,49,0,24
-42.04769,-20.73826,9,49,5,40
-42.045,-20.73826,31,51,5,20
-42.0423,-20.73826,45,56,0,11
-42.03938,-20.73826,31,55,0,24
-42.03668,-20.73826,22,53,0,31
-42.03399,-20.73826,44,44,11,0
-42.03106,-20.73826,42,42,2,0
-42.02837,-20.73826,43,50,2,7
-42.02545,-20.73826,45,46,2,1
-42.02275,-20.73826,55,43,5,-12
-42.02005,-20.73826,58,40,2,-18
-42.01713,-20.73826,63,54,11,-9
-42.01444,-20.73826,55,55,0,0
-42.01174,-20.73826,48,45,5,-3
-42.00882,-20.73826,60,44,5,-16
-42.00612,-20.73826,65,48,0,-17
-42.00342,-20.73826,59,46,0,-13
-42.0005,-20.73826,49,44,5,-5
-41.99781,-20.73826,63,41,0,-22
-41.99511,-20.73826,64,45,0,-19
-41.99219,-20.73826,61,45,5,-16
-41.98949,-20.73826,68,45,0,-23
-41.98657,-20.73826,80,45,0,-35
-41.98387,-20.73826,58,45,0,-13
-41.98118,-20.73826,68,43,0,-25
-41.97826,-20.73826,63,35,0,-28
-41.97556,-20.73826,58,37,0,-21
-41.97286,-20.73826,58,43,0,-15
-41.96994,-20.73826,57,40,5,-17
-42.1005,-20.73805,68,25,5,-43
-42.0978,-20.73805,60,30,5,-30
-42.09511,-20.73805,61,27,5,-34
-42.09219,-20.73805,61,33,5,-28
-42.08949,-20.73805,67,34,5,-33
-42.08657,-20.73805,63,35,5,-28
-42.08387,-20.73805,62,24,5,-38
-42.08118,-20.73805,61,33,5,-28
-42.07825,-20.73805,61,37,5,-24
-42.07556,-20.73805,63,33,5,-30
-42.07286,-20.73805,55,35,5,-20
-42.06994,-20.73805,56,36,5,-20
-42.06724,-20.73805,56,39,5,-17
-42.06455,-20.73805,54,39,5,-15
-42.06163,-20.73805,51,41,5,-10
-42.05893,-20.73805,46,44,5,-2
-42.05601,-20.73805,16,42,5,26
-42.05331,-20.73805,24,54,0,30
-42.05061,-20.73805,34,49,0,15
-42.04769,-20.73805,25,49,5,24
-42.045,-20.73805,31,52,5,21
-42.0423,-20.73805,42,55,0,13
-42.03938,-20.73805,33,54,0,21
-42.03668,-20.73805,22,53,0,31
-42.03399,-20.73805,46,46,2,0
-42.03106,-20.73805,42,42,2,0
-42.02837,-20.73805,43,50,2,7
-42.02545,-20.73805,46,46,2,0
-42.02275,-20.73805,54,43,5,-11
-42.02005,-20.73805,66,37,2,-29
-42.01713,-20.73805,70,54,2,-16
-42.01444,-20.73805,53,55,0,2
-42.01174,-20.73805,47,45,5,-2
-42.00882,-20.73805,59,43,5,-16
-42.00612,-20.73805,64,48,0,-16
-42.00342,-20.73805,60,46,0,-14
-42.0005,-20.73805,49,41,5,-8
-41.99781,-20.73805,62,41,0,-21
-41.99511,-20.73805,64,45,0,-19
-41.99219,-20.73805,61,45,5,-16
-41.98949,-20.73805,71,45,0,-26
-41.98657,-20.73805,73,45,11,-28
-41.98387,-20.73805,57,45,0,-12
-41.98118,-20.73805,66,44,0,-22
-41.97826,-20.73805,63,35,0,-28
-41.97556,-20.73805,58,37,0,-21
-41.97286,-20.73805,58,45,0,-13
-41.96994,-20.73805,57,45,5,-12
-42.1005,-20.73783,67,25,5,-42
-42.0978,-20.73783,60,30,5,-30
-42.09511,-20.73783,61,26,5,-35
-42.09219,-20.73783,61,33,5,-28
-42.08949,-20.73783,65,34,5,-31
-42.08657,-20.73783,62,36,5,-26
-42.08387,-20.73783,62,24,5,-38
-42.08118,-20.73783,61,33,5,-28
-42.07825,-20.73783,61,38,5,-23
-42.07556,-20.73783,62,33,5,-29
-42.07286,-20.73783,55,35,5,-20
-42.06994,-20.73783,56,37,5,-19
-42.06724,-20.73783,56,38,5,-18
-42.06455,-20.73783,54,39,5,-15
-42.06163,-20.73783,53,41,5,-12
-42.05893,-20.73783,45,45,5,0
-42.05601,-20.73783,17,42,5,25
-42.05331,-20.73783,23,56,0,33
-42.05061,-20.73783,26,49,0,23
-42.04769,-20.73783,25,49,5,24
-42.045,-20.73783,34,52,5,18
-42.0423,-20.73783,42,55,0,13
-42.03938,-20.73783,36,53,0,17
-42.03668,-20.73783,22,53,0,31
-42.03399,-20.73783,49,45,2,-4
-42.03106,-20.73783,42,42,11,0
-42.02837,-20.73783,44,53,11,9
-42.02545,-20.73783,46,46,2,0
-42.02275,-20.73783,54,42,5,-12
-42.02005,-20.73783,65,37,2,-28
-42.01713,-20.73783,69,53,11,-16
-42.01444,-20.73783,51,51,11,0
-42.01174,-20.73783,47,46,5,-1
-42.00882,-20.73783,57,45,5,-12
-42.00612,-20.73783,63,48,0,-15
-42.00342,-20.73783,60,46,0,-14
-42.0005,-20.73783,49,41,5,-8
-41.99781,-20.73783,62,41,0,-21
-41.99511,-20.73783,63,40,5,-23
-41.99219,-20.73783,61,44,11,-17
-41.98949,-20.73783,73,45,0,-28
-41.98657,-20.73783,78,45,11,-33
-41.98387,-20.73783,57,43,0,-14
-41.98118,-20.73783,65,38,0,-27
-41.97826,-20.73783,62,33,0,-29
-41.97556,-20.73783,58,38,0,-20
-41.97286,-20.73783,58,45,0,-13
-41.96994,-20.73783,57,38,5,-19
-42.1005,-20.73741,61,31,5,-30
-42.0978,-20.73741,61,31,0,-30
-42.09511,-20.73741,61,26,5,-35
-42.09219,-20.73741,63,29,5,-34
-42.08949,-20.73741,64,32,5,-32
-42.08657,-20.73741,62,37,0,-25
-42.08387,-20.73741,66,28,5,-38
-42.08118,-20.73741,61,32,5,-29
-42.07825,-20.73741,61,39,5,-22
-42.07556,-20.73741,61,34,5,-27
-42.07286,-20.73741,55,35,5,-20
-42.06994,-20.73741,56,37,5,-19
-42.06724,-20.73741,57,37,5,-20
-42.06455,-20.73741,57,41,5,-16
-42.06163,-20.73741,53,38,5,-15
-42.05893,-20.73741,45,45,5,0
-42.05601,-20.73741,22,42,5,20
-42.05331,-20.73741,24,70,0,46
-42.05061,-20.73741,23,50,0,27
-42.04769,-20.73741,9,49,5,40
-42.045,-20.73741,35,53,5,18
-42.0423,-20.73741,44,55,0,11
-42.03938,-20.73741,36,51,0,15
-42.03668,-20.73741,22,54,11,32
-42.03399,-20.73741,50,46,2,-4
-42.03106,-20.73741,42,44,11,2
-42.02837,-20.73741,44,50,2,6
-42.02545,-20.73741,47,47,2,0
-42.02275,-20.73741,56,44,5,-12
-42.02005,-20.73741,66,37,11,-29
-42.01713,-20.73741,72,51,2,-21
-42.01444,-20.73741,50,52,11,2
-42.01174,-20.73741,47,46,5,-1
-42.00882,-20.73741,56,45,5,-11
-42.00612,-20.73741,62,47,0,-15
-42.00342,-20.73741,60,45,0,-15
-42.0005,-20.73741,49,45,5,-4
-41.99781,-20.73741,64,39,5,-25
-41.99511,-20.73741,64,39,5,-25
-41.99219,-20.73741,64,42,0,-22
-41.98949,-20.73741,73,44,0,-29
-41.98657,-20.73741,76,44,0,-32
-41.98387,-20.73741,56,43,0,-13
-41.98118,-20.73741,62,36,5,-26
-41.97826,-20.73741,62,35,0,-27
-41.97556,-20.73741,58,39,0,-19
-41.97286,-20.73741,58,45,0,-13
-41.96994,-20.73741,57,45,5,-12
-42.10297,-20.7372,61,32,5,-29
-42.10275,-20.7372,61,31,5,-30
-42.10252,-20.7372,61,28,5,-33
-42.1023,-20.7372,62,26,5,-36
-42.10185,-20.7372,62,26,5,-36
-42.10163,-20.7372,63,30,5,-33
-42.1014,-20.7372,63,31,5,-32
-42.10118,-20.7372,67,31,0,-36
-42.10073,-20.7372,61,31,0,-30
-42.1005,-20.7372,61,31,0,-30
-42.10028,-20.7372,61,31,0,-30
-42.10005,-20.7372,61,31,0,-30
-42.09983,-20.7372,61,30,0,-31
-42.09938,-20.7372,61,31,0,-30
-42.09915,-20.7372,61,32,5,-29
-42.09893,-20.7372,61,31,5,-30
-42.0987,-20.7372,61,31,5,-30
-42.09825,-20.7372,61,31,5,-30
-42.09803,-20.7372,61,31,0,-30
-42.0978,-20.7372,61,30,0,-31
-42.09758,-20.7372,61,30,0,-31
-42.09713,-20.7372,61,29,0,-32
-42.09691,-20.7372,61,29,5,-32
-42.09668,-20.7372,61,25,5,-36
-42.09646,-20.7372,61,25,5,-36
-42.09601,-20.7372,61,25,5,-36
-42.09578,-20.7372,61,25,5,-36
-42.09556,-20.7372,61,25,5,-36
-42.09533,-20.7372,61,25,5,-36
-42.09511,-20.7372,61,26,5,-35
-42.09466,-20.7372,61,26,5,-35
-42.09443,-20.7372,61,25,5,-36
-42.09421,-20.7372,61,25,5,-36
-42.09398,-20.7372,62,26,5,-36
-42.09354,-20.7372,62,25,5,-37
-42.09331,-20.7372,62,25,5,-37
-42.09309,-20.7372,62,25,5,-37
-42.09286,-20.7372,62,26,5,-36
-42.09241,-20.7372,63,27,5,-36
-42.09219,-20.7372,64,28,5,-36
-42.09196,-20.7372,65,29,5,-36
-42.09174,-20.7372,65,30,5,-35
-42.09129,-20.7372,66,32,5,-34
-42.09106,-20.7372,67,30,5,-37
-42.09084,-20.7372,67,30,5,-37
-42.09061,-20.7372,65,32,5,-33
-42.09039,-20.7372,64,33,5,-31
-42.08994,-20.7372,64,32,5,-32
-42.08972,-20.7372,64,31,5,-33
-42.08949,-20.7372,65,32,5,-33
-42.08927,-20.7372,63,32,5,-31
-42.08882,-20.7372,63,35,5,-28
-42.08859,-20.7372,63,35,5,-28
-42.08837,-20.7372,63,34,5,-29
-42.08814,-20.7372,62,34,5,-28
-42.08769,-20.7372,62,34,5,-28
-42.08747,-20.7372,62,36,5,-26
-42.08724,-20.7372,64,37,5,-27
-42.08702,-20.7372,63,37,0,-26
-42.08657,-20.7372,62,37,0,-25
-42.08634,-20.7372,62,37,0,-25
-42.08612,-20.7372,63,37,0,-26
-42.08589,-20.7372,63,36,0,-27
-42.08545,-20.7372,62,33,5,-29
-42.08522,-20.7372,62,33,5,-29
-42.085,-20.7372,62,32,5,-30
-42.08477,-20.7372,62,31,5,-31
-42.08455,-20.7372,62,31,5,-31
-42.0841,-20.7372,62,29,5,-33
-42.08387,-20.7372,62,28,5,-34
-42.08365,-20.7372,62,28,5,-34
-42.08342,-20.7372,62,28,5,-34
-42.08297,-20.7372,61,25,5,-36
-42.08275,-20.7372,61,25,5,-36
-42.08252,-20.7372,61,25,5,-36
-42.0823,-20.7372,62,29,5,-33
-42.08185,-20.7372,61,28,5,-33
-42.08163,-20.7372,61,28,5,-33
-42.0814,-20.7372,61,32,5,-29
-42.08118,-20.7372,61,33,5,-28
-42.08073,-20.7372,61,33,5,-28
-42.0805,-20.7372,61,33,5,-28
-42.08028,-20.7372,61,32,5,-29
-42.08005,-20.7372,61,32,5,-29
-42.07983,-20.7372,61,32,5,-29
-42.07938,-20.7372,61,30,5,-31
-42.07915,-20.7372,61,30,5,-31
-42.07893,-20.7372,61,34,5,-27
-42.0787,-20.7372,61,33,5,-28
-42.07825,-20.7372,64,38,5,-26
-42.07803,-20.7372,65,39,5,-26
-42.07781,-20.7372,64,38,5,-26
-42.07758,-20.7372,61,38,5,-23
-42.07713,-20.7372,63,37,5,-26
-42.07691,-20.7372,60,35,5,-25
-42.07668,-20.7372,60,35,5,-25
-42.07646,-20.7372,60,33,5,-27
-42.07601,-20.7372,59,33,5,-26
-42.07578,-20.7372,59,34,5,-25
-42.07556,-20.7372,59,34,5,-25
-42.07533,-20.7372,61,34,5,-27
-42.07511,-20.7372,63,34,5,-29
-42.07466,-20.7372,60,34,5,-26
-42.07443,-20.7372,54,34,5,-20
-42.07421,-20.7372,54,34,5,-20
-42.07399,-20.7372,54,33,5,-21
-42.07354,-20.7372,54,32,5,-22
-42.07331,-20.7372,54,34,5,-20
-42.07309,-20.7372,55,35,5,-20
-42.07286,-20.7372,55,36,5,-19
-42.07241,-20.7372,55,36,5,-19
-42.07219,-20.7372,55,36,5,-19
-42.07196,-20.7372,55,38,5,-17
-42.07174,-20.7372,56,38,5,-18
-42.07129,-20.7372,56,36,5,-20
-42.07106,-20.7372,56,35,5,-21
-42.07084,-20.7372,56,35,5,-21
-42.07061,-20.7372,56,37,5,-19
-42.07039,-20.7372,56,37,5,-19
-42.06994,-20.7372,56,37,5,-19
-42.06972,-20.7372,56,38,5,-18
-42.06949,-20.7372,56,39,5,-17
-42.06927,-20.7372,57,39,5,-18
-42.06882,-20.7372,57,38,5,-19
-42.06859,-20.7372,56,38,5,-18
-42.06837,-20.7372,57,39,5,-18
-42.06814,-20.7372,57,39,5,-18
-42.06769,-20.7372,57,38,5,-19
-42.06747,-20.7372,57,37,5,-20
-42.06724,-20.7372,57,37,5,-20
-42.06702,-20.7372,57,39,5,-18
-42.06657,-20.7372,58,38,5,-20
-42.06634,-20.7372,56,39,5,-17
-42.06612,-20.7372,57,38,5,-19
-42.0659,-20.7372,57,39,5,-18
-42.06545,-20.7372,56,39,5,-17
-42.06522,-20.7372,56,39,5,-17
-42.065,-20.7372,56,40,5,-16
-42.06477,-20.7372,56,41,5,-15
-42.06455,-20.7372,57,41,5,-16
-42.0641,-20.7372,55,39,5,-16
-42.06387,-20.7372,55,40,5,-15
-42.06365,-20.7372,56,40,5,-16
-42.06342,-20.7372,54,40,5,-14
-42.06297,-20.7372,54,39,5,-15
-42.06275,-20.7372,54,39,5,-15
-42.06252,-20.7372,54,38,5,-16
-42.0623,-20.7372,54,39,5,-15
-42.06185,-20.7372,54,38,5,-16
-42.06163,-20.7372,54,38,5,-16
-42.0614,-20.7372,54,38,5,-16
-42.06118,-20.7372,53,39,5,-14
-42.06073,-20.7372,50,42,5,-8
-42.0605,-20.7372,50,43,5,-7
-42.06028,-20.7372,49,44,5,-5
-42.06005,-20.7372,49,46,5,-3
-42.05983,-20.7372,48,46,5,-2
-42.05938,-20.7372,48,48,5,0
-42.05915,-20.7372,48,47,5,-1
-42.05893,-20.7372,46,46,5,0
-42.0587,-20.7372,45,44,0,-1
-42.05826,-20.7372,45,45,5,0
-42.05803,-20.7372,45,45,5,0
-42.05781,-20.7372,42,43,5,1
-42.05758,-20.7372,37,42,5,5
-42.05713,-20.7372,26,42,5,16
-42.05691,-20.7372,11,42,5,31
-42.05668,-20.7372,16,41,5,25
-42.05646,-20.7372,25,41,5,16
-42.05601,-20.7372,27,42,5,15
-42.05578,-20.7372,32,42,5,10
-42.05556,-20.7372,27,42,5,15
-42.05533,-20.7372,22,43,5,21
-42.05511,-20.7372,24,43,5,19
-42.05466,-20.7372,24,44,5,20
-42.05443,-20.7372,19,44,5,25
-42.05421,-20.7372,24,47,0,23
-42.05399,-20.7372,24,71,0,47
-42.05354,-20.7372,28,71,0,43
-42.05331,-20.7372,23,71,0,48
-42.05309,-20.7372,23,71,0,48
-42.05286,-20.7372,23,53,0,30
-42.05241,-20.7372,23,71,0,48
-42.05219,-20.7372,21,71,0,50
-42.05196,-20.7372,24,71,0,47
-42.05174,-20.7372,23,53,0,30
-42.05129,-20.7372,23,61,0,38
-42.05106,-20.7372,23,58,0,35
-42.05084,-20.7372,20,57,0,37
-42.05061,-20.7372,23,50,0,27
-42.05039,-20.7372,23,48,0,25
-42.04994,-20.7372,31,45,5,14
-42.04972,-20.7372,23,45,5,22
-42.04949,-20.7372,23,44,5,21
-42.04927,-20.7372,27,45,5,18
-42.04882,-20.7372,23,45,5,22
-42.04859,-20.7372,31,45,5,14
-42.04837,-20.7372,38,47,5,9
-42.04814,-20.7372,28,49,5,21
-42.04769,-20.7372,32,50,5,18
-42.04747,-20.7372,15,50,5,35
-42.04724,-20.7372,8,51,5,43
-42.04702,-20.7372,8,51,5,43
-42.04657,-20.7372,8,51,5,43
-42.04635,-20.7372,8,52,5,44
-42.04612,-20.7372,8,52,5,44
-42.0459,-20.7372,15,53,5,38
-42.04545,-20.7372,21,53,5,32
-42.04522,-20.7372,28,53,5,25
-42.045,-20.7372,31,53,5,22
-42.04477,-20.7372,36,54,5,18
-42.04455,-20.7372,38,54,5,16
-42.0441,-20.7372,36,54,5,18
-42.04387,-20.7372,39,53,5,14
-42.04365,-20.7372,36,53,5,17
-42.04342,-20.7372,39,53,5,14
-42.04297,-20.7372,41,53,5,12
-42.04275,-20.7372,40,54,5,14
-42.04253,-20.7372,41,55,5,14
-42.0423,-20.7372,44,58,0,14
-42.04185,-20.7372,43,57,0,14
-42.04163,-20.7372,39,55,0,16
-42.0414,-20.7372,42,53,0,11
-42.04118,-20.7372,44,52,0,8
-42.04073,-20.7372,43,50,0,7
-42.0405,-20.7372,42,51,0,9
-42.04028,-20.7372,40,51,5,11
-42.04005,-20.7372,39,49,5,10
-42.03983,-20.7372,37,50,5,13
-42.03938,-20.7372,32,50,5,18
-42.03915,-20.7372,34,50,5,16
-42.03893,-20.7372,33,49,5,16
-42.0387,-20.7372,27,51,5,24
-42.03826,-20.7372,24,55,0,31
-42.03803,-20.7372,30,57,0,27
-42.03781,-20.7372,33,56,0,23
-42.03758,-20.7372,33,55,0,22
-42.03713,-20.7372,27,55,11,28
-42.03691,-20.7372,16,54,0,38
-42.03668,-20.7372,24,54,0,30
-42.03646,-20.7372,27,53,0,26
-42.03601,-20.7372,29,53,0,24
-42.03578,-20.7372,34,52,11,18
-42.03556,-20.7372,40,53,11,13
-42.03533,-20.7372,44,53,0,9
-42.03511,-20.7372,45,53,0,8
-42.03466,-20.7372,48,52,11,4
-42.03444,-20.7372,48,47,0,-1
-42.03421,-20.7372,49,47,2,-2
-42.03399,-20.7372,48,47,2,-1
-42.03354,-20.7372,51,41,2,-10
-42.03331,-20.7372,51,41,2,-10
-42.03309,-20.7372,51,44,2,-7
-42.03286,-20.7372,51,46,2,-5
-42.03241,-20.7372,52,46,11,-6
-42.03219,-20.7372,52,47,2,-5
-42.03196,-20.7372,52,49,11,-3
-42.03174,-20.7372,43,44,11,1
-42.03129,-20.7372,42,44,11,2
-42.03106,-20.7372,42,43,11,1
-42.03084,-20.7372,42,43,2,1
-42.03062,-20.7372,43,43,2,0
-42.03017,-20.7372,43,43,2,0
-42.02994,-20.7372,43,49,11,6
-42.02972,-20.7372,43,49,2,6
-42.02949,-20.7372,44,49,2,5
-42.02927,-20.7372,44,49,2,5
-42.02882,-20.7372,44,50,6,6
-42.02859,-20.7372,45,50,2,5
-42.02837,-20.7372,44,50,2,6
-42.02814,-20.7372,45,50,2,5
-42.02769,-20.7372,45,50,11,5
-42.02747,-20.7372,46,50,11,4
-42.02724,-20.7372,46,48,2,2
-42.02702,-20.7372,46,48,2,2
-42.02657,-20.7372,46,48,2,2
-42.02635,-20.7372,46,48,2,2
-42.02612,-20.7372,47,48,2,1
-42.0259,-20.7372,47,48,11,1
-42.02545,-20.7372,47,47,2,0
-42.02522,-20.7372,47,47,5,0
-42.025,-20.7372,47,47,5,0
-42.02477,-20.7372,47,47,5,0
-42.02455,-20.7372,47,47,5,0
-42.0241,-20.7372,48,48,5,0
-42.02387,-20.7372,47,47,5,0
-42.02365,-20.7372,49,48,5,-1
-42.02342,-20.7372,50,47,5,-3
-42.02297,-20.7372,52,46,5,-6
-42.02275,-20.7372,53,46,5,-7
-42.02253,-20.7372,56,47,5,-9
-42.0223,-20.7372,53,47,5,-6
-42.02185,-20.7372,55,46,11,-9
-42.02163,-20.7372,63,45,11,-18
-42.0214,-20.7372,55,45,5,-10
-42.02118,-20.7372,58,44,5,-14
-42.02073,-20.7372,61,43,5,-18
-42.0205,-20.7372,64,38,5,-26
-42.02028,-20.7372,65,37,5,-28
-42.02005,-20.7372,67,37,5,-30
-42.01983,-20.7372,67,43,2,-24
-42.01938,-20.7372,65,42,11,-23
-42.01915,-20.7372,64,45,2,-19
-42.01893,-20.7372,64,42,2,-22
-42.01871,-20.7372,65,46,2,-19
-42.01826,-20.7372,69,46,2,-23
-42.01803,-20.7372,64,46,2,-18
-42.01781,-20.7372,69,46,2,-23
-42.01758,-20.7372,77,51,2,-26
-42.01713,-20.7372,73,52,2,-21
-42.01691,-20.7372,70,52,2,-18
-42.01668,-20.7372,70,53,2,-17
-42.01646,-20.7372,69,54,11,-15
-42.01601,-20.7372,69,54,11,-15
-42.01578,-20.7372,67,55,2,-12
-42.01556,-20.7372,58,55,2,-3
-42.01533,-20.7372,53,54,2,1
-42.01511,-20.7372,51,51,2,0
-42.01466,-20.7372,50,48,11,-2
-42.01444,-20.7372,50,51,11,1
-42.01421,-20.7372,50,51,2,1
-42.01399,-20.7372,50,51,2,1
-42.01354,-20.7372,48,47,11,-1
-42.01331,-20.7372,51,51,2,0
-42.01309,-20.7372,51,51,2,0
-42.01286,-20.7372,48,48,11,0
-42.01241,-20.7372,48,48,5,0
-42.01219,-20.7372,48,47,5,-1
-42.01196,-20.7372,48,47,5,-1
-42.01174,-20.7372,47,46,5,-1
-42.01129,-20.7372,47,47,5,0
-42.01106,-20.7372,47,47,5,0
-42.01084,-20.7372,50,47,5,-3
-42.01062,-20.7372,47,47,5,0
-42.01017,-20.7372,57,48,5,-9
-42.00994,-20.7372,54,48,5,-6
-42.00972,-20.7372,48,48,5,0
-42.00949,-20.7372,48,45,5,-3
-42.00927,-20.7372,47,44,5,-3
-42.00882,-20.7372,48,46,5,-2
-42.00859,-20.7372,54,46,5,-8
-42.00837,-20.7372,57,47,5,-10
-42.00814,-20.7372,61,47,5,-14
-42.00769,-20.7372,61,47,0,-14
-42.00747,-20.7372,61,47,0,-14
-42.00724,-20.7372,60,47,0,-13
-42.00702,-20.7372,61,47,0,-14
-42.00657,-20.7372,61,47,0,-14
-42.00635,-20.7372,62,46,0,-16
-42.00612,-20.7372,62,46,0,-16
-42.0059,-20.7372,63,46,0,-17
-42.00545,-20.7372,63,45,0,-18
-42.00522,-20.7372,63,45,0,-18
-42.005,-20.7372,64,45,0,-19
-42.00477,-20.7372,64,45,0,-19
-42.00455,-20.7372,63,45,0,-18
-42.0041,-20.7372,62,45,0,-17
-42.00387,-20.7372,62,45,0,-17
-42.00365,-20.7372,61,45,0,-16
-42.00342,-20.7372,60,45,0,-15
-42.00298,-20.7372,59,45,0,-14
-42.00275,-20.7372,58,45,0,-13
-42.00253,-20.7372,53,45,5,-8
-42.0023,-20.7372,50,45,5,-5
-42.00185,-20.7372,49,45,5,-4
-42.00163,-20.7372,49,45,5,-4
-42.0014,-20.7372,49,45,0,-4
-42.00118,-20.7372,52,45,0,-7
-42.00073,-20.7372,49,45,0,-4
-42.0005,-20.7372,49,45,5,-4
-42.00028,-20.7372,49,45,5,-4
-42.00005,-20.7372,49,41,5,-8
-41.99983,-20.7372,49,45,5,-4
-41.99938,-20.7372,48,45,5,-3
-41.99916,-20.7372,48,45,5,-3
-41.99893,-20.7372,57,41,5,-16
-41.99871,-20.7372,59,40,5,-19
-41.99826,-20.7372,61,39,5,-22
-41.99803,-20.7372,62,39,5,-23
-41.99781,-20.7372,64,38,5,-26
-41.99758,-20.7372,64,38,5,-26
-41.99713,-20.7372,64,38,5,-26
-41.99691,-20.7372,63,39,5,-24
-41.99668,-20.7372,62,39,5,-23
-41.99646,-20.7372,62,39,5,-23
-41.99601,-20.7372,61,39,5,-22
-41.99578,-20.7372,62,40,5,-22
-41.99556,-20.7372,63,40,5,-23
-41.99533,-20.7372,65,40,5,-25
-41.99511,-20.7372,64,38,5,-26
-41.99466,-20.7372,64,36,5,-28
-41.99444,-20.7372,64,36,5,-28
-41.99421,-20.7372,62,36,5,-26
-41.99399,-20.7372,61,36,5,-25
-41.99354,-20.7372,60,40,0,-20
-41.99331,-20.7372,60,40,0,-20
-41.99309,-20.7372,60,40,0,-20
-41.99286,-20.7372,62,41,0,-21
-41.99241,-20.7372,63,41,0,-22
-41.99219,-20.7372,64,41,0,-23
-41.99196,-20.7372,68,42,0,-26
-41.99174,-20.7372,71,42,0,-29
-41.99129,-20.7372,75,42,0,-33
-41.99107,-20.7372,75,42,0,-33
-41.99084,-20.7372,74,43,0,-31
-41.99062,-20.7372,68,43,11,-25
-41.99017,-20.7372,68,43,0,-25
-41.98994,-20.7372,69,43,0,-26
-41.98972,-20.7372,72,44,0,-28
-41.98949,-20.7372,72,44,0,-28
-41.98927,-20.7372,72,44,0,-28
-41.98882,-20.7372,73,43,0,-30
-41.98859,-20.7372,69,43,0,-26
-41.98837,-20.7372,72,43,0,-29
-41.98814,-20.7372,78,43,0,-35
-41.98769,-20.7372,78,43,0,-35
-41.98747,-20.7372,76,44,0,-32
-41.98725,-20.7372,75,44,0,-31
-41.98702,-20.7372,75,42,11,-33
-41.98657,-20.7372,74,43,0,-31
-41.98635,-20.7372,73,43,0,-30
-41.98612,-20.7372,73,43,0,-30
-41.9859,-20.7372,67,43,0,-24
-41.98545,-20.7372,61,43,0,-18
-41.98522,-20.7372,58,43,0,-15
-41.985,-20.7372,57,43,0,-14
-41.98477,-20.7372,57,43,0,-14
-41.98455,-20.7372,57,43,0,-14
-41.9841,-20.7372,57,43,0,-14
-41.98387,-20.7372,56,43,0,-13
-41.98365,-20.7372,56,44,0,-12
-41.98343,-20.7372,56,44,0,-12
-41.98298,-20.7372,56,44,0,-12
-41.98275,-20.7372,56,44,0,-12
-41.98253,-20.7372,56,45,0,-11
-41.9823,-20.7372,56,45,0,-11
-41.98185,-20.7372,57,38,5,-19
-41.98163,-20.7372,57,39,5,-18
-41.9814,-20.7372,60,45,5,-15
-41.98118,-20.7372,59,37,5,-22
-41.98073,-20.7372,66,38,5,-28
-41.9805,-20.7372,65,37,5,-28
-41.98028,-20.7372,65,39,5,-26
-41.98005,-20.7372,68,45,5,-23
-41.97983,-20.7372,67,43,5,-24
-41.97938,-20.7372,66,45,5,-21
-41.97916,-20.7372,64,45,5,-19
-41.97893,-20.7372,63,40,0,-23
-41.97871,-20.7372,63,34,0,-29
-41.97826,-20.7372,62,34,0,-28
-41.97803,-20.7372,62,34,0,-28
-41.97781,-20.7372,61,33,0,-28
-41.97758,-20.7372,60,33,0,-27
-41.97713,-20.7372,60,35,0,-25
-41.97691,-20.7372,60,35,0,-25
-41.97668,-20.7372,59,36,0,-23
-41.97646,-20.7372,58,36,0,-22
-41.97601,-20.7372,58,39,0,-19
-41.97578,-20.7372,58,39,0,-19
-41.97556,-20.7372,58,40,0,-18
-41.97534,-20.7372,58,41,0,-17
-41.97511,-20.7372,58,41,0,-17
-41.97466,-20.7372,58,44,0,-14
-41.97444,-20.7372,58,45,0,-13
-41.97421,-20.7372,58,45,0,-13
-41.97399,-20.7372,58,45,0,-13
-41.97354,-20.7372,58,45,0,-13
-41.97331,-20.7372,58,45,0,-13
-41.97309,-20.7372,58,45,0,-13
-41.97286,-20.7372,58,45,0,-13
-41.97241,-20.7372,58,45,0,-13
-41.97219,-20.7372,58,45,0,-13
-41.97196,-20.7372,58,45,0,-13
-41.97174,-20.7372,58,45,11,-13
-41.97129,-20.7372,58,38,0,-20
-41.97107,-20.7372,57,45,0,-12
-41.97084,-20.7372,57,45,0,-12
-41.97062,-20.7372,57,45,0,-12
-41.97017,-20.7372,57,45,5,-12
-41.96994,-20.7372,57,45,5,-12
-41.96972,-20.7372,57,46,5,-11
-41.96949,-20.7372,57,45,5,-12
-41.96927,-20.7372,57,33,5,-24
-42.1005,-20.73699,61,31,0,-30
-42.0978,-20.73699,61,30,0,-31
-42.09511,-20.73699,62,25,5,-37
-42.09219,-20.73699,64,27,5,-37
-42.08949,-20.73699,62,31,5,-31
-42.08657,-20.73699,61,37,0,-24
-42.08387,-20.73699,64,28,5,-36
-42.08118,-20.73699,60,32,5,-28
-42.07825,-20.73699,64,38,5,-26
-42.07556,-20.73699,60,34,5,-26
-42.07286,-20.73699,55,36,5,-19
-42.06994,-20.73699,56,38,5,-18
-42.06724,-20.73699,57,39,5,-18
-42.06455,-20.73699,55,41,5,-14
-42.06163,-20.73699,55,38,5,-17
-42.05893,-20.73699,47,44,5,-3
-42.05601,-20.73699,30,42,5,12
-42.05331,-20.73699,23,71,0,48
-42.05061,-20.73699,22,53,0,31
-42.04769,-20.73699,36,50,5,14
-42.045,-20.73699,33,55,5,22
-42.0423,-20.73699,24,58,0,34
-42.03938,-20.73699,33,50,5,17
-42.03668,-20.73699,25,53,11,28
-42.03399,-20.73699,49,46,2,-3
-42.03106,-20.73699,43,44,2,1
-42.02837,-20.73699,45,50,2,5
-42.02545,-20.73699,52,51,2,-1
-42.02275,-20.73699,56,48,5,-8
-42.02005,-20.73699,62,45,5,-17
-42.01713,-20.73699,75,52,11,-23
-42.01444,-20.73699,49,48,2,-1
-42.01174,-20.73699,48,46,5,-2
-42.00882,-20.73699,48,46,0,-2
-42.00612,-20.73699,62,45,0,-17
-42.00342,-20.73699,60,45,0,-15
-42.0005,-20.73699,49,45,5,-4
-41.99781,-20.73699,61,39,5,-22
-41.99511,-20.73699,65,39,5,-26
-41.99219,-20.73699,65,41,0,-24
-41.98949,-20.73699,71,44,0,-27
-41.98657,-20.73699,73,43,0,-30
-41.98387,-20.73699,57,43,0,-14
-41.98118,-20.73699,57,45,5,-12
-41.97826,-20.73699,62,45,0,-17
-41.97556,-20.73699,58,39,0,-19
-41.97286,-20.73699,58,45,0,-13
-41.96994,-20.73699,57,46,0,-11
-42.1005,-20.73657,61,31,0,-30
-42.0978,-20.73657,61,30,0,-31
-42.09511,-20.73657,62,25,5,-37
-42.09219,-20.73657,65,25,5,-40
-42.08949,-20.73657,63,30,5,-33
-42.08657,-20.73657,60,37,0,-23
-42.08387,-20.73657,63,28,5,-35
-42.08118,-20.73657,60,32,5,-28
-42.07825,-20.73657,62,39,5,-23
-42.07556,-20.73657,61,33,5,-28
-42.07286,-20.73657,55,36,5,-19
-42.06994,-20.73657,56,37,5,-19
-42.06724,-20.73657,64,38,5,-26
-42.06455,-20.73657,55,40,5,-15
-42.06163,-20.73657,54,38,5,-16
-42.05893,-20.73657,47,52,0,5
-42.05601,-20.73657,35,41,5,6
-42.05331,-20.73657,23,71,0,48
-42.05061,-20.73657,22,52,0,30
-42.04769,-20.73657,33,51,5,18
-42.045,-20.73657,31,58,5,27
-42.0423,-20.73657,23,74,0,51
-42.03938,-20.73657,34,50,5,16
-42.03668,-20.73657,27,48,5,21
-42.03399,-20.73657,50,48,2,-2
-42.03106,-20.73657,43,42,2,-1
-42.02837,-20.73657,45,50,11,5
-42.02545,-20.73657,52,51,11,-1
-42.02275,-20.73657,55,52,5,-3
-42.02005,-20.73657,65,49,5,-16
-42.01713,-20.73657,70,48,2,-22
-42.01444,-20.73657,48,53,11,5
-42.01174,-20.73657,48,49,5,1
-42.00882,-20.73657,48,46,0,-2
-42.00612,-20.73657,62,45,0,-17
-42.00342,-20.73657,59,45,0,-14
-42.0005,-20.73657,51,45,0,-6
-41.99781,-20.73657,59,41,5,-18
-41.99511,-20.73657,62,45,5,-17
-41.99219,-20.73657,66,41,0,-25
-41.98949,-20.73657,70,40,0,-30
-41.98657,-20.73657,73,43,0,-30
-41.98387,-20.73657,57,42,0,-15
-41.98118,-20.73657,57,45,0,-12
-41.97826,-20.73657,61,45,0,-16
-41.97556,-20.73657,60,36,0,-24
-41.97286,-20.73657,58,45,11,-13
-41.96994,-20.73657,57,46,0,-11
-42.1005,-20.73635,61,30,0,-31
-42.0978,-20.73635,62,29,0,-33
-42.09511,-20.73635,62,25,5,-37
-42.09219,-20.73635,64,25,5,-39
-42.08949,-20.73635,63,32,5,-31
-42.08657,-20.73635,60,37,0,-23
-42.08387,-20.73635,63,29,5,-34
-42.08118,-20.73635,60,32,5,-28
-42.07825,-20.73635,62,39,5,-23
-42.07556,-20.73635,62,33,5,-29
-42.07286,-20.73635,54,37,5,-17
-42.06994,-20.73635,56,37,5,-19
-42.06724,-20.73635,64,39,5,-25
-42.06455,-20.73635,56,40,5,-16
-42.06163,-20.73635,54,39,5,-15
-42.05893,-20.73635,48,52,0,4
-42.05601,-20.73635,36,41,5,5
-42.05331,-20.73635,23,71,0,48
-42.05061,-20.73635,22,52,0,30
-42.04769,-20.73635,31,47,5,16
-42.045,-20.73635,30,58,5,28
-42.0423,-20.73635,6,73,0,67
-42.03938,-20.73635,15,51,5,36
-42.03668,-20.73635,28,48,5,20
-42.03399,-20.73635,50,50,2,0
-42.03106,-20.73635,44,45,2,1
-42.02837,-20.73635,46,50,11,4
-42.02545,-20.73635,52,50,11,-2
-42.02275,-20.73635,62,52,5,-10
-42.02005,-20.73635,65,50,5,-15
-42.01713,-20.73635,61,50,2,-11
-42.01444,-20.73635,48,49,11,1
-42.01174,-20.73635,50,49,5,-1
-42.00882,-20.73635,47,45,0,-2
-42.00612,-20.73635,62,45,0,-17
-42.00342,-20.73635,59,45,0,-14
-42.0005,-20.73635,52,45,0,-7
-41.99781,-20.73635,57,42,5,-15
-41.99511,-20.73635,60,46,5,-14
-41.99219,-20.73635,65,40,0,-25
-41.98949,-20.73635,65,40,0,-25
-41.98657,-20.73635,64,44,0,-20
-41.98387,-20.73635,57,43,0,-14
-41.98118,-20.73635,57,45,0,-12
-41.97826,-20.73635,61,45,0,-16
-41.97556,-20.73635,62,41,0,-21
-41.97286,-20.73635,58,45,0,-13
-41.96994,-20.73635,57,46,0,-11
-42.1005,-20.73614,62,31,0,-31
-42.0978,-20.73614,62,29,0,-33
-42.09511,-20.73614,63,26,5,-37
-42.09219,-20.73614,63,26,5,-37
-42.08949,-20.73614,63,35,5,-28
-42.08657,-20.73614,60,36,0,-24
-42.08387,-20.73614,62,28,5,-34
-42.08118,-20.73614,60,32,5,-28
-42.07825,-20.73614,61,39,5,-22
-42.07556,-20.73614,63,32,5,-31
-42.07286,-20.73614,54,37,5,-17
-42.06994,-20.73614,56,37,5,-19
-42.06724,-20.73614,65,39,5,-26
-42.06455,-20.73614,56,40,5,-16
-42.06163,-20.73614,55,39,5,-16
-42.05893,-20.73614,49,53,0,4
-42.05601,-20.73614,36,42,5,6
-42.05331,-20.73614,23,71,0,48
-42.05061,-20.73614,26,52,0,26
-42.04769,-20.73614,24,54,0,30
-42.045,-20.73614,26,58,5,32
-42.0423,-20.73614,6,75,0,69
-42.03938,-20.73614,5,51,5,46
-42.03668,-20.73614,30,49,5,19
-42.03399,-20.73614,52,50,11,-2
-42.03106,-20.73614,46,46,11,0
-42.02837,-20.73614,46,50,2,4
-42.02545,-20.73614,54,56,11,2
-42.02275,-20.73614,62,52,5,-10
-42.02005,-20.73614,66,51,5,-15
-42.01713,-20.73614,59,51,11,-8
-42.01444,-20.73614,47,52,2,5
-42.01174,-20.73614,51,50,5,-1
-42.00882,-20.73614,47,44,5,-3
-42.00612,-20.73614,61,45,0,-16
-42.00342,-20.73614,59,45,0,-14
-42.0005,-20.73614,52,45,0,-7
-41.99781,-20.73614,55,45,5,-10
-41.99511,-20.73614,63,46,0,-17
-41.99219,-20.73614,65,40,0,-25
-41.98949,-20.73614,63,40,0,-23
-41.98657,-20.73614,60,44,0,-16
-41.98387,-20.73614,58,43,0,-15
-41.98118,-20.73614,58,44,0,-14
-41.97826,-20.73614,61,45,0,-16
-41.97556,-20.73614,62,45,0,-17
-41.97286,-20.73614,57,46,0,-11
-41.96994,-20.73614,57,46,0,-11
-42.1005,-20.73593,62,32,0,-30
-42.0978,-20.73593,64,29,0,-35
-42.09511,-20.73593,63,27,0,-36
-42.09219,-20.73593,63,25,5,-38
-42.08949,-20.73593,64,32,5,-32
-42.08657,-20.73593,60,36,0,-24
-42.08387,-20.73593,62,28,5,-34
-42.08118,-20.73593,60,32,5,-28
-42.07825,-20.73593,60,40,5,-20
-42.07556,-20.73593,63,33,5,-30
-42.07286,-20.73593,54,37,5,-17
-42.06994,-20.73593,55,37,5,-18
-42.06724,-20.73593,64,39,5,-25
-42.06455,-20.73593,55,41,5,-14
-42.06163,-20.73593,54,39,5,-15
-42.05893,-20.73593,50,52,0,2
-42.05601,-20.73593,32,42,5,10
-42.05331,-20.73593,23,71,0,48
-42.05061,-20.73593,24,52,0,28
-42.04769,-20.73593,26,54,0,28
-42.045,-20.73593,24,74,5,50
-42.0423,-20.73593,22,74,0,52
-42.03938,-20.73593,17,52,5,35
-42.03668,-20.73593,26,49,11,23
-42.03399,-20.73593,51,50,2,-1
-42.03106,-20.73593,50,50,11,0
-42.02837,-20.73593,46,50,2,4
-42.02545,-20.73593,52,52,5,0
-42.02275,-20.73593,61,54,5,-7
-42.02005,-20.73593,65,52,5,-13
-42.01713,-20.73593,54,51,2,-3
-42.01444,-20.73593,47,49,11,2
-42.01174,-20.73593,54,50,5,-4
-42.00882,-20.73593,48,42,5,-6
-42.00612,-20.73593,61,45,0,-16
-42.00342,-20.73593,58,45,0,-13
-42.0005,-20.73593,52,43,0,-9
-41.99781,-20.73593,55,45,5,-10
-41.99511,-20.73593,56,46,0,-10
-41.99219,-20.73593,65,38,0,-27
-41.98949,-20.73593,61,40,11,-21
-41.98657,-20.73593,60,44,0,-16
-41.98387,-20.73593,58,45,0,-13
-41.98118,-20.73593,58,45,0,-13
-41.97826,-20.73593,58,45,0,-13
-41.97556,-20.73593,63,41,0,-22
-41.97286,-20.73593,57,46,0,-11
-41.96994,-20.73593,57,46,0,-11
-42.1005,-20.73551,64,32,0,-32
-42.0978,-20.73551,65,28,0,-37
-42.09511,-20.73551,62,27,0,-35
-42.09219,-20.73551,63,25,5,-38
-42.08949,-20.73551,67,34,5,-33
-42.08657,-20.73551,60,36,5,-24
-42.08387,-20.73551,62,29,5,-33
-42.08118,-20.73551,60,33,5,-27
-42.07825,-20.73551,61,39,5,-22
-42.07556,-20.73551,63,34,5,-29
-42.07286,-20.73551,54,40,5,-14
-42.06994,-20.73551,55,37,5,-18
-42.06724,-20.73551,64,40,5,-24
-42.06455,-20.73551,60,46,0,-14
-42.06163,-20.73551,54,41,5,-13
-42.05893,-20.73551,50,49,0,-1
-42.05601,-20.73551,22,43,0,21
-42.05331,-20.73551,23,57,0,34
-42.05061,-20.73551,22,55,0,33
-42.04769,-20.73551,27,57,0,30
-42.045,-20.73551,21,74,0,53
-42.0423,-20.73551,21,74,0,53
-42.03938,-20.73551,17,62,0,45
-42.03668,-20.73551,24,49,5,25
-42.03399,-20.73551,49,49,2,0
-42.03106,-20.73551,50,52,11,2
-42.02837,-20.73551,45,50,2,5
-42.02545,-20.73551,49,52,5,3
-42.02275,-20.73551,61,57,5,-4
-42.02005,-20.73551,60,52,11,-8
-42.01713,-20.73551,51,51,2,0
-42.01444,-20.73551,47,47,2,0
-42.01174,-20.73551,56,53,5,-3
-42.00882,-20.73551,47,43,5,-4
-42.00612,-20.73551,60,45,0,-15
-42.00342,-20.73551,59,44,5,-15
-42.0005,-20.73551,52,43,0,-9
-41.99781,-20.73551,58,45,0,-13
-41.99511,-20.73551,55,46,5,-9
-41.99219,-20.73551,64,40,0,-24
-41.98949,-20.73551,60,39,0,-21
-41.98657,-20.73551,60,36,5,-24
-41.98387,-20.73551,58,45,0,-13
-41.98118,-20.73551,58,43,0,-15
-41.97826,-20.73551,58,44,0,-14
-41.97556,-20.73551,64,45,0,-19
-41.97286,-20.73551,57,46,0,-11
-41.96994,-20.73551,57,46,0,-11
-42.1005,-20.7353,64,31,5,-33
-42.0978,-20.7353,64,27,0,-37
-42.09511,-20.7353,62,26,0,-36
-42.09219,-20.7353,64,26,5,-38
-42.08949,-20.7353,67,37,5,-30
-42.08657,-20.7353,60,32,5,-28
-42.08387,-20.7353,62,28,5,-34
-42.08118,-20.7353,60,32,5,-28
-42.07825,-20.7353,61,37,5,-24
-42.07556,-20.7353,61,34,5,-27
-42.07286,-20.7353,55,40,5,-15
-42.06994,-20.7353,55,34,5,-21
-42.06724,-20.7353,64,40,5,-24
-42.06455,-20.7353,61,46,0,-15
-42.06163,-20.7353,54,41,5,-13
-42.05893,-20.7353,49,47,0,-2
-42.05601,-20.7353,10,55,0,45
-42.05331,-20.7353,23,52,0,29
-42.05061,-20.7353,23,55,0,32
-42.04769,-20.7353,20,61,0,41
-42.045,-20.7353,6,73,0,67
-42.0423,-20.7353,5,73,0,68
-42.03938,-20.7353,4,72,0,68
-42.03668,-20.7353,23,51,5,28
-42.03399,-20.7353,44,49,2,5
-42.03106,-20.7353,48,49,11,1
-42.02837,-20.7353,52,52,2,0
-42.02545,-20.7353,50,52,11,2
-42.02275,-20.7353,62,58,5,-4
-42.02005,-20.7353,59,52,5,-7
-42.01713,-20.7353,49,48,11,-1
-42.01444,-20.7353,47,47,2,0
-42.01174,-20.7353,56,49,5,-7
-42.00882,-20.7353,48,42,5,-6
-42.00612,-20.7353,60,44,5,-16
-42.00342,-20.7353,59,41,5,-18
-42.0005,-20.7353,53,44,0,-9
-41.99781,-20.7353,60,45,0,-15
-41.99511,-20.7353,56,44,5,-12
-41.99219,-20.7353,63,39,0,-24
-41.98949,-20.7353,61,37,0,-24
-41.98657,-20.7353,60,38,5,-22
-41.98387,-20.7353,59,44,0,-15
-41.98118,-20.7353,58,42,0,-16
-41.97826,-20.7353,58,43,0,-15
-41.97556,-20.7353,61,45,0,-16
-41.97286,-20.7353,57,46,0,-11
-41.96994,-20.7353,60,38,0,-22
-42.1005,-20.73509,64,25,5,-39
-42.0978,-20.73509,64,27,0,-37
-42.09511,-20.73509,62,25,0,-37
-42.09219,-20.73509,67,25,5,-42
-42.08949,-20.73509,67,35,5,-32
-42.08657,-20.73509,60,32,5,-28
-42.08387,-20.73509,62,30,5,-32
-42.08118,-20.73509,60,32,5,-28
-42.07825,-20.73509,61,40,5,-21
-42.07556,-20.73509,61,34,5,-27
-42.07286,-20.73509,55,40,5,-15
-42.06994,-20.73509,55,34,5,-21
-42.06724,-20.73509,58,40,5,-18
-42.06455,-20.73509,61,45,0,-16
-42.06163,-20.73509,55,42,5,-13
-42.05893,-20.73509,50,53,0,3
-42.05601,-20.73509,10,53,0,43
-42.05331,-20.73509,26,50,0,24
-42.05061,-20.73509,24,57,0,33
-42.04769,-20.73509,21,56,0,35
-42.045,-20.73509,15,73,0,58
-42.0423,-20.73509,5,73,0,68
-42.03938,-20.73509,4,72,0,68
-42.03668,-20.73509,23,51,5,28
-42.03399,-20.73509,36,50,2,14
-42.03106,-20.73509,49,52,2,3
-42.02837,-20.73509,49,51,2,2
-42.02545,-20.73509,50,53,11,3
-42.02275,-20.73509,56,57,5,1
-42.02005,-20.73509,57,50,5,-7
-42.01713,-20.73509,48,48,2,0
-42.01444,-20.73509,47,47,11,0
-42.01174,-20.73509,54,46,5,-8
-42.00882,-20.73509,48,43,5,-5
-42.00612,-20.73509,59,42,5,-17
-42.00342,-20.73509,58,41,5,-17
-42.0005,-20.73509,55,44,0,-11
-41.99781,-20.73509,59,45,0,-14
-41.99511,-20.73509,57,44,5,-13
-41.99219,-20.73509,62,39,0,-23
-41.98949,-20.73509,61,36,0,-25
-41.98657,-20.73509,59,38,5,-21
-41.98387,-20.73509,62,44,0,-18
-41.98118,-20.73509,58,41,0,-17
-41.97826,-20.73509,57,43,0,-14
-41.97556,-20.73509,57,45,0,-12
-41.97286,-20.73509,56,46,0,-10
-41.96994,-20.73509,61,33,5,-28
-42.1005,-20.73466,65,26,5,-39
-42.0978,-20.73466,64,25,0,-39
-42.09511,-20.73466,62,24,0,-38
-42.09219,-20.73466,68,25,5,-43
-42.08949,-20.73466,67,38,5,-29
-42.08657,-20.73466,60,31,5,-29
-42.08387,-20.73466,62,32,5,-30
-42.08118,-20.73466,59,32,5,-27
-42.07825,-20.73466,63,40,5,-23
-42.07556,-20.73466,60,34,5,-26
-42.07286,-20.73466,55,39,5,-16
-42.06994,-20.73466,55,37,5,-18
-42.06724,-20.73466,60,38,5,-22
-42.06455,-20.73466,55,45,0,-10
-42.06163,-20.73466,55,51,0,-4
-42.05893,-20.73466,50,55,0,5
-42.05601,-20.73466,19,53,0,34
-42.05331,-20.73466,24,49,0,25
-42.05061,-20.73466,24,67,0,43
-42.04769,-20.73466,21,73,0,52
-42.045,-20.73466,24,73,0,49
-42.0423,-20.73466,20,73,0,53
-42.03938,-20.73466,15,61,0,46
-42.03668,-20.73466,24,60,5,36
-42.03399,-20.73466,25,50,2,25
-42.03106,-20.73466,44,55,11,11
-42.02837,-20.73466,50,51,2,1
-42.02545,-20.73466,40,53,11,13
-42.02275,-20.73466,54,57,5,3
-42.02005,-20.73466,56,50,5,-6
-42.01713,-20.73466,48,48,2,0
-42.01444,-20.73466,48,48,2,0
-42.01174,-20.73466,49,48,5,-1
-42.00882,-20.73466,47,45,5,-2
-42.00612,-20.73466,57,41,5,-16
-42.00342,-20.73466,54,40,5,-14
-42.0005,-20.73466,58,44,0,-14
-41.99781,-20.73466,59,43,0,-16
-41.99511,-20.73466,57,42,5,-15
-41.99219,-20.73466,65,34,5,-31
-41.98949,-20.73466,61,35,0,-26
-41.98657,-20.73466,59,41,5,-18
-41.98387,-20.73466,60,42,0,-18
-41.98118,-20.73466,58,41,0,-17
-41.97826,-20.73466,57,43,0,-14
-41.97556,-20.73466,57,45,11,-12
-41.97286,-20.73466,56,46,0,-10
-41.96994,-20.73466,60,31,5,-29
-42.10297,-20.73445,62,26,5,-36
-42.10275,-20.73445,62,26,5,-36
-42.10252,-20.73445,62,25,5,-37
-42.1023,-20.73445,62,25,5,-37
-42.10185,-20.73445,63,25,5,-38
-42.10163,-20.73445,64,25,5,-39
-42.1014,-20.73445,63,25,5,-38
-42.10118,-20.73445,65,26,5,-39
-42.10073,-20.73445,64,26,5,-38
-42.1005,-20.73445,66,26,5,-40
-42.10028,-20.73445,68,26,5,-42
-42.10005,-20.73445,70,26,5,-44
-42.09983,-20.73445,68,25,5,-43
-42.09938,-20.73445,70,28,5,-42
-42.09915,-20.73445,69,28,0,-41
-42.09893,-20.73445,69,28,0,-41
-42.0987,-20.73445,68,28,0,-40
-42.09825,-20.73445,69,26,0,-43
-42.09803,-20.73445,68,26,0,-42
-42.0978,-20.73445,63,25,0,-38
-42.09758,-20.73445,63,24,0,-39
-42.09713,-20.73445,67,22,0,-45
-42.09691,-20.73445,67,20,0,-47
-42.09668,-20.73445,67,19,0,-48
-42.09646,-20.73445,64,20,0,-44
-42.09601,-20.73445,62,19,0,-43
-42.09578,-20.73445,62,20,0,-42
-42.09556,-20.73445,62,20,0,-42
-42.09533,-20.73445,61,22,0,-39
-42.09511,-20.73445,61,22,0,-39
-42.09466,-20.73445,62,22,5,-40
-42.09443,-20.73445,62,21,5,-41
-42.09421,-20.73445,62,22,5,-40
-42.09398,-20.73445,63,22,5,-41
-42.09354,-20.73445,68,23,5,-45
-42.09331,-20.73445,68,23,5,-45
-42.09309,-20.73445,68,23,5,-45
-42.09286,-20.73445,68,23,5,-45
-42.09241,-20.73445,67,24,5,-43
-42.09219,-20.73445,68,25,5,-43
-42.09196,-20.73445,63,25,5,-38
-42.09174,-20.73445,60,26,5,-34
-42.09129,-20.73445,60,26,5,-34
-42.09106,-20.73445,61,27,5,-34
-42.09084,-20.73445,62,27,5,-35
-42.09061,-20.73445,62,28,5,-34
-42.09039,-20.73445,67,29,5,-38
-42.08994,-20.73445,67,37,5,-30
-42.08972,-20.73445,67,37,5,-30
-42.08949,-20.73445,67,37,5,-30
-42.08927,-20.73445,67,38,0,-29
-42.08882,-20.73445,66,37,0,-29
-42.08859,-20.73445,66,37,0,-29
-42.08837,-20.73445,60,35,5,-25
-42.08814,-20.73445,60,37,5,-23
-42.08769,-20.73445,60,36,5,-24
-42.08747,-20.73445,60,36,5,-24
-42.08724,-20.73445,60,36,0,-24
-42.08702,-20.73445,60,36,0,-24
-42.08657,-20.73445,60,34,5,-26
-42.08634,-20.73445,61,31,5,-30
-42.08612,-20.73445,61,31,5,-30
-42.08589,-20.73445,61,32,5,-29
-42.08545,-20.73445,66,33,5,-33
-42.08522,-20.73445,61,31,5,-30
-42.085,-20.73445,61,30,5,-31
-42.08477,-20.73445,61,29,5,-32
-42.08455,-20.73445,61,28,5,-33
-42.0841,-20.73445,61,28,5,-33
-42.08387,-20.73445,62,30,5,-32
-42.08365,-20.73445,63,33,5,-30
-42.08342,-20.73445,66,33,5,-33
-42.08297,-20.73445,66,32,5,-34
-42.08275,-20.73445,63,32,5,-31
-42.08252,-20.73445,65,32,5,-33
-42.0823,-20.73445,61,32,5,-29
-42.08185,-20.73445,61,32,5,-29
-42.08163,-20.73445,62,32,5,-30
-42.0814,-20.73445,59,32,5,-27
-42.08118,-20.73445,59,32,5,-27
-42.08073,-20.73445,59,32,5,-27
-42.0805,-20.73445,59,32,5,-27
-42.08028,-20.73445,59,32,5,-27
-42.08005,-20.73445,59,32,5,-27
-42.07983,-20.73445,60,33,5,-27
-42.07938,-20.73445,60,33,5,-27
-42.07915,-20.73445,61,35,5,-26
-42.07893,-20.73445,62,38,5,-24
-42.0787,-20.73445,66,38,5,-28
-42.07825,-20.73445,62,37,5,-25
-42.07803,-20.73445,64,39,5,-25
-42.07781,-20.73445,61,39,5,-22
-42.07758,-20.73445,59,39,0,-20
-42.07713,-20.73445,59,37,5,-22
-42.07691,-20.73445,59,35,5,-24
-42.07668,-20.73445,59,35,5,-24
-42.07646,-20.73445,60,35,5,-25
-42.07601,-20.73445,60,34,5,-26
-42.07578,-20.73445,60,34,5,-26
-42.07556,-20.73445,60,34,5,-26
-42.07533,-20.73445,60,34,5,-26
-42.07511,-20.73445,59,35,5,-24
-42.07466,-20.73445,60,33,5,-27
-42.07443,-20.73445,58,33,5,-25
-42.07421,-20.73445,57,35,5,-22
-42.07399,-20.73445,55,36,5,-19
-42.07354,-20.73445,55,38,5,-17
-42.07331,-20.73445,55,38,5,-17
-42.07309,-20.73445,55,39,5,-16
-42.07286,-20.73445,55,39,5,-16
-42.07241,-20.73445,55,38,5,-17
-42.07219,-20.73445,55,37,5,-18
-42.07196,-20.73445,56,37,5,-19
-42.07174,-20.73445,56,37,5,-19
-42.07129,-20.73445,56,39,5,-17
-42.07106,-20.73445,57,40,5,-17
-42.07084,-20.73445,58,39,5,-19
-42.07061,-20.73445,57,38,5,-19
-42.07039,-20.73445,58,38,5,-20
-42.06994,-20.73445,55,38,5,-17
-42.06972,-20.73445,55,37,5,-18
-42.06949,-20.73445,55,36,5,-19
-42.06927,-20.73445,55,36,5,-19
-42.06882,-20.73445,55,35,5,-20
-42.06859,-20.73445,55,34,5,-21
-42.06837,-20.73445,55,35,5,-20
-42.06814,-20.73445,55,39,5,-16
-42.06769,-20.73445,58,36,5,-22
-42.06747,-20.73445,62,36,5,-26
-42.06724,-20.73445,64,36,5,-28
-42.06702,-20.73445,64,36,5,-28
-42.06657,-20.73445,64,42,5,-22
-42.06634,-20.73445,63,43,5,-20
-42.06612,-20.73445,59,43,5,-16
-42.0659,-20.73445,58,46,5,-12
-42.06545,-20.73445,63,46,0,-17
-42.06522,-20.73445,57,46,0,-11
-42.065,-20.73445,57,45,0,-12
-42.06477,-20.73445,58,45,0,-13
-42.06455,-20.73445,57,45,0,-12
-42.0641,-20.73445,62,38,5,-24
-42.06387,-20.73445,61,39,5,-22
-42.06365,-20.73445,60,40,5,-20
-42.06342,-20.73445,60,40,5,-20
-42.06297,-20.73445,60,38,5,-22
-42.06275,-20.73445,60,38,5,-22
-42.06252,-20.73445,59,38,5,-21
-42.0623,-20.73445,59,39,5,-20
-42.06185,-20.73445,59,61,5,2
-42.06163,-20.73445,54,55,0,1
-42.0614,-20.73445,54,61,0,7
-42.06118,-20.73445,52,60,0,8
-42.06073,-20.73445,53,60,0,7
-42.0605,-20.73445,52,60,0,8
-42.06028,-20.73445,51,60,0,9
-42.06005,-20.73445,51,48,0,-3
-42.05983,-20.73445,50,53,0,3
-42.05938,-20.73445,50,57,0,7
-42.05915,-20.73445,51,57,0,6
-42.05893,-20.73445,50,54,0,4
-42.0587,-20.73445,49,55,0,6
-42.05826,-20.73445,47,55,0,8
-42.05803,-20.73445,49,55,0,6
-42.05781,-20.73445,47,50,0,3
-42.05758,-20.73445,43,45,0,2
-42.05713,-20.73445,32,54,0,22
-42.05691,-20.73445,11,54,0,43
-42.05668,-20.73445,10,54,0,44
-42.05646,-20.73445,26,52,0,26
-42.05601,-20.73445,47,54,0,7
-42.05578,-20.73445,40,53,0,13
-42.05556,-20.73445,31,52,0,21
-42.05533,-20.73445,31,49,0,18
-42.05511,-20.73445,29,50,0,21
-42.05466,-20.73445,32,52,0,20
-42.05443,-20.73445,33,51,0,18
-42.05421,-20.73445,30,50,0,20
-42.05399,-20.73445,25,52,0,27
-42.05354,-20.73445,22,49,0,27
-42.05331,-20.73445,23,48,0,25
-42.05309,-20.73445,24,50,0,26
-42.05286,-20.73445,28,50,0,22
-42.05241,-20.73445,22,53,0,31
-42.05219,-20.73445,20,69,0,49
-42.05196,-20.73445,22,69,0,47
-42.05174,-20.73445,21,68,0,47
-42.05129,-20.73445,21,68,0,47
-42.05106,-20.73445,24,68,0,44
-42.05084,-20.73445,22,67,0,45
-42.05061,-20.73445,24,67,0,43
-42.05039,-20.73445,24,62,0,38
-42.04994,-20.73445,24,55,0,31
-42.04972,-20.73445,24,56,0,32
-42.04949,-20.73445,23,51,0,28
-42.04927,-20.73445,23,52,0,29
-42.04882,-20.73445,23,55,0,32
-42.04859,-20.73445,23,54,0,31
-42.04837,-20.73445,22,52,0,30
-42.04814,-20.73445,20,51,0,31
-42.04769,-20.73445,21,73,0,52
-42.04747,-20.73445,22,53,0,31
-42.04724,-20.73445,24,73,0,49
-42.04702,-20.73445,24,55,0,31
-42.04657,-20.73445,24,72,0,48
-42.04635,-20.73445,23,72,0,49
-42.04612,-20.73445,22,72,0,50
-42.0459,-20.73445,24,72,0,48
-42.04545,-20.73445,25,72,0,47
-42.04522,-20.73445,30,72,0,42
-42.045,-20.73445,31,73,0,42
-42.04477,-20.73445,19,72,0,53
-42.04455,-20.73445,19,72,0,53
-42.0441,-20.73445,19,73,0,54
-42.04387,-20.73445,19,73,0,54
-42.04365,-20.73445,19,73,0,54
-42.04342,-20.73445,19,72,0,53
-42.04297,-20.73445,19,73,0,54
-42.04275,-20.73445,19,73,0,54
-42.04253,-20.73445,19,73,0,54
-42.0423,-20.73445,19,73,0,54
-42.04185,-20.73445,19,73,0,54
-42.04163,-20.73445,18,73,0,55
-42.0414,-20.73445,18,73,0,55
-42.04118,-20.73445,18,73,0,55
-42.04073,-20.73445,17,62,0,45
-42.0405,-20.73445,16,60,0,44
-42.04028,-20.73445,16,60,0,44
-42.04005,-20.73445,15,60,0,45
-42.03983,-20.73445,15,69,0,54
-42.03938,-20.73445,15,61,0,46
-42.03915,-20.73445,14,61,0,47
-42.03893,-20.73445,13,64,0,51
-42.0387,-20.73445,13,62,0,49
-42.03826,-20.73445,12,71,0,59
-42.03803,-20.73445,12,62,0,50
-42.03781,-20.73445,11,61,0,50
-42.03758,-20.73445,11,58,0,47
-42.03713,-20.73445,11,62,0,51
-42.03691,-20.73445,21,64,0,43
-42.03668,-20.73445,25,60,0,35
-42.03646,-20.73445,29,69,0,40
-42.03601,-20.73445,30,69,0,39
-42.03578,-20.73445,31,69,0,38
-42.03556,-20.73445,34,69,0,35
-42.03533,-20.73445,33,68,0,35
-42.03511,-20.73445,27,68,0,41
-42.03466,-20.73445,25,52,0,27
-42.03444,-20.73445,23,52,2,29
-42.03421,-20.73445,24,50,2,26
-42.03399,-20.73445,23,49,2,26
-42.03354,-20.73445,25,49,2,24
-42.03331,-20.73445,24,50,11,26
-42.03309,-20.73445,25,53,11,28
-42.03286,-20.73445,31,48,2,17
-42.03241,-20.73445,40,47,2,7
-42.03219,-20.73445,39,47,2,8
-42.03196,-20.73445,40,47,2,7
-42.03174,-20.73445,47,47,2,0
-42.03129,-20.73445,48,56,2,8
-42.03106,-20.73445,48,51,11,3
-42.03084,-20.73445,48,53,2,5
-42.03062,-20.73445,44,53,2,9
-42.03017,-20.73445,44,53,2,9
-42.02994,-20.73445,49,54,11,5
-42.02972,-20.73445,45,53,2,8
-42.02949,-20.73445,50,52,2,2
-42.02927,-20.73445,50,52,2,2
-42.02882,-20.73445,50,52,2,2
-42.02859,-20.73445,46,52,11,6
-42.02837,-20.73445,46,51,11,5
-42.02814,-20.73445,50,51,2,1
-42.02769,-20.73445,51,51,2,0
-42.02747,-20.73445,48,50,5,2
-42.02724,-20.73445,53,53,5,0
-42.02702,-20.73445,55,56,11,1
-42.02657,-20.73445,46,51,5,5
-42.02635,-20.73445,49,55,11,6
-42.02612,-20.73445,49,54,5,5
-42.0259,-20.73445,40,53,5,13
-42.02545,-20.73445,40,52,5,12
-42.02522,-20.73445,44,53,11,9
-42.025,-20.73445,45,53,5,8
-42.02477,-20.73445,47,51,5,4
-42.02455,-20.73445,50,50,5,0
-42.0241,-20.73445,57,57,11,0
-42.02387,-20.73445,58,57,11,-1
-42.02365,-20.73445,57,57,5,0
-42.02342,-20.73445,56,56,5,0
-42.02297,-20.73445,54,58,5,4
-42.02275,-20.73445,53,56,11,3
-42.02253,-20.73445,52,57,5,5
-42.0223,-20.73445,45,55,5,10
-42.02185,-20.73445,46,54,5,8
-42.02163,-20.73445,47,53,5,6
-42.0214,-20.73445,47,52,5,5
-42.02118,-20.73445,48,51,5,3
-42.02073,-20.73445,52,52,5,0
-42.0205,-20.73445,52,51,5,-1
-42.02028,-20.73445,51,50,5,-1
-42.02005,-20.73445,55,50,5,-5
-42.01983,-20.73445,54,50,5,-4
-42.01938,-20.73445,53,48,2,-5
-42.01915,-20.73445,55,50,2,-5
-42.01893,-20.73445,52,50,11,-2
-42.01871,-20.73445,52,51,2,-1
-42.01826,-20.73445,51,51,11,0
-42.01803,-20.73445,51,51,2,0
-42.01781,-20.73445,50,50,2,0
-42.01758,-20.73445,49,51,2,2
-42.01713,-20.73445,48,50,11,2
-42.01691,-20.73445,48,50,11,2
-42.01668,-20.73445,47,50,11,3
-42.01646,-20.73445,48,48,2,0
-42.01601,-20.73445,52,53,11,1
-42.01578,-20.73445,49,48,2,-1
-42.01556,-20.73445,48,48,11,0
-42.01533,-20.73445,48,51,11,3
-42.01511,-20.73445,48,47,11,-1
-42.01466,-20.73445,49,48,2,-1
-42.01444,-20.73445,49,48,2,-1
-42.01421,-20.73445,49,48,11,-1
-42.01399,-20.73445,49,50,2,1
-42.01354,-20.73445,48,48,2,0
-42.01331,-20.73445,48,48,2,0
-42.01309,-20.73445,48,48,5,0
-42.01286,-20.73445,48,47,5,-1
-42.01241,-20.73445,52,47,5,-5
-42.01219,-20.73445,49,47,5,-2
-42.01196,-20.73445,49,47,5,-2
-42.01174,-20.73445,49,48,5,-1
-42.01129,-20.73445,50,50,5,0
-42.01106,-20.73445,52,53,5,1
-42.01084,-20.73445,54,55,5,1
-42.01062,-20.73445,49,48,5,-1
-42.01017,-20.73445,49,46,5,-3
-42.00994,-20.73445,49,46,5,-3
-42.00972,-20.73445,49,47,0,-2
-42.00949,-20.73445,48,47,0,-1
-42.00927,-20.73445,48,47,0,-1
-42.00882,-20.73445,47,43,5,-4
-42.00859,-20.73445,47,43,5,-4
-42.00837,-20.73445,47,43,5,-4
-42.00814,-20.73445,47,43,5,-4
-42.00769,-20.73445,51,42,5,-9
-42.00747,-20.73445,51,41,5,-10
-42.00724,-20.73445,52,42,5,-10
-42.00702,-20.73445,52,42,5,-10
-42.00657,-20.73445,54,42,5,-12
-42.00635,-20.73445,57,41,5,-16
-42.00612,-20.73445,57,41,5,-16
-42.0059,-20.73445,57,42,5,-15
-42.00545,-20.73445,57,42,5,-15
-42.00522,-20.73445,58,42,5,-16
-42.005,-20.73445,58,42,5,-16
-42.00477,-20.73445,58,41,5,-17
-42.00455,-20.73445,58,41,5,-17
-42.0041,-20.73445,58,40,5,-18
-42.00387,-20.73445,54,40,5,-14
-42.00365,-20.73445,52,40,5,-12
-42.00342,-20.73445,52,40,5,-12
-42.00298,-20.73445,53,40,5,-13
-42.00275,-20.73445,52,40,5,-12
-42.00253,-20.73445,54,40,5,-14
-42.0023,-20.73445,52,40,5,-12
-42.00185,-20.73445,53,43,0,-10
-42.00163,-20.73445,56,44,0,-12
-42.0014,-20.73445,56,43,0,-13
-42.00118,-20.73445,59,43,0,-16
-42.00073,-20.73445,57,44,0,-13
-42.0005,-20.73445,58,43,0,-15
-42.00028,-20.73445,56,43,11,-13
-42.00005,-20.73445,55,44,0,-11
-41.99983,-20.73445,54,44,0,-10
-41.99938,-20.73445,54,44,0,-10
-41.99916,-20.73445,54,44,0,-10
-41.99893,-20.73445,57,44,0,-13
-41.99871,-20.73445,60,43,11,-17
-41.99826,-20.73445,61,43,0,-18
-41.99803,-20.73445,60,43,0,-17
-41.99781,-20.73445,59,43,0,-16
-41.99758,-20.73445,63,43,0,-20
-41.99713,-20.73445,62,37,5,-25
-41.99691,-20.73445,60,37,5,-23
-41.99668,-20.73445,59,37,5,-22
-41.99646,-20.73445,59,37,5,-22
-41.99601,-20.73445,59,38,5,-21
-41.99578,-20.73445,58,39,5,-19
-41.99556,-20.73445,58,39,5,-19
-41.99533,-20.73445,57,43,5,-14
-41.99511,-20.73445,57,42,5,-15
-41.99466,-20.73445,56,42,5,-14
-41.99444,-20.73445,56,41,5,-15
-41.99421,-20.73445,56,37,5,-19
-41.99399,-20.73445,56,36,5,-20
-41.99354,-20.73445,59,36,0,-23
-41.99331,-20.73445,61,37,0,-24
-41.99309,-20.73445,62,39,0,-23
-41.99286,-20.73445,61,40,0,-21
-41.99241,-20.73445,61,37,5,-24
-41.99219,-20.73445,64,34,5,-30
-41.99196,-20.73445,66,34,5,-32
-41.99174,-20.73445,64,35,5,-29
-41.99129,-20.73445,64,36,0,-28
-41.99107,-20.73445,64,36,0,-28
-41.99084,-20.73445,63,36,0,-27
-41.99062,-20.73445,62,36,0,-26
-41.99017,-20.73445,62,35,0,-27
-41.98994,-20.73445,62,34,0,-28
-41.98972,-20.73445,61,35,0,-26
-41.98949,-20.73445,61,34,0,-27
-41.98927,-20.73445,62,35,0,-27
-41.98882,-20.73445,66,36,0,-30
-41.98859,-20.73445,63,37,0,-26
-41.98837,-20.73445,62,38,0,-24
-41.98814,-20.73445,61,38,11,-23
-41.98769,-20.73445,60,40,0,-20
-41.98747,-20.73445,60,40,0,-20
-41.98725,-20.73445,59,41,0,-18
-41.98702,-20.73445,59,41,5,-18
-41.98657,-20.73445,59,40,5,-19
-41.98635,-20.73445,58,40,5,-18
-41.98612,-20.73445,58,40,5,-18
-41.9859,-20.73445,58,40,5,-18
-41.98545,-20.73445,58,41,5,-17
-41.98522,-20.73445,58,41,0,-17
-41.985,-20.73445,58,41,0,-17
-41.98477,-20.73445,58,41,0,-17
-41.98455,-20.73445,61,41,0,-20
-41.9841,-20.73445,61,41,0,-20
-41.98387,-20.73445,59,41,0,-18
-41.98365,-20.73445,59,41,0,-18
-41.98343,-20.73445,59,41,0,-18
-41.98298,-20.73445,60,41,0,-19
-41.98275,-20.73445,60,41,0,-19
-41.98253,-20.73445,60,41,0,-19
-41.9823,-20.73445,58,41,0,-17
-41.98185,-20.73445,58,41,0,-17
-41.98163,-20.73445,58,41,0,-17
-41.9814,-20.73445,58,41,0,-17
-41.98118,-20.73445,58,41,0,-17
-41.98073,-20.73445,58,35,5,-23
-41.9805,-20.73445,58,33,5,-25
-41.98028,-20.73445,58,31,5,-27
-41.98005,-20.73445,58,31,5,-27
-41.97983,-20.73445,58,31,5,-27
-41.97938,-20.73445,58,39,5,-19
-41.97916,-20.73445,58,42,0,-16
-41.97893,-20.73445,57,42,0,-15
-41.97871,-20.73445,57,42,0,-15
-41.97826,-20.73445,57,43,0,-14
-41.97803,-20.73445,57,44,0,-13
-41.97781,-20.73445,57,44,0,-13
-41.97758,-20.73445,57,45,0,-12
-41.97713,-20.73445,57,45,0,-12
-41.97691,-20.73445,57,45,0,-12
-41.97668,-20.73445,57,45,0,-12
-41.97646,-20.73445,57,45,0,-12
-41.97601,-20.73445,57,45,0,-12
-41.97578,-20.73445,57,45,0,-12
-41.97556,-20.73445,57,45,11,-12
-41.97534,-20.73445,57,45,0,-12
-41.97511,-20.73445,57,45,0,-12
-41.97466,-20.73445,57,45,0,-12
-41.97444,-20.73445,57,45,0,-12
-41.97421,-20.73445,57,45,5,-12
-41.97399,-20.73445,57,46,5,-11
-41.97354,-20.73445,57,46,5,-11
-41.97331,-20.73445,57,46,5,-11
-41.97309,-20.73445,56,46,0,-10
-41.97286,-20.73445,56,46,0,-10
-41.97241,-20.73445,56,46,0,-10
-41.97219,-20.73445,56,46,0,-10
-41.97196,-20.73445,56,46,0,-10
-41.97174,-20.73445,56,46,0,-10
-41.97129,-20.73445,56,46,5,-10
-41.97107,-20.73445,59,38,5,-21
-41.97084,-20.73445,61,35,5,-26
-41.97062,-20.73445,62,33,5,-29
-41.97017,-20.73445,62,32,5,-30
-41.96994,-20.73445,61,30,5,-31
-41.96972,-20.73445,59,32,5,-27
-41.96949,-20.73445,56,34,0,-22
-41.96927,-20.73445,56,38,0,-18
-42.1005,-20.73424,70,26,5,-44
-42.0978,-20.73424,68,26,0,-42
-42.09511,-20.73424,62,20,0,-42
-42.09219,-20.73424,68,25,5,-43
-42.08949,-20.73424,67,37,0,-30
-42.08657,-20.73424,61,31,5,-30
-42.08387,-20.73424,62,32,5,-30
-42.08118,-20.73424,59,33,5,-26
-42.07825,-20.73424,62,40,5,-22
-42.07556,-20.73424,61,34,5,-27
-42.07286,-20.73424,55,39,5,-16
-42.06994,-20.73424,55,38,5,-17
-42.06724,-20.73424,64,35,5,-29
-42.06455,-20.73424,56,43,0,-13
-42.06163,-20.73424,59,61,0,2
-42.05893,-20.73424,49,55,0,6
-42.05601,-20.73424,41,53,0,12
-42.05331,-20.73424,28,48,0,20
-42.05061,-20.73424,24,66,0,42
-42.04769,-20.73424,24,53,0,29
-42.045,-20.73424,19,72,0,53
-42.0423,-20.73424,5,73,0,68
-42.03938,-20.73424,14,61,0,47
-42.03668,-20.73424,28,69,0,41
-42.03399,-20.73424,26,52,2,26
-42.03106,-20.73424,45,51,2,6
-42.02837,-20.73424,49,51,2,2
-42.02545,-20.73424,41,52,5,11
-42.02275,-20.73424,52,56,5,4
-42.02005,-20.73424,54,50,5,-4
-42.01713,-20.73424,48,48,2,0
-42.01444,-20.73424,49,48,11,-1
-42.01174,-20.73424,49,50,5,1
-42.00882,-20.73424,47,43,5,-4
-42.00612,-20.73424,59,41,5,-18
-42.00342,-20.73424,51,40,5,-11
-42.0005,-20.73424,58,43,0,-15
-41.99781,-20.73424,60,43,5,-17
-41.99511,-20.73424,57,43,5,-14
-41.99219,-20.73424,64,35,5,-29
-41.98949,-20.73424,61,35,0,-26
-41.98657,-20.73424,58,40,5,-18
-41.98387,-20.73424,61,41,0,-20
-41.98118,-20.73424,58,41,0,-17
-41.97826,-20.73424,57,43,0,-14
-41.97556,-20.73424,57,45,11,-12
-41.97286,-20.73424,56,46,0,-10
-41.96994,-20.73424,64,36,5,-28
-42.1005,-20.73382,70,27,5,-43
-42.0978,-20.73382,68,26,0,-42
-42.09511,-20.73382,63,22,0,-41
-42.09219,-20.73382,68,23,5,-45
-42.08949,-20.73382,67,27,5,-40
-42.08657,-20.73382,62,31,5,-31
-42.08387,-20.73382,62,30,5,-32
-42.08118,-20.73382,60,33,5,-27
-42.07825,-20.73382,62,41,0,-21
-42.07556,-20.73382,61,35,5,-26
-42.07286,-20.73382,56,39,5,-17
-42.06994,-20.73382,55,41,5,-14
-42.06724,-20.73382,64,36,5,-28
-42.06455,-20.73382,58,42,0,-16
-42.06163,-20.73382,55,56,0,1
-42.05893,-20.73382,47,47,0,0
-42.05601,-20.73382,32,53,0,21
-42.05331,-20.73382,34,49,0,15
-42.05061,-20.73382,24,65,0,41
-42.04769,-20.73382,27,66,0,39
-42.045,-20.73382,33,67,0,34
-42.0423,-20.73382,17,72,0,55
-42.03938,-20.73382,14,60,0,46
-42.03668,-20.73382,32,62,0,30
-42.03399,-20.73382,33,52,2,19
-42.03106,-20.73382,47,51,2,4
-42.02837,-20.73382,45,51,2,6
-42.02545,-20.73382,41,54,5,13
-42.02275,-20.73382,52,56,5,4
-42.02005,-20.73382,54,50,5,-4
-42.01713,-20.73382,49,48,2,-1
-42.01444,-20.73382,49,48,11,-1
-42.01174,-20.73382,49,49,5,0
-42.00882,-20.73382,46,43,5,-3
-42.00612,-20.73382,56,41,5,-15
-42.00342,-20.73382,48,41,5,-7
-42.0005,-20.73382,58,42,0,-16
-41.99781,-20.73382,62,40,5,-22
-41.99511,-20.73382,58,42,5,-16
-41.99219,-20.73382,62,38,0,-24
-41.98949,-20.73382,63,35,0,-28
-41.98657,-20.73382,58,40,0,-18
-41.98387,-20.73382,62,40,0,-22
-41.98118,-20.73382,60,41,0,-19
-41.97826,-20.73382,57,44,0,-13
-41.97556,-20.73382,57,45,11,-12
-41.97286,-20.73382,56,46,0,-10
-41.96994,-20.73382,63,36,0,-27
-42.1005,-20.73361,70,27,5,-43
-42.0978,-20.73361,68,27,0,-41
-42.09511,-20.73361,63,21,0,-42
-42.09219,-20.73361,69,23,5,-46
-42.08949,-20.73361,67,24,5,-43
-42.08657,-20.73361,65,30,5,-35
-42.08387,-20.73361,63,28,5,-35
-42.08118,-20.73361,60,33,5,-27
-42.07825,-20.73361,63,40,0,-23
-42.07556,-20.73361,60,34,5,-26
-42.07286,-20.73361,55,39,5,-16
-42.06994,-20.73361,55,38,5,-17
-42.06724,-20.73361,64,36,5,-28
-42.06455,-20.73361,64,42,5,-22
-42.06163,-20.73361,59,60,0,1
-42.05893,-20.73361,44,47,0,3
-42.05601,-20.73361,37,53,0,16
-42.05331,-20.73361,37,48,0,11
-42.05061,-20.73361,24,65,0,41
-42.04769,-20.73361,29,65,0,36
-42.045,-20.73361,35,66,0,31
-42.0423,-20.73361,17,72,0,55
-42.03938,-20.73361,14,60,0,46
-42.03668,-20.73361,32,64,0,32
-42.03399,-20.73361,37,53,2,16
-42.03106,-20.73361,46,53,2,7
-42.02837,-20.73361,44,51,2,7
-42.02545,-20.73361,42,54,5,12
-42.02275,-20.73361,53,54,5,1
-42.02005,-20.73361,53,50,5,-3
-42.01713,-20.73361,49,50,11,1
-42.01444,-20.73361,49,51,2,2
-42.01174,-20.73361,49,49,5,0
-42.00882,-20.73361,46,43,5,-3
-42.00612,-20.73361,54,41,5,-13
-42.00342,-20.73361,46,41,5,-5
-42.0005,-20.73361,57,42,0,-15
-41.99781,-20.73361,61,40,5,-21
-41.99511,-20.73361,58,42,5,-16
-41.99219,-20.73361,61,38,0,-23
-41.98949,-20.73361,63,35,0,-28
-41.98657,-20.73361,58,39,0,-19
-41.98387,-20.73361,63,40,0,-23
-41.98118,-20.73361,62,41,0,-21
-41.97826,-20.73361,57,44,0,-13
-41.97556,-20.73361,57,45,0,-12
-41.97286,-20.73361,56,46,0,-10
-41.96994,-20.73361,62,35,5,-27
-42.1005,-20.73339,73,27,5,-46
-42.0978,-20.73339,67,27,0,-40
-42.09511,-20.73339,66,23,0,-43
-42.09219,-20.73339,69,23,5,-46
-42.08949,-20.73339,63,22,5,-41
-42.08657,-20.73339,68,31,5,-37
-42.08387,-20.73339,63,27,5,-36
-42.08118,-20.73339,60,33,5,-27
-42.07825,-20.73339,62,41,0,-21
-42.07556,-20.73339,58,34,5,-24
-42.07286,-20.73339,56,39,5,-17
-42.06994,-20.73339,55,41,5,-14
-42.06724,-20.73339,58,38,5,-20
-42.06455,-20.73339,65,36,5,-29
-42.06163,-20.73339,53,61,0,8
-42.05893,-20.73339,40,53,0,13
-42.05601,-20.73339,32,53,0,21
-42.05331,-20.73339,38,48,0,10
-42.05061,-20.73339,24,66,0,42
-42.04769,-20.73339,31,64,0,33
-42.045,-20.73339,27,66,0,39
-42.0423,-20.73339,11,71,0,60
-42.03938,-20.73339,3,59,0,56
-42.03668,-20.73339,32,69,0,37
-42.03399,-20.73339,39,53,11,14
-42.03106,-20.73339,42,56,11,14
-42.02837,-20.73339,44,51,2,7
-42.02545,-20.73339,41,54,5,13
-42.02275,-20.73339,53,53,5,0
-42.02005,-20.73339,54,52,5,-2
-42.01713,-20.73339,50,50,2,0
-42.01444,-20.73339,49,49,2,0
-42.01174,-20.73339,49,49,5,0
-42.00882,-20.73339,46,44,5,-2
-42.00612,-20.73339,49,41,5,-8
-42.00342,-20.73339,45,42,5,-3
-42.0005,-20.73339,56,42,0,-14
-41.99781,-20.73339,60,40,5,-20
-41.99511,-20.73339,59,46,5,-13
-41.99219,-20.73339,60,38,0,-22
-41.98949,-20.73339,63,35,0,-28
-41.98657,-20.73339,58,39,5,-19
-41.98387,-20.73339,62,40,0,-22
-41.98118,-20.73339,63,41,5,-22
-41.97826,-20.73339,58,44,0,-14
-41.97556,-20.73339,57,45,0,-12
-41.97286,-20.73339,56,45,0,-11
-41.96994,-20.73339,63,32,5,-31
-42.1005,-20.73297,73,27,5,-46
-42.0978,-20.73297,68,28,0,-40
-42.09511,-20.73297,66,26,0,-40
-42.09219,-20.73297,69,23,5,-46
-42.08949,-20.73297,74,21,5,-53
-42.08657,-20.73297,71,28,5,-43
-42.08387,-20.73297,63,27,5,-36
-42.08118,-20.73297,60,31,5,-29
-42.07825,-20.73297,62,41,0,-21
-42.07556,-20.73297,57,34,5,-23
-42.07286,-20.73297,55,39,5,-16
-42.06994,-20.73297,55,42,5,-13
-42.06724,-20.73297,59,38,5,-21
-42.06455,-20.73297,65,36,5,-29
-42.06163,-20.73297,53,61,0,8
-42.05893,-20.73297,33,53,0,20
-42.05601,-20.73297,21,51,0,30
-42.05331,-20.73297,32,49,0,17
-42.05061,-20.73297,30,65,0,35
-42.04769,-20.73297,31,63,0,32
-42.045,-20.73297,29,65,0,36
-42.0423,-20.73297,16,61,0,45
-42.03938,-20.73297,3,60,0,57
-42.03668,-20.73297,32,69,0,37
-42.03399,-20.73297,36,53,2,17
-42.03106,-20.73297,42,54,2,12
-42.02837,-20.73297,44,57,11,13
-42.02545,-20.73297,41,59,5,18
-42.02275,-20.73297,53,53,5,0
-42.02005,-20.73297,53,53,5,0
-42.01713,-20.73297,51,51,2,0
-42.01444,-20.73297,49,49,5,0
-42.01174,-20.73297,49,48,5,-1
-42.00882,-20.73297,45,44,5,-1
-42.00612,-20.73297,46,42,5,-4
-42.00342,-20.73297,47,44,0,-3
-42.0005,-20.73297,57,41,0,-16
-41.99781,-20.73297,60,43,5,-17
-41.99511,-20.73297,59,46,5,-13
-41.99219,-20.73297,60,37,0,-23
-41.98949,-20.73297,64,36,0,-28
-41.98657,-20.73297,57,31,5,-26
-41.98387,-20.73297,64,40,0,-24
-41.98118,-20.73297,63,31,5,-32
-41.97826,-20.73297,58,44,0,-14
-41.97556,-20.73297,58,45,0,-13
-41.97286,-20.73297,56,46,0,-10
-41.96994,-20.73297,61,32,5,-29
-42.1005,-20.73276,73,27,5,-46
-42.0978,-20.73276,68,28,0,-40
-42.09511,-20.73276,79,26,0,-53
-42.09219,-20.73276,69,23,5,-46
-42.08949,-20.73276,75,23,5,-52
-42.08657,-20.73276,68,30,5,-38
-42.08387,-20.73276,62,26,5,-36
-42.08118,-20.73276,60,31,5,-29
-42.07825,-20.73276,61,41,0,-20
-42.07556,-20.73276,55,34,5,-21
-42.07286,-20.73276,56,59,5,3
-42.06994,-20.73276,56,43,5,-13
-42.06724,-20.73276,58,49,5,-9
-42.06455,-20.73276,62,34,5,-28
-42.06163,-20.73276,56,57,0,1
-42.05893,-20.73276,28,53,0,25
-42.05601,-20.73276,18,54,0,36
-42.05331,-20.73276,26,51,0,25
-42.05061,-20.73276,28,63,0,35
-42.04769,-20.73276,31,63,0,32
-42.045,-20.73276,30,64,0,34
-42.0423,-20.73276,19,60,2,41
-42.03938,-20.73276,12,62,0,50
-42.03668,-20.73276,32,70,0,38
-42.03399,-20.73276,35,56,11,21
-42.03106,-20.73276,41,54,2,13
-42.02837,-20.73276,44,55,11,11
-42.02545,-20.73276,43,59,5,16
-42.02275,-20.73276,53,53,5,0
-42.02005,-20.73276,51,51,5,0
-42.01713,-20.73276,53,53,11,0
-42.01444,-20.73276,49,49,5,0
-42.01174,-20.73276,49,48,5,-1
-42.00882,-20.73276,46,44,5,-2
-42.00612,-20.73276,44,42,5,-2
-42.00342,-20.73276,51,44,0,-7
-42.0005,-20.73276,58,40,11,-18
-41.99781,-20.73276,59,45,5,-14
-41.99511,-20.73276,59,44,5,-15
-41.99219,-20.73276,58,38,0,-20
-41.98949,-20.73276,63,36,0,-27
-41.98657,-20.73276,58,34,5,-24
-41.98387,-20.73276,66,41,0,-25
-41.98118,-20.73276,63,32,5,-31
-41.97826,-20.73276,59,44,0,-15
-41.97556,-20.73276,58,45,0,-13
-41.97286,-20.73276,55,46,0,-9
-41.96994,-20.73276,59,46,5,-13
-42.1005,-20.73255,73,27,5,-46
-42.0978,-20.73255,69,28,0,-41
-42.09511,-20.73255,80,27,0,-53
-42.09219,-20.73255,70,24,5,-46
-42.08949,-20.73255,77,23,5,-54
-42.08657,-20.73255,65,34,5,-31
-42.08387,-20.73255,63,26,5,-37
-42.08118,-20.73255,59,31,5,-28
-42.07825,-20.73255,61,40,0,-21
-42.07556,-20.73255,55,34,5,-21
-42.07286,-20.73255,56,55,0,-1
-42.06994,-20.73255,57,43,5,-14
-42.06724,-20.73255,57,38,5,-19
-42.06455,-20.73255,62,32,5,-30
-42.06163,-20.73255,59,60,0,1
-42.05893,-20.73255,27,49,0,22
-42.05601,-20.73255,16,49,0,33
-42.05331,-20.73255,30,53,0,23
-42.05061,-20.73255,21,59,0,38
-42.04769,-20.73255,31,63,0,32
-42.045,-20.73255,30,64,0,34
-42.0423,-20.73255,24,60,2,36
-42.03938,-20.73255,11,58,0,47
-42.03668,-20.73255,30,69,0,39
-42.03399,-20.73255,36,56,2,20
-42.03106,-20.73255,39,53,11,14
-42.02837,-20.73255,44,55,2,11
-42.02545,-20.73255,43,60,5,17
-42.02275,-20.73255,53,53,5,0
-42.02005,-20.73255,50,51,5,1
-42.01713,-20.73255,53,53,2,0
-42.01444,-20.73255,50,50,5,0
-42.01174,-20.73255,48,48,5,0
-42.00882,-20.73255,46,46,5,0
-42.00612,-20.73255,44,43,5,-1
-42.00342,-20.73255,54,45,0,-9
-42.0005,-20.73255,59,41,0,-18
-41.99781,-20.73255,61,44,5,-17
-41.99511,-20.73255,60,39,5,-21
-41.99219,-20.73255,57,38,0,-19
-41.98949,-20.73255,62,36,0,-26
-41.98657,-20.73255,58,40,5,-18
-41.98387,-20.73255,67,41,0,-26
-41.98118,-20.73255,63,36,5,-27
-41.97826,-20.73255,59,44,0,-15
-41.97556,-20.73255,58,45,0,-13
-41.97286,-20.73255,55,46,0,-9
-41.96994,-20.73255,54,47,0,-7
-42.1005,-20.73213,73,29,5,-44
-42.0978,-20.73213,70,28,0,-42
-42.09511,-20.73213,82,26,0,-56
-42.09219,-20.73213,90,23,5,-67
-42.08949,-20.73213,74,23,5,-51
-42.08657,-20.73213,77,31,5,-46
-42.08387,-20.73213,64,28,5,-36
-42.08118,-20.73213,59,32,5,-27
-42.07825,-20.73213,61,41,0,-20
-42.07556,-20.73213,55,32,5,-23
-42.07286,-20.73213,56,55,0,-1
-42.06994,-20.73213,56,47,5,-9
-42.06724,-20.73213,56,36,5,-20
-42.06455,-20.73213,61,48,11,-13
-42.06163,-20.73213,61,54,0,-7
-42.05893,-20.73213,30,44,0,14
-42.05601,-20.73213,26,53,0,27
-42.05331,-20.73213,33,52,0,19
-42.05061,-20.73213,21,59,0,38
-42.04769,-20.73213,33,63,0,30
-42.045,-20.73213,28,61,0,33
-42.0423,-20.73213,29,60,2,31
-42.03938,-20.73213,9,57,0,48
-42.03668,-20.73213,26,69,0,43
-42.03399,-20.73213,34,52,2,18
-42.03106,-20.73213,39,53,2,14
-42.02837,-20.73213,47,56,2,9
-42.02545,-20.73213,42,62,5,20
-42.02275,-20.73213,50,52,5,2
-42.02005,-20.73213,48,52,0,4
-42.01713,-20.73213,52,52,11,0
-42.01444,-20.73213,50,48,5,-2
-42.01174,-20.73213,48,49,5,1
-42.00882,-20.73213,46,47,5,1
-42.00612,-20.73213,44,43,5,-1
-42.00342,-20.73213,54,45,0,-9
-42.0005,-20.73213,60,43,0,-17
-41.99781,-20.73213,59,45,5,-14
-41.99511,-20.73213,60,43,5,-17
-41.99219,-20.73213,57,37,0,-20
-41.98949,-20.73213,63,37,0,-26
-41.98657,-20.73213,58,40,0,-18
-41.98387,-20.73213,68,42,0,-26
-41.98118,-20.73213,63,45,0,-18
-41.97826,-20.73213,59,43,0,-16
-41.97556,-20.73213,58,45,0,-13
-41.97286,-20.73213,56,45,0,-11
-41.96994,-20.73213,54,47,0,-7
-42.1005,-20.73192,77,28,5,-49
-42.0978,-20.73192,69,28,0,-41
-42.09511,-20.73192,82,26,0,-56
-42.09219,-20.73192,73,23,5,-50
-42.08949,-20.73192,79,23,5,-56
-42.08657,-20.73192,67,32,5,-35
-42.08387,-20.73192,66,28,5,-38
-42.08118,-20.73192,58,32,5,-26
-42.07825,-20.73192,60,42,0,-18
-42.07556,-20.73192,55,32,5,-23
-42.07286,-20.73192,56,50,0,-6
-42.06994,-20.73192,60,47,0,-13
-42.06724,-20.73192,55,37,5,-18
-42.06455,-20.73192,61,39,5,-22
-42.06163,-20.73192,60,49,5,-11
-42.05893,-20.73192,31,47,0,16
-42.05601,-20.73192,32,55,0,23
-42.05331,-20.73192,26,52,0,26
-42.05061,-20.73192,23,58,0,35
-42.04769,-20.73192,32,63,0,31
-42.045,-20.73192,30,62,0,32
-42.0423,-20.73192,33,60,2,27
-42.03938,-20.73192,20,61,0,41
-42.03668,-20.73192,26,69,0,43
-42.03399,-20.73192,23,47,2,24
-42.03106,-20.73192,39,51,11,12
-42.02837,-20.73192,51,58,2,7
-42.02545,-20.73192,42,61,5,19
-42.02275,-20.73192,47,54,0,7
-42.02005,-20.73192,43,51,0,8
-42.01713,-20.73192,50,49,11,-1
-42.01444,-20.73192,50,48,5,-2
-42.01174,-20.73192,48,49,5,1
-42.00882,-20.73192,46,46,5,0
-42.00612,-20.73192,43,45,5,2
-42.00342,-20.73192,53,46,0,-7
-42.0005,-20.73192,60,43,0,-17
-41.99781,-20.73192,59,44,5,-15
-41.99511,-20.73192,60,48,5,-12
-41.99219,-20.73192,57,37,0,-20
-41.98949,-20.73192,64,38,0,-26
-41.98657,-20.73192,58,39,0,-19
-41.98387,-20.73192,68,42,0,-26
-41.98118,-20.73192,64,45,0,-19
-41.97826,-20.73192,59,41,0,-18
-41.97556,-20.73192,58,45,0,-13
-41.97286,-20.73192,56,45,0,-11
-41.96994,-20.73192,54,47,0,-7
-42.10297,-20.7317,68,25,5,-43
-42.10275,-20.7317,70,25,5,-45
-42.10252,-20.7317,71,26,5,-45
-42.1023,-20.7317,72,26,5,-46
-42.10185,-20.7317,77,26,5,-51
-42.10163,-20.7317,80,26,5,-54
-42.1014,-20.7317,81,27,5,-54
-42.10118,-20.7317,81,27,5,-54
-42.10073,-20.7317,81,27,5,-54
-42.1005,-20.7317,82,29,5,-53
-42.10028,-20.7317,91,32,5,-59
-42.10005,-20.7317,80,30,5,-50
-42.09983,-20.7317,73,31,5,-42
-42.09938,-20.7317,71,31,0,-40
-42.09915,-20.7317,70,30,0,-40
-42.09893,-20.7317,71,30,0,-41
-42.0987,-20.7317,70,29,0,-41
-42.09825,-20.7317,69,29,0,-40
-42.09803,-20.7317,71,28,0,-43
-42.0978,-20.7317,71,28,0,-43
-42.09758,-20.7317,69,28,0,-41
-42.09713,-20.7317,80,27,0,-53
-42.09691,-20.7317,80,27,0,-53
-42.09668,-20.7317,80,27,0,-53
-42.09646,-20.7317,80,27,0,-53
-42.09601,-20.7317,80,27,0,-53
-42.09578,-20.7317,80,27,0,-53
-42.09556,-20.7317,80,27,0,-53
-42.09533,-20.7317,80,26,0,-54
-42.09511,-20.7317,80,26,0,-54
-42.09466,-20.7317,80,26,0,-54
-42.09443,-20.7317,81,26,5,-55
-42.09421,-20.7317,81,23,5,-58
-42.09398,-20.7317,83,23,5,-60
-42.09354,-20.7317,91,23,5,-68
-42.09331,-20.7317,85,23,5,-62
-42.09309,-20.7317,72,24,5,-48
-42.09286,-20.7317,74,24,5,-50
-42.09241,-20.7317,75,23,5,-52
-42.09219,-20.7317,71,23,5,-48
-42.09196,-20.7317,82,24,5,-58
-42.09174,-20.7317,82,24,5,-58
-42.09129,-20.7317,90,23,5,-67
-42.09106,-20.7317,74,23,5,-51
-42.09084,-20.7317,70,24,5,-46
-42.09061,-20.7317,70,24,5,-46
-42.09039,-20.7317,81,24,5,-57
-42.08994,-20.7317,81,23,5,-58
-42.08972,-20.7317,80,23,5,-57
-42.08949,-20.7317,80,23,5,-57
-42.08927,-20.7317,79,22,5,-57
-42.08882,-20.7317,79,21,5,-58
-42.08859,-20.7317,79,21,5,-58
-42.08837,-20.7317,79,29,5,-50
-42.08814,-20.7317,79,28,5,-51
-42.08769,-20.7317,80,28,5,-52
-42.08747,-20.7317,81,29,5,-52
-42.08724,-20.7317,82,30,5,-52
-42.08702,-20.7317,82,32,5,-50
-42.08657,-20.7317,82,33,5,-49
-42.08634,-20.7317,81,34,5,-47
-42.08612,-20.7317,77,33,5,-44
-42.08589,-20.7317,67,34,5,-33
-42.08545,-20.7317,67,31,5,-36
-42.08522,-20.7317,66,31,5,-35
-42.085,-20.7317,68,30,5,-38
-42.08477,-20.7317,68,27,5,-41
-42.08455,-20.7317,66,27,5,-39
-42.0841,-20.7317,66,27,5,-39
-42.08387,-20.7317,68,28,5,-40
-42.08365,-20.7317,67,30,5,-37
-42.08342,-20.7317,67,30,5,-37
-42.08297,-20.7317,67,31,5,-36
-42.08275,-20.7317,66,31,5,-35
-42.08252,-20.7317,66,31,5,-35
-42.0823,-20.7317,65,30,5,-35
-42.08185,-20.7317,63,31,5,-32
-42.08163,-20.7317,60,32,5,-28
-42.0814,-20.7317,58,33,5,-25
-42.08118,-20.7317,58,33,5,-25
-42.08073,-20.7317,58,36,5,-22
-42.0805,-20.7317,58,35,5,-23
-42.08028,-20.7317,59,36,5,-23
-42.08005,-20.7317,60,46,5,-14
-42.07983,-20.7317,59,46,0,-13
-42.07938,-20.7317,59,46,0,-13
-42.07915,-20.7317,60,46,0,-14
-42.07893,-20.7317,60,45,0,-15
-42.0787,-20.7317,61,44,0,-17
-42.07825,-20.7317,59,43,0,-16
-42.07803,-20.7317,60,42,0,-18
-42.07781,-20.7317,60,41,0,-19
-42.07758,-20.7317,58,40,0,-18
-42.07713,-20.7317,58,32,5,-26
-42.07691,-20.7317,59,32,5,-27
-42.07668,-20.7317,59,33,5,-26
-42.07646,-20.7317,58,33,5,-25
-42.07601,-20.7317,55,32,5,-23
-42.07578,-20.7317,55,31,5,-24
-42.07556,-20.7317,55,34,5,-21
-42.07533,-20.7317,55,34,5,-21
-42.07511,-20.7317,55,34,5,-21
-42.07466,-20.7317,55,41,5,-14
-42.07443,-20.7317,55,48,0,-7
-42.07421,-20.7317,55,50,0,-5
-42.07399,-20.7317,55,53,0,-2
-42.07354,-20.7317,55,52,0,-3
-42.07331,-20.7317,55,51,0,-4
-42.07309,-20.7317,55,50,0,-5
-42.07286,-20.7317,56,50,0,-6
-42.07241,-20.7317,56,50,0,-6
-42.07219,-20.7317,56,50,0,-6
-42.07196,-20.7317,58,49,0,-9
-42.07174,-20.7317,59,49,0,-10
-42.07129,-20.7317,57,48,0,-9
-42.07106,-20.7317,58,48,0,-10
-42.07084,-20.7317,58,48,0,-10
-42.07061,-20.7317,64,47,0,-17
-42.07039,-20.7317,64,47,0,-17
-42.06994,-20.7317,63,47,0,-16
-42.06972,-20.7317,63,46,0,-17
-42.06949,-20.7317,63,46,0,-17
-42.06927,-20.7317,63,45,0,-18
-42.06882,-20.7317,63,45,0,-18
-42.06859,-20.7317,63,44,0,-19
-42.06837,-20.7317,64,44,0,-20
-42.06814,-20.7317,57,44,0,-13
-42.06769,-20.7317,57,37,5,-20
-42.06747,-20.7317,58,37,5,-21
-42.06724,-20.7317,56,37,5,-19
-42.06702,-20.7317,55,36,5,-19
-42.06657,-20.7317,55,37,5,-18
-42.06634,-20.7317,54,37,5,-17
-42.06612,-20.7317,54,36,5,-18
-42.0659,-20.7317,55,37,5,-18
-42.06545,-20.7317,61,38,11,-23
-42.06522,-20.7317,62,38,11,-24
-42.065,-20.7317,62,37,5,-25
-42.06477,-20.7317,61,36,5,-25
-42.06455,-20.7317,61,37,5,-24
-42.0641,-20.7317,61,39,5,-22
-42.06387,-20.7317,61,38,5,-23
-42.06365,-20.7317,61,41,5,-20
-42.06342,-20.7317,61,43,5,-18
-42.06297,-20.7317,61,44,5,-17
-42.06275,-20.7317,62,36,5,-26
-42.06252,-20.7317,62,36,5,-26
-42.0623,-20.7317,64,36,5,-28
-42.06185,-20.7317,61,38,5,-23
-42.06163,-20.7317,59,38,5,-21
-42.0614,-20.7317,59,38,5,-21
-42.06118,-20.7317,57,37,5,-20
-42.06073,-20.7317,50,49,5,-1
-42.0605,-20.7317,50,51,5,1
-42.06028,-20.7317,43,41,5,-2
-42.06005,-20.7317,38,38,5,0
-42.05983,-20.7317,35,40,5,5
-42.05938,-20.7317,38,47,0,9
-42.05915,-20.7317,34,46,0,12
-42.05893,-20.7317,32,45,0,13
-42.0587,-20.7317,37,41,0,4
-42.05826,-20.7317,33,41,5,8
-42.05803,-20.7317,36,41,5,5
-42.05781,-20.7317,35,41,5,6
-42.05758,-20.7317,33,42,5,9
-42.05713,-20.7317,35,61,0,26
-42.05691,-20.7317,35,61,0,26
-42.05668,-20.7317,36,60,0,24
-42.05646,-20.7317,36,59,0,23
-42.05601,-20.7317,37,57,0,20
-42.05578,-20.7317,36,57,0,21
-42.05556,-20.7317,36,54,0,18
-42.05533,-20.7317,36,54,0,18
-42.05511,-20.7317,36,54,0,18
-42.05466,-20.7317,37,53,0,16
-42.05443,-20.7317,36,53,0,17
-42.05421,-20.7317,34,53,0,19
-42.05399,-20.7317,35,53,0,18
-42.05354,-20.7317,36,53,0,17
-42.05331,-20.7317,33,52,0,19
-42.05309,-20.7317,28,52,0,24
-42.05286,-20.7317,24,51,0,27
-42.05241,-20.7317,24,50,0,26
-42.05219,-20.7317,18,49,0,31
-42.05196,-20.7317,23,50,0,27
-42.05174,-20.7317,12,50,0,38
-42.05129,-20.7317,21,50,0,29
-42.05106,-20.7317,22,50,0,28
-42.05084,-20.7317,23,52,0,29
-42.05061,-20.7317,23,61,0,38
-42.05039,-20.7317,24,63,0,39
-42.04994,-20.7317,27,64,0,37
-42.04972,-20.7317,30,64,0,34
-42.04949,-20.7317,30,64,0,34
-42.04927,-20.7317,30,63,0,33
-42.04882,-20.7317,32,62,0,30
-42.04859,-20.7317,33,63,0,30
-42.04837,-20.7317,33,64,0,31
-42.04814,-20.7317,33,64,0,31
-42.04769,-20.7317,34,63,0,29
-42.04747,-20.7317,32,62,0,30
-42.04724,-20.7317,33,62,0,29
-42.04702,-20.7317,33,61,0,28
-42.04657,-20.7317,31,61,0,30
-42.04635,-20.7317,31,61,0,30
-42.04612,-20.7317,32,61,0,29
-42.0459,-20.7317,31,61,0,30
-42.04545,-20.7317,32,61,0,29
-42.04522,-20.7317,32,61,0,29
-42.045,-20.7317,31,61,0,30
-42.04477,-20.7317,33,62,0,29
-42.04455,-20.7317,34,62,0,28
-42.0441,-20.7317,34,62,0,28
-42.04387,-20.7317,35,63,0,28
-42.04365,-20.7317,36,63,0,27
-42.04342,-20.7317,35,63,0,28
-42.04297,-20.7317,34,63,0,29
-42.04275,-20.7317,33,63,0,30
-42.04253,-20.7317,33,61,0,28
-42.0423,-20.7317,34,60,2,26
-42.04185,-20.7317,35,54,2,19
-42.04163,-20.7317,37,54,2,17
-42.0414,-20.7317,34,51,2,17
-42.04118,-20.7317,33,51,2,18
-42.04073,-20.7317,31,51,11,20
-42.0405,-20.7317,30,56,11,26
-42.04028,-20.7317,33,58,11,25
-42.04005,-20.7317,32,56,5,24
-42.03983,-20.7317,28,58,5,30
-42.03938,-20.7317,28,61,0,33
-42.03915,-20.7317,26,61,0,35
-42.03893,-20.7317,21,59,2,38
-42.0387,-20.7317,8,59,2,51
-42.03826,-20.7317,8,59,11,51
-42.03803,-20.7317,8,59,2,51
-42.03781,-20.7317,9,59,0,50
-42.03758,-20.7317,14,63,0,49
-42.03713,-20.7317,20,62,0,42
-42.03691,-20.7317,26,67,0,41
-42.03668,-20.7317,23,68,0,45
-42.03646,-20.7317,26,60,0,34
-42.03601,-20.7317,26,59,0,33
-42.03578,-20.7317,23,60,0,37
-42.03556,-20.7317,20,56,2,36
-42.03533,-20.7317,19,59,11,40
-42.03511,-20.7317,20,56,6,36
-42.03466,-20.7317,22,54,2,32
-42.03444,-20.7317,19,53,2,34
-42.03421,-20.7317,14,53,2,39
-42.03399,-20.7317,12,52,2,40
-42.03354,-20.7317,12,49,11,37
-42.03331,-20.7317,18,49,2,31
-42.03309,-20.7317,16,49,2,33
-42.03286,-20.7317,14,56,2,42
-42.03241,-20.7317,15,57,11,42
-42.03219,-20.7317,16,57,11,41
-42.03196,-20.7317,17,55,2,38
-42.03174,-20.7317,31,52,2,21
-42.03129,-20.7317,27,51,2,24
-42.03106,-20.7317,37,52,2,15
-42.03084,-20.7317,39,53,11,14
-42.03062,-20.7317,44,53,11,9
-42.03017,-20.7317,44,53,2,9
-42.02994,-20.7317,47,53,2,6
-42.02972,-20.7317,49,54,11,5
-42.02949,-20.7317,47,61,2,14
-42.02927,-20.7317,47,61,2,14
-42.02882,-20.7317,47,62,2,15
-42.02859,-20.7317,46,58,11,12
-42.02837,-20.7317,47,58,11,11
-42.02814,-20.7317,38,58,2,20
-42.02769,-20.7317,35,57,2,22
-42.02747,-20.7317,33,59,2,26
-42.02724,-20.7317,35,58,5,23
-42.02702,-20.7317,34,58,5,24
-42.02657,-20.7317,31,57,5,26
-42.02635,-20.7317,37,58,5,21
-42.02612,-20.7317,41,66,5,25
-42.0259,-20.7317,43,66,5,23
-42.02545,-20.7317,49,61,5,12
-42.02522,-20.7317,50,60,5,10
-42.025,-20.7317,50,59,5,9
-42.02477,-20.7317,50,59,5,9
-42.02455,-20.7317,48,58,5,10
-42.0241,-20.7317,50,57,11,7
-42.02387,-20.7317,48,56,5,8
-42.02365,-20.7317,49,55,5,6
-42.02342,-20.7317,49,55,5,6
-42.02297,-20.7317,48,55,0,7
-42.02275,-20.7317,47,54,0,7
-42.02253,-20.7317,49,53,0,4
-42.0223,-20.7317,47,53,0,6
-42.02185,-20.7317,46,49,5,3
-42.02163,-20.7317,46,49,5,3
-42.0214,-20.7317,46,49,5,3
-42.02118,-20.7317,45,50,5,5
-42.02073,-20.7317,44,51,5,7
-42.0205,-20.7317,43,50,5,7
-42.02028,-20.7317,42,50,5,8
-42.02005,-20.7317,42,51,0,9
-42.01983,-20.7317,42,54,0,12
-42.01938,-20.7317,47,50,11,3
-42.01915,-20.7317,51,50,11,-1
-42.01893,-20.7317,50,50,11,0
-42.01871,-20.7317,49,49,11,0
-42.01826,-20.7317,49,49,11,0
-42.01803,-20.7317,48,48,5,0
-42.01781,-20.7317,51,49,5,-2
-42.01758,-20.7317,49,49,5,0
-42.01713,-20.7317,49,49,5,0
-42.01691,-20.7317,51,53,5,2
-42.01668,-20.7317,50,49,5,-1
-42.01646,-20.7317,51,52,5,1
-42.01601,-20.7317,53,51,11,-2
-42.01578,-20.7317,50,51,5,1
-42.01556,-20.7317,49,49,5,0
-42.01533,-20.7317,49,49,5,0
-42.01511,-20.7317,49,49,5,0
-42.01466,-20.7317,51,48,5,-3
-42.01444,-20.7317,51,48,5,-3
-42.01421,-20.7317,50,49,5,-1
-42.01399,-20.7317,49,48,5,-1
-42.01354,-20.7317,49,48,5,-1
-42.01331,-20.7317,49,49,5,0
-42.01309,-20.7317,49,49,5,0
-42.01286,-20.7317,48,48,5,0
-42.01241,-20.7317,48,48,5,0
-42.01219,-20.7317,48,48,5,0
-42.01196,-20.7317,48,48,5,0
-42.01174,-20.7317,48,48,5,0
-42.01129,-20.7317,47,54,5,7
-42.01106,-20.7317,47,47,5,0
-42.01084,-20.7317,47,48,5,1
-42.01062,-20.7317,47,47,5,0
-42.01017,-20.7317,46,46,0,0
-42.00994,-20.7317,46,47,0,1
-42.00972,-20.7317,46,46,0,0
-42.00949,-20.7317,46,46,0,0
-42.00927,-20.7317,46,46,5,0
-42.00882,-20.7317,46,46,5,0
-42.00859,-20.7317,46,46,5,0
-42.00837,-20.7317,45,46,5,1
-42.00814,-20.7317,45,46,5,1
-42.00769,-20.7317,45,46,5,1
-42.00747,-20.7317,44,46,0,2
-42.00724,-20.7317,44,46,0,2
-42.00702,-20.7317,44,46,0,2
-42.00657,-20.7317,43,44,0,1
-42.00635,-20.7317,43,45,0,2
-42.00612,-20.7317,43,46,0,3
-42.0059,-20.7317,41,46,0,5
-42.00545,-20.7317,41,46,0,5
-42.00522,-20.7317,46,46,0,0
-42.005,-20.7317,41,46,0,5
-42.00477,-20.7317,48,46,0,-2
-42.00455,-20.7317,44,45,0,1
-42.0041,-20.7317,45,46,0,1
-42.00387,-20.7317,46,46,0,0
-42.00365,-20.7317,50,46,0,-4
-42.00342,-20.7317,50,46,0,-4
-42.00298,-20.7317,52,46,0,-6
-42.00275,-20.7317,60,46,0,-14
-42.00253,-20.7317,63,45,0,-18
-42.0023,-20.7317,62,45,0,-17
-42.00185,-20.7317,61,45,0,-16
-42.00163,-20.7317,61,45,11,-16
-42.0014,-20.7317,61,44,0,-17
-42.00118,-20.7317,61,44,0,-17
-42.00073,-20.7317,60,43,0,-17
-42.0005,-20.7317,60,44,0,-16
-42.00028,-20.7317,60,45,0,-15
-42.00005,-20.7317,60,45,0,-15
-41.99983,-20.7317,60,45,0,-15
-41.99938,-20.7317,60,45,0,-15
-41.99916,-20.7317,60,43,5,-17
-41.99893,-20.7317,60,40,5,-20
-41.99871,-20.7317,60,39,5,-21
-41.99826,-20.7317,60,45,11,-15
-41.99803,-20.7317,59,45,5,-14
-41.99781,-20.7317,59,45,5,-14
-41.99758,-20.7317,59,45,5,-14
-41.99713,-20.7317,60,46,5,-14
-41.99691,-20.7317,60,46,5,-14
-41.99668,-20.7317,61,46,5,-15
-41.99646,-20.7317,60,46,5,-14
-41.99601,-20.7317,60,39,5,-21
-41.99578,-20.7317,61,40,5,-21
-41.99556,-20.7317,60,47,5,-13
-41.99533,-20.7317,60,47,5,-13
-41.99511,-20.7317,60,47,5,-13
-41.99466,-20.7317,59,48,5,-11
-41.99444,-20.7317,59,48,5,-11
-41.99421,-20.7317,59,48,5,-11
-41.99399,-20.7317,59,48,5,-11
-41.99354,-20.7317,58,38,5,-20
-41.99331,-20.7317,58,36,5,-22
-41.99309,-20.7317,58,34,5,-24
-41.99286,-20.7317,57,35,5,-22
-41.99241,-20.7317,57,35,5,-22
-41.99219,-20.7317,57,36,0,-21
-41.99196,-20.7317,61,37,0,-24
-41.99174,-20.7317,60,37,0,-23
-41.99129,-20.7317,63,37,0,-26
-41.99107,-20.7317,63,37,0,-26
-41.99084,-20.7317,62,38,0,-24
-41.99062,-20.7317,64,37,0,-27
-41.99017,-20.7317,63,37,0,-26
-41.98994,-20.7317,63,38,0,-25
-41.98972,-20.7317,65,38,0,-27
-41.98949,-20.7317,63,38,0,-25
-41.98927,-20.7317,64,39,0,-25
-41.98882,-20.7317,63,40,0,-23
-41.98859,-20.7317,62,40,0,-22
-41.98837,-20.7317,61,41,0,-20
-41.98814,-20.7317,60,41,11,-19
-41.98769,-20.7317,60,41,0,-19
-41.98747,-20.7317,59,41,0,-18
-41.98725,-20.7317,59,41,0,-18
-41.98702,-20.7317,58,40,0,-18
-41.98657,-20.7317,58,37,0,-21
-41.98635,-20.7317,58,35,0,-23
-41.98612,-20.7317,57,36,0,-21
-41.9859,-20.7317,57,37,0,-20
-41.98545,-20.7317,57,41,0,-16
-41.98522,-20.7317,57,41,0,-16
-41.985,-20.7317,57,41,0,-16
-41.98477,-20.7317,57,41,0,-16
-41.98455,-20.7317,64,41,0,-23
-41.9841,-20.7317,65,42,0,-23
-41.98387,-20.7317,70,42,0,-28
-41.98365,-20.7317,67,42,0,-25
-41.98343,-20.7317,66,42,0,-24
-41.98298,-20.7317,67,43,0,-24
-41.98275,-20.7317,66,43,0,-23
-41.98253,-20.7317,65,43,0,-22
-41.9823,-20.7317,64,43,0,-21
-41.98185,-20.7317,64,45,0,-19
-41.98163,-20.7317,64,45,0,-19
-41.9814,-20.7317,64,45,0,-19
-41.98118,-20.7317,63,45,0,-18
-41.98073,-20.7317,62,45,0,-17
-41.9805,-20.7317,61,45,0,-16
-41.98028,-20.7317,61,45,0,-16
-41.98005,-20.7317,60,45,5,-15
-41.97983,-20.7317,60,33,5,-27
-41.97938,-20.7317,60,31,5,-29
-41.97916,-20.7317,60,35,5,-25
-41.97893,-20.7317,60,36,0,-24
-41.97871,-20.7317,60,44,0,-16
-41.97826,-20.7317,60,45,0,-15
-41.97803,-20.7317,58,45,0,-13
-41.97781,-20.7317,58,45,0,-13
-41.97758,-20.7317,58,45,0,-13
-41.97713,-20.7317,58,45,0,-13
-41.97691,-20.7317,58,45,0,-13
-41.97668,-20.7317,58,45,0,-13
-41.97646,-20.7317,58,45,0,-13
-41.97601,-20.7317,58,45,0,-13
-41.97578,-20.7317,58,45,0,-13
-41.97556,-20.7317,58,45,0,-13
-41.97534,-20.7317,57,45,5,-12
-41.97511,-20.7317,57,45,5,-12
-41.97466,-20.7317,57,45,5,-12
-41.97444,-20.7317,57,45,5,-12
-41.97421,-20.7317,57,45,0,-12
-41.97399,-20.7317,57,45,0,-12
-41.97354,-20.7317,56,45,0,-11
-41.97331,-20.7317,56,45,0,-11
-41.97309,-20.7317,56,45,0,-11
-41.97286,-20.7317,56,45,0,-11
-41.97241,-20.7317,56,46,0,-10
-41.97219,-20.7317,56,46,0,-10
-41.97196,-20.7317,55,46,0,-9
-41.97174,-20.7317,55,46,0,-9
-41.97129,-20.7317,55,46,0,-9
-41.97107,-20.7317,55,46,0,-9
-41.97084,-20.7317,55,46,0,-9
-41.97062,-20.7317,55,46,0,-9
-41.97017,-20.7317,55,47,0,-8
-41.96994,-20.7317,54,47,0,-7
-41.96972,-20.7317,54,47,0,-7
-41.96949,-20.7317,54,47,0,-7
-41.96927,-20.7317,54,47,0,-7
-42.1005,-20.73149,80,32,5,-48
-42.0978,-20.73149,80,28,0,-52
-42.09511,-20.73149,80,26,0,-54
-42.09219,-20.73149,70,23,5,-47
-42.08949,-20.73149,81,22,5,-59
-42.08657,-20.73149,83,36,5,-47
-42.08387,-20.73149,70,29,5,-41
-42.08118,-20.73149,58,33,5,-25
-42.07825,-20.73149,59,43,0,-16
-42.07556,-20.73149,54,32,5,-22
-42.07286,-20.73149,56,49,0,-7
-42.06994,-20.73149,64,46,0,-18
-42.06724,-20.73149,56,37,5,-19
-42.06455,-20.73149,61,38,5,-23
-42.06163,-20.73149,60,38,5,-22
-42.05893,-20.73149,35,44,0,9
-42.05601,-20.73149,38,61,0,23
-42.05331,-20.73149,36,52,0,16
-42.05061,-20.73149,27,58,0,31
-42.04769,-20.73149,32,63,0,31
-42.045,-20.73149,35,61,0,26
-42.0423,-20.73149,35,56,2,21
-42.03938,-20.73149,29,60,0,31
-42.03668,-20.73149,25,60,2,35
-42.03399,-20.73149,11,50,11,39
-42.03106,-20.73149,35,52,2,17
-42.02837,-20.73149,43,62,2,19
-42.02545,-20.73149,49,61,5,12
-42.02275,-20.73149,52,54,0,2
-42.02005,-20.73149,42,50,11,8
-42.01713,-20.73149,52,48,5,-4
-42.01444,-20.73149,52,49,5,-3
-42.01174,-20.73149,48,48,5,0
-42.00882,-20.73149,45,46,0,1
-42.00612,-20.73149,41,46,0,5
-42.00342,-20.73149,48,46,0,-2
-42.0005,-20.73149,61,45,0,-16
-41.99781,-20.73149,59,45,11,-14
-41.99511,-20.73149,60,45,5,-15
-41.99219,-20.73149,57,38,0,-19
-41.98949,-20.73149,64,38,0,-26
-41.98657,-20.73149,58,38,0,-20
-41.98387,-20.73149,69,42,0,-27
-41.98118,-20.73149,63,45,0,-18
-41.97826,-20.73149,59,45,0,-14
-41.97556,-20.73149,58,45,0,-13
-41.97286,-20.73149,56,45,0,-11
-41.96994,-20.73149,54,47,0,-7
-42.1005,-20.73107,82,28,5,-54
-42.0978,-20.73107,81,29,0,-52
-42.09511,-20.73107,80,26,0,-54
-42.09219,-20.73107,70,22,5,-48
-42.08949,-20.73107,80,21,5,-59
-42.08657,-20.73107,83,36,5,-47
-42.08387,-20.73107,71,30,5,-41
-42.08118,-20.73107,58,36,5,-22
-42.07825,-20.73107,59,44,0,-15
-42.07556,-20.73107,54,34,5,-20
-42.07286,-20.73107,59,47,0,-12
-42.06994,-20.73107,57,44,0,-13
-42.06724,-20.73107,57,37,5,-20
-42.06455,-20.73107,61,38,5,-23
-42.06163,-20.73107,59,39,5,-20
-42.05893,-20.73107,38,44,0,6
-42.05601,-20.73107,38,61,0,23
-42.05331,-20.73107,39,52,0,13
-42.05061,-20.73107,27,55,0,28
-42.04769,-20.73107,33,63,0,30
-42.045,-20.73107,36,60,0,24
-42.0423,-20.73107,34,56,2,22
-42.03938,-20.73107,31,60,11,29
-42.03668,-20.73107,29,58,2,29
-42.03399,-20.73107,6,50,2,44
-42.03106,-20.73107,37,52,2,15
-42.02837,-20.73107,42,66,11,24
-42.02545,-20.73107,42,64,5,22
-42.02275,-20.73107,51,54,0,3
-42.02005,-20.73107,42,50,5,8
-42.01713,-20.73107,51,48,5,-3
-42.01444,-20.73107,50,48,5,-2
-42.01174,-20.73107,48,48,5,0
-42.00882,-20.73107,45,45,0,0
-42.00612,-20.73107,40,46,0,6
-42.00342,-20.73107,56,45,0,-11
-42.0005,-20.73107,61,45,0,-16
-41.99781,-20.73107,60,45,0,-15
-41.99511,-20.73107,60,47,0,-13
-41.99219,-20.73107,60,38,0,-22
-41.98949,-20.73107,63,37,0,-26
-41.98657,-20.73107,58,42,0,-16
-41.98387,-20.73107,68,41,0,-27
-41.98118,-20.73107,62,45,0,-17
-41.97826,-20.73107,60,45,0,-15
-41.97556,-20.73107,57,45,0,-12
-41.97286,-20.73107,56,45,0,-11
-41.96994,-20.73107,55,46,5,-9
-42.1005,-20.73086,80,27,5,-53
-42.0978,-20.73086,81,29,0,-52
-42.09511,-20.73086,80,27,0,-53
-42.09219,-20.73086,70,25,5,-45
-42.08949,-20.73086,80,22,5,-58
-42.08657,-20.73086,82,32,5,-50
-42.08387,-20.73086,74,28,5,-46
-42.08118,-20.73086,59,36,5,-23
-42.07825,-20.73086,58,44,0,-14
-42.07556,-20.73086,54,35,5,-19
-42.07286,-20.73086,63,47,0,-16
-42.06994,-20.73086,58,44,0,-14
-42.06724,-20.73086,64,38,5,-26
-42.06455,-20.73086,61,38,5,-23
-42.06163,-20.73086,59,39,5,-20
-42.05893,-20.73086,33,44,0,11
-42.05601,-20.73086,38,61,0,23
-42.05331,-20.73086,38,52,0,14
-42.05061,-20.73086,25,55,0,30
-42.04769,-20.73086,34,62,0,28
-42.045,-20.73086,37,60,0,23
-42.0423,-20.73086,31,52,11,21
-42.03938,-20.73086,20,59,2,39
-42.03668,-20.73086,18,58,2,40
-42.03399,-20.73086,9,54,11,45
-42.03106,-20.73086,38,54,2,16
-42.02837,-20.73086,40,62,11,22
-42.02545,-20.73086,42,63,5,21
-42.02275,-20.73086,53,55,0,2
-42.02005,-20.73086,42,50,5,8
-42.01713,-20.73086,51,47,5,-4
-42.01444,-20.73086,50,47,5,-3
-42.01174,-20.73086,47,47,5,0
-42.00882,-20.73086,45,45,0,0
-42.00612,-20.73086,40,46,0,6
-42.00342,-20.73086,59,45,0,-14
-42.0005,-20.73086,59,45,0,-14
-41.99781,-20.73086,60,45,0,-15
-41.99511,-20.73086,60,47,0,-13
-41.99219,-20.73086,63,37,5,-26
-41.98949,-20.73086,63,37,0,-26
-41.98657,-20.73086,58,42,0,-16
-41.98387,-20.73086,66,40,0,-26
-41.98118,-20.73086,62,43,0,-19
-41.97826,-20.73086,60,45,0,-15
-41.97556,-20.73086,57,45,0,-12
-41.97286,-20.73086,56,46,0,-10
-41.96994,-20.73086,55,47,5,-8
-42.1005,-20.73065,75,27,5,-48
-42.0978,-20.73065,72,28,0,-44
-42.09511,-20.73065,79,26,0,-53
-42.09219,-20.73065,70,23,5,-47
-42.08949,-20.73065,79,22,5,-57
-42.08657,-20.73065,80,32,5,-48
-42.08387,-20.73065,89,29,5,-60
-42.08118,-20.73065,68,36,5,-32
-42.07825,-20.73065,60,44,0,-16
-42.07556,-20.73065,54,37,5,-17
-42.07286,-20.73065,63,47,0,-16
-42.06994,-20.73065,57,44,0,-13
-42.06724,-20.73065,64,41,5,-23
-42.06455,-20.73065,61,39,5,-22
-42.06163,-20.73065,58,39,5,-19
-42.05893,-20.73065,32,55,0,23
-42.05601,-20.73065,38,49,0,11
-42.05331,-20.73065,39,54,0,15
-42.05061,-20.73065,26,51,0,25
-42.04769,-20.73065,38,62,0,24
-42.045,-20.73065,34,60,0,26
-42.0423,-20.73065,18,52,2,34
-42.03938,-20.73065,10,56,2,46
-42.03668,-20.73065,9,58,11,49
-42.03399,-20.73065,12,53,11,41
-42.03106,-20.73065,33,56,11,23
-42.02837,-20.73065,38,65,2,27
-42.02545,-20.73065,40,64,5,24
-42.02275,-20.73065,49,56,0,7
-42.02005,-20.73065,43,50,5,7
-42.01713,-20.73065,52,47,5,-5
-42.01444,-20.73065,49,46,5,-3
-42.01174,-20.73065,49,47,5,-2
-42.00882,-20.73065,45,46,0,1
-42.00612,-20.73065,40,46,0,6
-42.00342,-20.73065,59,45,0,-14
-42.0005,-20.73065,58,45,0,-13
-41.99781,-20.73065,61,45,0,-16
-41.99511,-20.73065,59,46,0,-13
-41.99219,-20.73065,63,37,5,-26
-41.98949,-20.73065,62,37,0,-25
-41.98657,-20.73065,58,40,0,-18
-41.98387,-20.73065,68,40,0,-28
-41.98118,-20.73065,61,43,0,-18
-41.97826,-20.73065,59,45,0,-14
-41.97556,-20.73065,57,45,0,-12
-41.97286,-20.73065,56,46,0,-10
-41.96994,-20.73065,55,47,5,-8
-42.1005,-20.73022,66,28,5,-38
-42.0978,-20.73022,67,29,0,-38
-42.09511,-20.73022,69,25,0,-44
-42.09219,-20.73022,69,23,5,-46
-42.08949,-20.73022,80,22,5,-58
-42.08657,-20.73022,79,33,5,-46
-42.08387,-20.73022,83,27,5,-56
-42.08118,-20.73022,69,34,5,-35
-42.07825,-20.73022,61,44,0,-17
-42.07556,-20.73022,65,38,5,-27
-42.07286,-20.73022,64,45,0,-19
-42.06994,-20.73022,57,43,0,-14
-42.06724,-20.73022,63,41,11,-22
-42.06455,-20.73022,60,39,5,-21
-42.06163,-20.73022,54,55,11,1
-42.05893,-20.73022,31,55,0,24
-42.05601,-20.73022,38,51,0,13
-42.05331,-20.73022,38,57,0,19
-42.05061,-20.73022,25,52,0,27
-42.04769,-20.73022,39,62,0,23
-42.045,-20.73022,28,52,0,24
-42.0423,-20.73022,15,52,11,37
-42.03938,-20.73022,9,55,11,46
-42.03668,-20.73022,12,62,11,50
-42.03399,-20.73022,10,56,2,46
-42.03106,-20.73022,30,63,2,33
-42.02837,-20.73022,33,62,2,29
-42.02545,-20.73022,35,69,0,34
-42.02275,-20.73022,50,55,0,5
-42.02005,-20.73022,42,50,5,8
-42.01713,-20.73022,51,47,5,-4
-42.01444,-20.73022,47,45,5,-2
-42.01174,-20.73022,52,53,5,1
-42.00882,-20.73022,44,46,0,2
-42.00612,-20.73022,39,46,0,7
-42.00342,-20.73022,55,45,0,-10
-42.0005,-20.73022,57,45,0,-12
-41.99781,-20.73022,61,45,5,-16
-41.99511,-20.73022,59,46,0,-13
-41.99219,-20.73022,64,38,5,-26
-41.98949,-20.73022,61,37,0,-24
-41.98657,-20.73022,58,37,0,-21
-41.98387,-20.73022,66,39,0,-27
-41.98118,-20.73022,61,42,0,-19
-41.97826,-20.73022,59,45,0,-14
-41.97556,-20.73022,57,45,0,-12
-41.97286,-20.73022,56,46,0,-10
-41.96994,-20.73022,55,36,5,-19
-42.1005,-20.73001,64,28,5,-36
-42.0978,-20.73001,63,29,0,-34
-42.09511,-20.73001,65,25,0,-40
-42.09219,-20.73001,68,22,5,-46
-42.08949,-20.73001,79,22,5,-57
-42.08657,-20.73001,78,33,5,-45
-42.08387,-20.73001,76,27,5,-49
-42.08118,-20.73001,74,34,5,-40
-42.07825,-20.73001,65,44,0,-21
-42.07556,-20.73001,66,37,5,-29
-42.07286,-20.73001,65,45,0,-20
-42.06994,-20.73001,57,43,0,-14
-42.06724,-20.73001,64,41,11,-23
-42.06455,-20.73001,60,40,5,-20
-42.06163,-20.73001,51,53,0,2
-42.05893,-20.73001,31,55,0,24
-42.05601,-20.73001,37,51,0,14
-42.05331,-20.73001,37,56,0,19
-42.05061,-20.73001,25,52,0,27
-42.04769,-20.73001,39,62,0,23
-42.045,-20.73001,17,46,5,29
-42.0423,-20.73001,14,53,2,39
-42.03668,-20.73001,10,62,11,52
-42.03399,-20.73001,4,60,11,56
-42.03106,-20.73001,29,65,2,36
-42.02837,-20.73001,29,62,5,33
-42.02545,-20.73001,32,64,0,32
-42.02275,-20.73001,48,55,0,7
-42.02005,-20.73001,43,50,5,7
-42.01713,-20.73001,50,45,5,-5
-42.01444,-20.73001,45,45,5,0
-42.01174,-20.73001,49,49,5,0
-42.00882,-20.73001,44,46,0,2
-42.00612,-20.73001,39,45,0,6
-42.00342,-20.73001,56,45,0,-11
-42.0005,-20.73001,56,44,0,-12
-41.99781,-20.73001,60,45,5,-15
-41.99511,-20.73001,59,46,0,-13
-41.99219,-20.73001,62,35,5,-27
-41.98949,-20.73001,61,36,0,-25
-41.98657,-20.73001,58,36,0,-22
-41.98387,-20.73001,66,38,0,-28
-41.98118,-20.73001,61,41,0,-20
-41.97826,-20.73001,58,45,0,-13
-41.97556,-20.73001,58,45,0,-13
-41.97286,-20.73001,57,46,0,-11
-41.96994,-20.73001,55,36,5,-19
-42.1005,-20.7298,62,30,5,-32
-42.0978,-20.7298,63,29,0,-34
-42.09511,-20.7298,63,25,0,-38
-42.09219,-20.7298,67,22,5,-45
-42.08949,-20.7298,79,23,5,-56
-42.08657,-20.7298,79,34,5,-45
-42.08387,-20.7298,79,29,5,-50
-42.08118,-20.7298,64,34,5,-30
-42.07825,-20.7298,65,44,0,-21
-42.07556,-20.7298,67,44,5,-23
-42.07286,-20.7298,66,45,0,-21
-42.06994,-20.7298,57,43,0,-14
-42.06724,-20.7298,64,41,5,-23
-42.06455,-20.7298,58,40,5,-18
-42.06163,-20.7298,51,55,0,4
-42.05893,-20.7298,36,55,0,19
-42.05601,-20.7298,37,51,0,14
-42.05331,-20.7298,37,51,0,14
-42.05061,-20.7298,25,54,0,29
-42.04769,-20.7298,33,62,0,29
-42.045,-20.7298,17,46,5,29
-42.0423,-20.7298,14,53,5,39
-42.03399,-20.7298,3,66,11,63
-42.03106,-20.7298,28,65,2,37
-42.02837,-20.7298,25,64,5,39
-42.02545,-20.7298,32,66,0,34
-42.02275,-20.7298,48,55,0,7
-42.02005,-20.7298,43,48,5,5
-42.01713,-20.7298,50,45,5,-5
-42.01444,-20.7298,44,44,5,0
-42.01174,-20.7298,48,48,5,0
-42.00882,-20.7298,43,45,0,2
-42.00612,-20.7298,39,45,0,6
-42.00342,-20.7298,61,45,0,-16
-42.0005,-20.7298,57,44,0,-13
-41.99781,-20.7298,61,45,5,-16
-41.99511,-20.7298,59,46,0,-13
-41.99219,-20.7298,62,34,5,-28
-41.98949,-20.7298,61,36,0,-25
-41.98657,-20.7298,58,36,0,-22
-41.98387,-20.7298,66,38,0,-28
-41.98118,-20.7298,60,41,0,-19
-41.97826,-20.7298,58,45,0,-13
-41.97556,-20.7298,57,45,0,-12
-41.97286,-20.7298,57,46,0,-11
-41.96994,-20.7298,55,37,5,-18
-42.1005,-20.72938,62,30,5,-32
-42.0978,-20.72938,62,30,0,-32
-42.09511,-20.72938,62,23,5,-39
-42.09219,-20.72938,62,22,5,-40
-42.08949,-20.72938,78,26,5,-52
-42.08657,-20.72938,78,35,0,-43
-42.08387,-20.72938,72,27,5,-45
-42.08118,-20.72938,64,33,5,-31
-42.07825,-20.72938,64,44,0,-20
-42.07556,-20.72938,68,44,0,-24
-42.07286,-20.72938,68,44,0,-24
-42.06994,-20.72938,61,43,0,-18
-42.06724,-20.72938,56,39,5,-17
-42.06455,-20.72938,57,40,5,-17
-42.06163,-20.72938,50,55,0,5
-42.05893,-20.72938,38,54,0,16
-42.05601,-20.72938,36,52,0,16
-42.05331,-20.72938,38,51,0,13
-42.05061,-20.72938,29,54,0,25
-42.04769,-20.72938,19,63,0,44
-42.045,-20.72938,17,46,5,29
-42.0423,-20.72938,13,51,5,38
-42.03938,-20.72938,7,56,2,49
-42.03668,-20.72938,3,57,11,54
-42.03399,-20.72938,8,68,2,60
-42.03106,-20.72938,25,69,2,44
-42.02837,-20.72938,19,62,11,43
-42.02545,-20.72938,30,66,5,36
-42.02275,-20.72938,48,56,0,8
-42.02005,-20.72938,43,48,5,5
-42.01713,-20.72938,49,45,5,-4
-42.01444,-20.72938,44,44,5,0
-42.01174,-20.72938,44,43,0,-1
-42.00882,-20.72938,43,45,0,2
-42.00612,-20.72938,39,45,0,6
-42.00342,-20.72938,61,45,0,-16
-42.0005,-20.72938,57,43,0,-14
-41.99781,-20.72938,59,44,5,-15
-41.99511,-20.72938,59,46,0,-13
-41.99219,-20.72938,64,34,5,-30
-41.98949,-20.72938,61,36,0,-25
-41.98657,-20.72938,58,37,0,-21
-41.98387,-20.72938,67,40,0,-27
-41.98118,-20.72938,60,41,0,-19
-41.97826,-20.72938,58,44,0,-14
-41.97556,-20.72938,58,45,0,-13
-41.97286,-20.72938,57,46,0,-11
-41.96994,-20.72938,55,37,5,-18
-42.1005,-20.72917,61,28,5,-33
-42.0978,-20.72917,62,31,0,-31
-42.09511,-20.72917,64,23,5,-41
-42.09219,-20.72917,61,23,5,-38
-42.08949,-20.72917,71,26,5,-45
-42.08657,-20.72917,67,35,0,-32
-42.08387,-20.72917,80,27,5,-53
-42.08118,-20.72917,63,32,5,-31
-42.07825,-20.72917,60,44,5,-16
-42.07556,-20.72917,69,44,0,-25
-42.07286,-20.72917,68,43,0,-25
-42.06994,-20.72917,69,42,5,-27
-42.06724,-20.72917,57,37,5,-20
-42.06455,-20.72917,50,40,5,-10
-42.06163,-20.72917,55,55,0,0
-42.05893,-20.72917,42,49,0,7
-42.05601,-20.72917,35,52,0,17
-42.05331,-20.72917,38,51,0,13
-42.05061,-20.72917,35,45,0,10
-42.04769,-20.72917,6,63,0,57
-42.045,-20.72917,16,46,5,30
-42.0423,-20.72917,12,51,5,39
-42.03938,-20.72917,6,60,2,54
-42.03668,-20.72917,2,57,2,55
-42.03399,-20.72917,7,65,2,58
-42.03106,-20.72917,26,71,2,45
-42.02837,-20.72917,23,61,2,38
-42.02545,-20.72917,30,64,5,34
-42.02275,-20.72917,47,53,0,6
-42.02005,-20.72917,43,48,5,5
-42.01713,-20.72917,49,45,5,-4
-42.01444,-20.72917,43,43,5,0
-42.01174,-20.72917,43,43,5,0
-42.00882,-20.72917,42,45,0,3
-42.00612,-20.72917,39,45,0,6
-42.00342,-20.72917,62,45,0,-17
-42.0005,-20.72917,58,43,0,-15
-41.99781,-20.72917,58,44,5,-14
-41.99511,-20.72917,59,46,0,-13
-41.99219,-20.72917,65,34,5,-31
-41.98949,-20.72917,61,36,0,-25
-41.98657,-20.72917,58,36,0,-22
-41.98387,-20.72917,67,39,0,-28
-41.98118,-20.72917,60,40,0,-20
-41.97826,-20.72917,58,44,0,-14
-41.97556,-20.72917,57,45,0,-12
-41.97286,-20.72917,57,46,0,-11
-41.96994,-20.72917,55,36,5,-19
-42.10297,-20.72896,67,25,5,-42
-42.10275,-20.72896,68,26,5,-42
-42.10252,-20.72896,61,29,5,-32
-42.1023,-20.72896,61,29,5,-32
-42.10185,-20.72896,61,27,5,-34
-42.10163,-20.72896,61,33,5,-28
-42.1014,-20.72896,61,33,5,-28
-42.10118,-20.72896,61,33,5,-28
-42.10073,-20.72896,61,31,5,-30
-42.1005,-20.72896,61,31,5,-30
-42.10028,-20.72896,62,32,5,-30
-42.10005,-20.72896,62,32,5,-30
-42.09983,-20.72896,62,32,0,-30
-42.09938,-20.72896,63,32,0,-31
-42.09915,-20.72896,62,32,0,-30
-42.09893,-20.72896,62,32,0,-30
-42.0987,-20.72896,62,32,0,-30
-42.09825,-20.72896,61,31,0,-30
-42.09803,-20.72896,61,31,0,-30
-42.0978,-20.72896,61,31,0,-30
-42.09758,-20.72896,61,31,0,-30
-42.09713,-20.72896,61,30,0,-31
-42.09691,-20.72896,61,30,0,-31
-42.09668,-20.72896,62,28,0,-34
-42.09646,-20.72896,62,27,0,-35
-42.09601,-20.72896,62,25,0,-37
-42.09578,-20.72896,62,24,0,-38
-42.09556,-20.72896,62,23,5,-39
-42.09533,-20.72896,63,23,5,-40
-42.09511,-20.72896,64,23,5,-41
-42.09466,-20.72896,67,23,5,-44
-42.09443,-20.72896,68,23,5,-45
-42.09421,-20.72896,68,23,5,-45
-42.09398,-20.72896,69,23,5,-46
-42.09354,-20.72896,70,23,5,-47
-42.09331,-20.72896,70,24,5,-46
-42.09309,-20.72896,71,24,5,-47
-42.09286,-20.72896,66,23,5,-43
-42.09241,-20.72896,60,23,5,-37
-42.09219,-20.72896,60,23,5,-37
-42.09196,-20.72896,61,23,5,-38
-42.09174,-20.72896,61,23,5,-38
-42.09129,-20.72896,62,23,5,-39
-42.09106,-20.72896,63,23,5,-40
-42.09084,-20.72896,64,23,5,-41
-42.09061,-20.72896,66,24,5,-42
-42.09039,-20.72896,67,24,5,-43
-42.08994,-20.72896,66,25,5,-41
-42.08972,-20.72896,66,26,5,-40
-42.08949,-20.72896,66,26,5,-40
-42.08927,-20.72896,65,26,5,-39
-42.08882,-20.72896,65,27,5,-38
-42.08859,-20.72896,65,30,5,-35
-42.08837,-20.72896,66,30,5,-36
-42.08814,-20.72896,66,37,5,-29
-42.08769,-20.72896,66,37,0,-29
-42.08747,-20.72896,66,37,0,-29
-42.08724,-20.72896,65,36,0,-29
-42.08702,-20.72896,65,36,0,-29
-42.08657,-20.72896,64,35,0,-29
-42.08634,-20.72896,64,35,0,-29
-42.08612,-20.72896,64,34,0,-30
-42.08589,-20.72896,64,34,0,-30
-42.08545,-20.72896,64,33,0,-31
-42.08522,-20.72896,64,33,0,-31
-42.085,-20.72896,64,33,5,-31
-42.08477,-20.72896,65,29,5,-36
-42.08455,-20.72896,66,29,5,-37
-42.0841,-20.72896,65,28,5,-37
-42.08387,-20.72896,65,28,5,-37
-42.08365,-20.72896,65,28,5,-37
-42.08342,-20.72896,65,28,5,-37
-42.08297,-20.72896,64,27,5,-37
-42.08275,-20.72896,64,28,5,-36
-42.08252,-20.72896,63,31,5,-32
-42.0823,-20.72896,64,31,5,-33
-42.08185,-20.72896,64,30,5,-34
-42.08163,-20.72896,67,31,5,-36
-42.0814,-20.72896,66,32,5,-34
-42.08118,-20.72896,65,32,5,-33
-42.08073,-20.72896,65,33,5,-32
-42.0805,-20.72896,66,37,5,-29
-42.08028,-20.72896,65,37,5,-28
-42.08005,-20.72896,64,37,5,-27
-42.07983,-20.72896,64,38,5,-26
-42.07938,-20.72896,64,38,5,-26
-42.07915,-20.72896,61,37,5,-24
-42.07893,-20.72896,62,36,5,-26
-42.0787,-20.72896,63,35,5,-28
-42.07825,-20.72896,55,33,5,-22
-42.07803,-20.72896,55,36,5,-19
-42.07781,-20.72896,55,44,5,-11
-42.07758,-20.72896,56,44,0,-12
-42.07713,-20.72896,57,44,0,-13
-42.07691,-20.72896,60,44,0,-16
-42.07668,-20.72896,67,44,0,-23
-42.07646,-20.72896,69,44,0,-25
-42.07601,-20.72896,68,44,0,-24
-42.07578,-20.72896,68,44,0,-24
-42.07556,-20.72896,69,44,0,-25
-42.07533,-20.72896,69,44,0,-25
-42.07511,-20.72896,68,43,0,-25
-42.07466,-20.72896,69,43,0,-26
-42.07443,-20.72896,69,43,0,-26
-42.07421,-20.72896,69,43,0,-26
-42.07399,-20.72896,69,43,0,-26
-42.07354,-20.72896,69,43,0,-26
-42.07331,-20.72896,69,43,0,-26
-42.07309,-20.72896,69,43,0,-26
-42.07286,-20.72896,69,43,0,-26
-42.07241,-20.72896,69,43,0,-26
-42.07219,-20.72896,68,43,0,-25
-42.07196,-20.72896,68,43,0,-25
-42.07174,-20.72896,68,43,0,-25
-42.07129,-20.72896,68,42,0,-26
-42.07106,-20.72896,69,42,0,-27
-42.07084,-20.72896,69,42,0,-27
-42.07061,-20.72896,69,42,0,-27
-42.07039,-20.72896,69,42,0,-27
-42.06994,-20.72896,70,41,5,-29
-42.06972,-20.72896,66,39,5,-27
-42.06949,-20.72896,61,38,5,-23
-42.06927,-20.72896,58,38,5,-20
-42.06882,-20.72896,56,37,5,-19
-42.06859,-20.72896,61,37,5,-24
-42.06837,-20.72896,59,38,5,-21
-42.06814,-20.72896,60,38,5,-22
-42.06769,-20.72896,61,37,5,-24
-42.06747,-20.72896,62,37,5,-25
-42.06724,-20.72896,63,37,5,-26
-42.06702,-20.72896,58,41,5,-17
-42.06657,-20.72896,57,41,5,-16
-42.06634,-20.72896,57,39,5,-18
-42.06612,-20.72896,56,38,5,-18
-42.0659,-20.72896,54,39,5,-15
-42.06545,-20.72896,51,39,5,-12
-42.06522,-20.72896,52,38,5,-14
-42.065,-20.72896,53,39,5,-14
-42.06477,-20.72896,55,39,5,-16
-42.06455,-20.72896,54,40,5,-14
-42.0641,-20.72896,55,46,5,-9
-42.06387,-20.72896,55,46,5,-9
-42.06365,-20.72896,55,46,5,-9
-42.06342,-20.72896,52,47,5,-5
-42.06297,-20.72896,52,51,5,-1
-42.06275,-20.72896,49,49,5,0
-42.06252,-20.72896,50,51,0,1
-42.0623,-20.72896,52,55,0,3
-42.06185,-20.72896,57,55,0,-2
-42.06163,-20.72896,59,55,0,-4
-42.0614,-20.72896,56,55,0,-1
-42.06118,-20.72896,57,55,0,-2
-42.06073,-20.72896,52,54,0,2
-42.0605,-20.72896,53,54,11,1
-42.06028,-20.72896,48,54,0,6
-42.06005,-20.72896,45,54,0,9
-42.05983,-20.72896,46,54,0,8
-42.05938,-20.72896,46,54,0,8
-42.05915,-20.72896,44,49,0,5
-42.05893,-20.72896,41,49,0,8
-42.0587,-20.72896,37,49,0,12
-42.05826,-20.72896,32,54,0,22
-42.05803,-20.72896,34,54,0,20
-42.05781,-20.72896,33,54,0,21
-42.05758,-20.72896,30,54,0,24
-42.05713,-20.72896,32,54,11,22
-42.05691,-20.72896,27,54,0,27
-42.05668,-20.72896,28,54,0,26
-42.05646,-20.72896,34,53,0,19
-42.05601,-20.72896,32,52,11,20
-42.05578,-20.72896,36,51,11,15
-42.05556,-20.72896,37,51,0,14
-42.05533,-20.72896,37,51,0,14
-42.05511,-20.72896,38,51,0,13
-42.05466,-20.72896,38,51,0,13
-42.05443,-20.72896,39,51,11,12
-42.05421,-20.72896,39,51,0,12
-42.05399,-20.72896,38,51,0,13
-42.05354,-20.72896,38,52,11,14
-42.05331,-20.72896,39,52,11,13
-42.05309,-20.72896,39,52,11,13
-42.05286,-20.72896,40,52,0,12
-42.05241,-20.72896,40,51,0,11
-42.05219,-20.72896,42,50,0,8
-42.05196,-20.72896,41,49,11,8
-42.05174,-20.72896,40,45,11,5
-42.05129,-20.72896,39,46,11,7
-42.05106,-20.72896,36,45,11,9
-42.05084,-20.72896,35,45,11,10
-42.05061,-20.72896,33,45,5,12
-42.05039,-20.72896,30,44,11,14
-42.04994,-20.72896,23,51,11,28
-42.04972,-20.72896,23,46,11,23
-42.04949,-20.72896,23,46,5,23
-42.04927,-20.72896,8,46,5,38
-42.04882,-20.72896,22,48,5,26
-42.04859,-20.72896,6,49,5,43
-42.04837,-20.72896,16,50,0,34
-42.04814,-20.72896,21,56,0,35
-42.04769,-20.72896,5,63,0,58
-42.04747,-20.72896,20,63,0,43
-42.04724,-20.72896,19,62,0,43
-42.04702,-20.72896,13,55,0,42
-42.04657,-20.72896,18,50,5,32
-42.04635,-20.72896,5,48,5,43
-42.04612,-20.72896,4,46,5,42
-42.0459,-20.72896,17,43,5,26
-42.04545,-20.72896,4,45,5,41
-42.04522,-20.72896,16,46,5,30
-42.045,-20.72896,16,41,5,25
-42.04477,-20.72896,3,41,5,38
-42.04455,-20.72896,14,41,5,27
-42.0441,-20.72896,14,45,5,31
-42.04387,-20.72896,7,45,5,38
-42.04365,-20.72896,13,45,5,32
-42.04342,-20.72896,10,45,5,35
-42.04297,-20.72896,3,50,5,47
-42.04275,-20.72896,12,50,5,38
-42.04253,-20.72896,3,51,5,48
-42.0423,-20.72896,11,51,5,40
-42.04185,-20.72896,11,55,5,44
-42.04163,-20.72896,4,55,5,51
-42.0414,-20.72896,10,56,5,46
-42.0405,-20.72896,8,59,5,51
-42.04028,-20.72896,1,59,5,58
-42.04005,-20.72896,6,60,5,54
-42.03983,-20.72896,7,61,2,54
-42.03938,-20.72896,8,62,2,54
-42.03915,-20.72896,11,60,2,49
-42.03893,-20.72896,16,62,2,46
-42.0387,-20.72896,12,62,11,50
-42.03826,-20.72896,12,59,2,47
-42.03803,-20.72896,8,58,2,50
-42.03781,-20.72896,3,57,2,54
-42.03758,-20.72896,2,57,2,55
-42.03713,-20.72896,3,58,11,55
-42.03691,-20.72896,5,58,2,53
-42.03668,-20.72896,1,57,2,56
-42.03533,-20.72896,3,59,6,56
-42.03511,-20.72896,3,57,2,54
-42.03466,-20.72896,7,59,2,52
-42.03421,-20.72896,2,65,2,63
-42.03354,-20.72896,5,69,11,64
-42.03309,-20.72896,12,72,11,60
-42.03286,-20.72896,16,70,2,54
-42.03241,-20.72896,10,69,2,59
-42.03219,-20.72896,19,71,2,52
-42.03174,-20.72896,20,73,11,53
-42.03129,-20.72896,5,73,2,68
-42.03106,-20.72896,27,73,2,46
-42.03084,-20.72896,26,71,2,45
-42.03062,-20.72896,34,70,2,36
-42.03017,-20.72896,31,71,11,40
-42.02994,-20.72896,33,68,2,35
-42.02972,-20.72896,35,68,2,33
-42.02949,-20.72896,32,65,11,33
-42.02927,-20.72896,31,65,11,34
-42.02882,-20.72896,30,62,5,32
-42.02859,-20.72896,27,62,11,35
-42.02837,-20.72896,22,64,2,42
-42.02814,-20.72896,26,61,2,35
-42.02769,-20.72896,25,59,11,34
-42.02747,-20.72896,18,57,2,39
-42.02724,-20.72896,19,57,2,38
-42.02702,-20.72896,20,57,5,37
-42.02657,-20.72896,12,65,5,53
-42.02635,-20.72896,20,62,5,42
-42.02612,-20.72896,15,61,5,46
-42.0259,-20.72896,12,61,5,49
-42.02545,-20.72896,24,62,5,38
-42.02522,-20.72896,30,62,5,32
-42.025,-20.72896,36,59,0,23
-42.02477,-20.72896,38,58,0,20
-42.02455,-20.72896,46,58,0,12
-42.0241,-20.72896,45,57,0,12
-42.02387,-20.72896,45,54,0,9
-42.02365,-20.72896,44,53,0,9
-42.02342,-20.72896,44,53,0,9
-42.02297,-20.72896,44,53,0,9
-42.02275,-20.72896,45,52,11,7
-42.02253,-20.72896,48,52,0,4
-42.0223,-20.72896,47,53,11,6
-42.02185,-20.72896,46,53,0,7
-42.02163,-20.72896,46,52,0,6
-42.0214,-20.72896,45,48,11,3
-42.02118,-20.72896,44,48,5,4
-42.02073,-20.72896,44,48,5,4
-42.0205,-20.72896,43,49,11,6
-42.02028,-20.72896,43,49,5,6
-42.02005,-20.72896,42,48,5,6
-42.01983,-20.72896,42,48,5,6
-42.01938,-20.72896,43,49,5,6
-42.01915,-20.72896,49,51,5,2
-42.01893,-20.72896,46,49,5,3
-42.01871,-20.72896,43,49,5,6
-42.01826,-20.72896,43,46,5,3
-42.01803,-20.72896,43,45,5,2
-42.01781,-20.72896,43,44,5,1
-42.01758,-20.72896,46,45,5,-1
-42.01713,-20.72896,48,45,5,-3
-42.01691,-20.72896,54,44,5,-10
-42.01668,-20.72896,52,45,5,-7
-42.01646,-20.72896,50,45,5,-5
-42.01601,-20.72896,46,45,5,-1
-42.01578,-20.72896,44,44,5,0
-42.01556,-20.72896,44,44,5,0
-42.01533,-20.72896,43,44,5,1
-42.01511,-20.72896,43,44,5,1
-42.01466,-20.72896,43,43,5,0
-42.01444,-20.72896,43,43,5,0
-42.01421,-20.72896,43,43,5,0
-42.01399,-20.72896,43,43,5,0
-42.01354,-20.72896,43,43,5,0
-42.01331,-20.72896,43,43,5,0
-42.01309,-20.72896,48,45,5,-3
-42.01286,-20.72896,43,43,5,0
-42.01241,-20.72896,43,44,5,1
-42.01219,-20.72896,43,44,5,1
-42.01196,-20.72896,43,45,5,2
-42.01174,-20.72896,43,43,5,0
-42.01129,-20.72896,43,44,0,1
-42.01106,-20.72896,43,44,0,1
-42.01084,-20.72896,43,43,0,0
-42.01062,-20.72896,43,43,0,0
-42.01017,-20.72896,43,44,0,1
-42.00994,-20.72896,43,44,0,1
-42.00972,-20.72896,43,44,0,1
-42.00949,-20.72896,42,44,0,2
-42.00927,-20.72896,42,44,0,2
-42.00882,-20.72896,41,45,0,4
-42.00859,-20.72896,41,41,0,0
-42.00837,-20.72896,41,41,5,0
-42.00814,-20.72896,41,41,5,0
-42.00769,-20.72896,41,41,5,0
-42.00747,-20.72896,40,40,5,0
-42.00724,-20.72896,40,40,0,0
-42.00702,-20.72896,40,40,0,0
-42.00657,-20.72896,40,42,0,2
-42.00635,-20.72896,39,42,0,3
-42.00612,-20.72896,39,39,0,0
-42.0059,-20.72896,39,39,0,0
-42.00545,-20.72896,44,45,0,1
-42.00522,-20.72896,43,44,0,1
-42.005,-20.72896,53,46,0,-7
-42.00477,-20.72896,59,46,0,-13
-42.00455,-20.72896,58,46,0,-12
-42.0041,-20.72896,61,44,0,-17
-42.00387,-20.72896,61,42,0,-19
-42.00365,-20.72896,61,45,0,-16
-42.00342,-20.72896,60,45,0,-15
-42.00298,-20.72896,60,44,0,-16
-42.00275,-20.72896,61,45,0,-16
-42.00253,-20.72896,62,45,0,-17
-42.0023,-20.72896,60,45,0,-15
-42.00185,-20.72896,59,45,0,-14
-42.00163,-20.72896,59,41,0,-18
-42.0014,-20.72896,59,41,0,-18
-42.00118,-20.72896,59,43,0,-16
-42.00073,-20.72896,59,43,0,-16
-42.0005,-20.72896,58,42,0,-16
-42.00028,-20.72896,58,42,0,-16
-42.00005,-20.72896,58,41,0,-17
-41.99983,-20.72896,58,41,0,-17
-41.99938,-20.72896,58,41,0,-17
-41.99916,-20.72896,58,41,0,-17
-41.99893,-20.72896,59,42,0,-17
-41.99871,-20.72896,58,42,0,-16
-41.99826,-20.72896,58,43,0,-15
-41.99803,-20.72896,58,44,0,-14
-41.99781,-20.72896,59,42,5,-17
-41.99758,-20.72896,61,43,5,-18
-41.99713,-20.72896,63,43,5,-20
-41.99691,-20.72896,62,43,5,-19
-41.99668,-20.72896,62,45,11,-17
-41.99646,-20.72896,60,43,5,-17
-41.99601,-20.72896,60,39,5,-21
-41.99578,-20.72896,59,39,5,-20
-41.99556,-20.72896,59,39,5,-20
-41.99533,-20.72896,59,38,5,-21
-41.99511,-20.72896,59,45,5,-14
-41.99466,-20.72896,59,46,5,-13
-41.99444,-20.72896,58,46,5,-12
-41.99421,-20.72896,58,46,5,-12
-41.99399,-20.72896,57,46,5,-11
-41.99354,-20.72896,57,47,0,-10
-41.99331,-20.72896,57,47,5,-10
-41.99309,-20.72896,60,47,5,-13
-41.99286,-20.72896,66,41,5,-25
-41.99241,-20.72896,64,34,5,-30
-41.99219,-20.72896,66,35,5,-31
-41.99196,-20.72896,66,35,0,-31
-41.99174,-20.72896,64,36,0,-28
-41.99129,-20.72896,63,37,0,-26
-41.99107,-20.72896,62,36,0,-26
-41.99084,-20.72896,62,36,0,-26
-41.99062,-20.72896,62,36,0,-26
-41.99017,-20.72896,62,35,0,-27
-41.98994,-20.72896,61,35,0,-26
-41.98972,-20.72896,61,35,0,-26
-41.98949,-20.72896,61,36,0,-25
-41.98927,-20.72896,61,36,0,-25
-41.98882,-20.72896,61,37,0,-24
-41.98859,-20.72896,60,38,0,-22
-41.98837,-20.72896,60,39,11,-21
-41.98814,-20.72896,60,40,0,-20
-41.98769,-20.72896,60,41,0,-19
-41.98747,-20.72896,60,41,0,-19
-41.98725,-20.72896,59,41,0,-18
-41.98702,-20.72896,58,38,0,-20
-41.98657,-20.72896,58,37,0,-21
-41.98635,-20.72896,58,36,0,-22
-41.98612,-20.72896,58,35,0,-23
-41.9859,-20.72896,58,34,0,-24
-41.98545,-20.72896,58,34,0,-24
-41.98522,-20.72896,58,34,0,-24
-41.985,-20.72896,57,34,0,-23
-41.98477,-20.72896,58,34,0,-24
-41.98455,-20.72896,67,34,0,-33
-41.9841,-20.72896,65,38,0,-27
-41.98387,-20.72896,68,39,0,-29
-41.98365,-20.72896,66,40,0,-26
-41.98343,-20.72896,64,40,0,-24
-41.98298,-20.72896,64,40,0,-24
-41.98275,-20.72896,64,39,0,-25
-41.98253,-20.72896,63,34,0,-29
-41.9823,-20.72896,62,36,0,-26
-41.98185,-20.72896,62,39,0,-23
-41.98163,-20.72896,61,39,0,-22
-41.9814,-20.72896,60,40,0,-20
-41.98118,-20.72896,60,40,0,-20
-41.98073,-20.72896,60,41,0,-19
-41.9805,-20.72896,60,41,0,-19
-41.98028,-20.72896,60,41,0,-19
-41.98005,-20.72896,59,42,0,-17
-41.97983,-20.72896,58,42,0,-16
-41.97938,-20.72896,58,43,0,-15
-41.97916,-20.72896,58,43,0,-15
-41.97893,-20.72896,58,43,0,-15
-41.97871,-20.72896,58,43,0,-15
-41.97826,-20.72896,58,44,0,-14
-41.97803,-20.72896,58,44,0,-14
-41.97781,-20.72896,58,44,0,-14
-41.97758,-20.72896,58,44,0,-14
-41.97713,-20.72896,58,44,0,-14
-41.97691,-20.72896,58,44,0,-14
-41.97668,-20.72896,58,44,0,-14
-41.97646,-20.72896,58,44,0,-14
-41.97601,-20.72896,58,44,0,-14
-41.97578,-20.72896,58,44,0,-14
-41.97556,-20.72896,58,45,0,-13
-41.97534,-20.72896,57,45,0,-12
-41.97511,-20.72896,57,45,0,-12
-41.97466,-20.72896,57,45,11,-12
-41.97444,-20.72896,57,45,0,-12
-41.97421,-20.72896,57,45,0,-12
-41.97399,-20.72896,57,45,0,-12
-41.97354,-20.72896,57,45,0,-12
-41.97331,-20.72896,57,45,0,-12
-41.97309,-20.72896,56,46,0,-10
-41.97286,-20.72896,56,46,0,-10
-41.97241,-20.72896,56,46,0,-10
-41.97219,-20.72896,56,46,0,-10
-41.97196,-20.72896,56,46,0,-10
-41.97174,-20.72896,56,46,0,-10
-41.97129,-20.72896,56,46,0,-10
-41.97107,-20.72896,55,46,0,-9
-41.97084,-20.72896,55,46,0,-9
-41.97062,-20.72896,55,46,5,-9
-41.97017,-20.72896,55,46,5,-9
-41.96994,-20.72896,55,46,5,-9
-41.96972,-20.72896,55,36,5,-19
-41.96949,-20.72896,55,35,5,-20
-41.96927,-20.72896,54,35,5,-19
-42.1005,-20.72853,61,33,0,-28
-42.0978,-20.72853,61,32,0,-29
-42.09511,-20.72853,65,24,5,-41
-42.09219,-20.72853,60,24,5,-36
-42.08949,-20.72853,63,27,5,-36
-42.08657,-20.72853,63,35,0,-28
-42.08387,-20.72853,64,28,5,-36
-42.08118,-20.72853,65,31,5,-34
-42.07825,-20.72853,54,35,5,-19
-42.07556,-20.72853,69,43,0,-26
-42.07286,-20.72853,69,42,5,-27
-42.06994,-20.72853,70,39,5,-31
-42.06724,-20.72853,51,40,5,-11
-42.06455,-20.72853,47,42,5,-5
-42.06163,-20.72853,57,55,0,-2
-42.05893,-20.72853,47,51,11,4
-42.05601,-20.72853,30,43,5,13
-42.05331,-20.72853,38,53,0,15
-42.05061,-20.72853,26,45,5,19
-42.04769,-20.72853,5,49,0,44
-42.045,-20.72853,15,45,5,30
-42.0423,-20.72853,11,53,5,42
-42.03938,-20.72853,10,65,2,55
-42.03106,-20.72853,26,73,2,47
-42.02837,-20.72853,26,63,2,37
-42.02545,-20.72853,30,54,5,24
-42.02275,-20.72853,44,49,5,5
-42.02005,-20.72853,42,49,5,7
-42.01713,-20.72853,45,45,5,0
-42.01444,-20.72853,43,43,5,0
-42.01174,-20.72853,43,43,5,0
-42.00882,-20.72853,41,41,5,0
-42.00612,-20.72853,39,39,5,0
-42.00342,-20.72853,60,46,0,-14
-42.0005,-20.72853,59,39,0,-20
-41.99781,-20.72853,59,42,0,-17
-41.99511,-20.72853,59,38,5,-21
-41.99219,-20.72853,65,35,5,-30
-41.98949,-20.72853,61,37,0,-24
-41.98657,-20.72853,59,37,0,-22
-41.98387,-20.72853,67,39,0,-28
-41.98118,-20.72853,60,40,0,-20
-41.97826,-20.72853,58,43,0,-15
-41.97556,-20.72853,57,44,0,-13
-41.97286,-20.72853,56,46,0,-10
-41.96994,-20.72853,55,46,5,-9
-42.1005,-20.72832,61,34,0,-27
-42.0978,-20.72832,61,31,0,-30
-42.09511,-20.72832,64,24,5,-40
-42.09219,-20.72832,60,24,5,-36
-42.08949,-20.72832,64,27,5,-37
-42.08657,-20.72832,61,34,0,-27
-42.08387,-20.72832,63,28,5,-35
-42.08118,-20.72832,65,31,5,-34
-42.07825,-20.72832,55,35,5,-20
-42.07556,-20.72832,59,43,0,-16
-42.07286,-20.72832,69,41,5,-28
-42.06994,-20.72832,74,37,5,-37
-42.06724,-20.72832,50,37,5,-13
-42.06455,-20.72832,43,41,5,-2
-42.06163,-20.72832,55,54,0,-1
-42.05893,-20.72832,47,54,0,7
-42.05601,-20.72832,28,43,5,15
-42.05331,-20.72832,37,53,0,16
-42.05061,-20.72832,25,46,5,21
-42.04769,-20.72832,10,47,5,37
-42.045,-20.72832,14,45,5,31
-42.0423,-20.72832,10,53,5,43
-42.03938,-20.72832,6,65,2,59
-42.03399,-20.72832,4,61,2,57
-42.03106,-20.72832,23,69,5,46
-42.02837,-20.72832,26,63,2,37
-42.02545,-20.72832,29,54,5,25
-42.02275,-20.72832,45,49,5,4
-42.02005,-20.72832,42,48,5,6
-42.01713,-20.72832,43,43,5,0
-42.01444,-20.72832,43,45,5,2
-42.01174,-20.72832,43,43,5,0
-42.00882,-20.72832,41,41,5,0
-42.00612,-20.72832,39,39,5,0
-42.00342,-20.72832,60,47,0,-13
-42.0005,-20.72832,60,38,0,-22
-41.99781,-20.72832,59,41,0,-18
-41.99511,-20.72832,59,37,5,-22
-41.99219,-20.72832,66,36,5,-30
-41.98949,-20.72832,61,37,0,-24
-41.98657,-20.72832,59,40,0,-19
-41.98387,-20.72832,66,39,0,-27
-41.98118,-20.72832,59,40,0,-19
-41.97826,-20.72832,58,43,0,-15
-41.97556,-20.72832,57,44,0,-13
-41.97286,-20.72832,56,46,0,-10
-41.96994,-20.72832,55,36,5,-19
-42.1005,-20.72811,60,34,0,-26
-42.0978,-20.72811,61,31,0,-30
-42.09511,-20.72811,63,24,5,-39
-42.09219,-20.72811,66,24,5,-42
-42.08949,-20.72811,62,27,5,-35
-42.08657,-20.72811,60,34,0,-26
-42.08387,-20.72811,62,29,5,-33
-42.08118,-20.72811,63,31,5,-32
-42.07825,-20.72811,55,36,5,-19
-42.07556,-20.72811,57,43,0,-14
-42.07286,-20.72811,69,41,5,-28
-42.06994,-20.72811,74,38,5,-36
-42.06724,-20.72811,48,38,5,-10
-42.06455,-20.72811,42,42,5,0
-42.06163,-20.72811,54,54,0,0
-42.05893,-20.72811,42,53,0,11
-42.05601,-20.72811,30,43,5,13
-42.05331,-20.72811,34,46,0,12
-42.05061,-20.72811,28,45,5,17
-42.04769,-20.72811,12,43,5,31
-42.045,-20.72811,14,43,5,29
-42.0423,-20.72811,10,53,5,43
-42.03938,-20.72811,10,67,2,57
-42.03399,-20.72811,6,65,6,59
-42.03106,-20.72811,22,69,5,47
-42.02837,-20.72811,28,63,11,35
-42.02545,-20.72811,33,53,5,20
-42.02275,-20.72811,44,48,5,4
-42.02005,-20.72811,42,48,5,6
-42.01713,-20.72811,44,44,5,0
-42.01444,-20.72811,43,44,5,1
-42.01174,-20.72811,43,43,5,0
-42.00882,-20.72811,41,40,5,-1
-42.00612,-20.72811,39,39,5,0
-42.00342,-20.72811,61,47,0,-14
-42.0005,-20.72811,60,37,0,-23
-41.99781,-20.72811,59,40,0,-19
-41.99511,-20.72811,59,38,5,-21
-41.99219,-20.72811,65,42,0,-23
-41.98949,-20.72811,61,37,0,-24
-41.98657,-20.72811,60,41,0,-19
-41.98387,-20.72811,67,38,0,-29
-41.98118,-20.72811,58,41,0,-17
-41.97826,-20.72811,58,43,0,-15
-41.97556,-20.72811,57,44,5,-13
-41.97286,-20.72811,55,46,0,-9
-41.96994,-20.72811,55,36,5,-19
-42.1005,-20.72769,60,34,0,-26
-42.0978,-20.72769,61,30,0,-31
-42.09511,-20.72769,62,24,5,-38
-42.09219,-20.72769,67,24,5,-43
-42.08949,-20.72769,61,27,5,-34
-42.08657,-20.72769,60,35,0,-25
-42.08387,-20.72769,61,30,5,-31
-42.08118,-20.72769,62,31,5,-31
-42.07825,-20.72769,55,43,5,-12
-42.07556,-20.72769,57,42,0,-15
-42.07286,-20.72769,61,41,5,-20
-42.06994,-20.72769,71,38,5,-33
-42.06724,-20.72769,47,39,5,-8
-42.06455,-20.72769,42,41,5,-1
-42.06163,-20.72769,46,49,0,3
-42.05893,-20.72769,44,46,0,2
-42.05601,-20.72769,38,43,5,5
-42.05331,-20.72769,33,46,5,13
-42.05061,-20.72769,31,47,5,16
-42.04769,-20.72769,10,49,11,39
-42.045,-20.72769,13,45,11,32
-42.0423,-20.72769,18,56,11,38
-42.03938,-20.72769,10,69,2,59
-42.03399,-20.72769,8,66,2,58
-42.03106,-20.72769,20,67,5,47
-42.02837,-20.72769,26,58,5,32
-42.02545,-20.72769,36,54,5,18
-42.02275,-20.72769,45,48,5,3
-42.02005,-20.72769,42,47,5,5
-42.01713,-20.72769,44,45,5,1
-42.01444,-20.72769,43,43,5,0
-42.01174,-20.72769,43,43,5,0
-42.00882,-20.72769,41,40,5,-1
-42.00612,-20.72769,47,39,5,-8
-42.00342,-20.72769,62,42,5,-20
-42.0005,-20.72769,60,35,0,-25
-41.99781,-20.72769,60,40,0,-20
-41.99511,-20.72769,59,35,5,-24
-41.99219,-20.72769,64,36,0,-28
-41.98949,-20.72769,61,37,0,-24
-41.98657,-20.72769,59,41,0,-18
-41.98387,-20.72769,63,34,0,-29
-41.98118,-20.72769,58,42,0,-16
-41.97826,-20.72769,57,30,5,-27
-41.97556,-20.72769,57,44,5,-13
-41.97286,-20.72769,55,46,0,-9
-41.96994,-20.72769,54,36,5,-18
-42.1005,-20.72748,60,34,0,-26
-42.0978,-20.72748,61,31,0,-30
-42.09511,-20.72748,62,25,5,-37
-42.09219,-20.72748,66,25,5,-41
-42.08949,-20.72748,61,27,5,-34
-42.08657,-20.72748,60,35,0,-25
-42.08387,-20.72748,60,30,5,-30
-42.08118,-20.72748,61,31,5,-30
-42.07825,-20.72748,56,43,0,-13
-42.07556,-20.72748,57,42,0,-15
-42.07286,-20.72748,59,41,0,-18
-42.06994,-20.72748,63,37,5,-26
-42.06724,-20.72748,47,37,5,-10
-42.06455,-20.72748,41,41,5,0
-42.06163,-20.72748,44,49,0,5
-42.05893,-20.72748,45,46,5,1
-42.05601,-20.72748,42,44,0,2
-42.05331,-20.72748,35,46,5,11
-42.05061,-20.72748,30,47,5,17
-42.04769,-20.72748,7,50,11,43
-42.045,-20.72748,18,45,5,27
-42.0423,-20.72748,19,58,0,39
-42.03938,-20.72748,15,69,2,54
-42.03399,-20.72748,2,67,2,65
-42.03106,-20.72748,22,67,5,45
-42.02837,-20.72748,26,57,5,31
-42.02545,-20.72748,37,54,5,17
-42.02275,-20.72748,49,49,5,0
-42.02005,-20.72748,43,43,5,0
-42.01713,-20.72748,44,46,5,2
-42.01444,-20.72748,43,44,5,1
-42.01174,-20.72748,43,42,5,-1
-42.00882,-20.72748,41,40,5,-1
-42.00612,-20.72748,50,38,5,-12
-42.00342,-20.72748,63,41,5,-22
-42.0005,-20.72748,60,34,0,-26
-41.99781,-20.72748,60,39,0,-21
-41.99511,-20.72748,58,36,5,-22
-41.99219,-20.72748,64,35,0,-29
-41.98949,-20.72748,60,36,0,-24
-41.98657,-20.72748,60,41,0,-19
-41.98387,-20.72748,63,33,0,-30
-41.98118,-20.72748,58,42,0,-16
-41.97826,-20.72748,57,30,5,-27
-41.97556,-20.72748,57,38,5,-19
-41.97286,-20.72748,55,46,0,-9
-41.96994,-20.72748,54,39,5,-15
-42.1005,-20.72726,61,34,0,-27
-42.0978,-20.72726,61,31,0,-30
-42.09511,-20.72726,65,25,5,-40
-42.09219,-20.72726,66,25,5,-41
-42.08949,-20.72726,60,27,5,-33
-42.08657,-20.72726,60,35,0,-25
-42.08387,-20.72726,60,30,5,-30
-42.08118,-20.72726,60,31,5,-29
-42.07825,-20.72726,56,43,0,-13
-42.07556,-20.72726,57,42,0,-15
-42.07286,-20.72726,58,41,0,-17
-42.06994,-20.72726,64,36,5,-28
-42.06724,-20.72726,46,37,5,-9
-42.06455,-20.72726,41,40,5,-1
-42.06163,-20.72726,44,51,0,7
-42.05893,-20.72726,43,42,5,-1
-42.05601,-20.72726,43,52,0,9
-42.05331,-20.72726,38,45,5,7
-42.05061,-20.72726,28,47,5,19
-42.04769,-20.72726,5,54,0,49
-42.045,-20.72726,18,45,0,27
-42.0423,-20.72726,21,59,0,38
-42.03938,-20.72726,18,70,2,52
-42.03106,-20.72726,19,66,5,47
-42.02837,-20.72726,21,57,5,36
-42.02545,-20.72726,39,54,5,15
-42.02275,-20.72726,48,48,5,0
-42.02005,-20.72726,43,43,5,0
-42.01713,-20.72726,44,46,5,2
-42.01444,-20.72726,44,45,5,1
-42.01174,-20.72726,43,42,5,-1
-42.00882,-20.72726,42,40,5,-2
-42.00612,-20.72726,50,38,5,-12
-42.00342,-20.72726,63,41,5,-22
-42.0005,-20.72726,62,33,0,-29
-41.99781,-20.72726,68,37,0,-31
-41.99511,-20.72726,58,36,5,-22
-41.99219,-20.72726,63,35,0,-28
-41.98949,-20.72726,60,36,0,-24
-41.98657,-20.72726,60,41,0,-19
-41.98387,-20.72726,62,33,0,-29
-41.98118,-20.72726,57,42,0,-15
-41.97826,-20.72726,57,30,5,-27
-41.97556,-20.72726,57,44,5,-13
-41.97286,-20.72726,55,46,0,-9
-41.96994,-20.72726,54,47,5,-7
-42.1005,-20.72684,61,34,0,-27
-42.0978,-20.72684,61,31,0,-30
-42.09511,-20.72684,67,25,5,-42
-42.09219,-20.72684,61,25,5,-36
-42.08949,-20.72684,60,27,5,-33
-42.08657,-20.72684,60,35,5,-25
-42.08387,-20.72684,60,30,5,-30
-42.08118,-20.72684,61,31,5,-30
-42.07825,-20.72684,56,43,0,-13
-42.07556,-20.72684,57,42,0,-15
-42.07286,-20.72684,58,41,0,-17
-42.06994,-20.72684,61,36,5,-25
-42.06724,-20.72684,44,38,5,-6
-42.06455,-20.72684,41,42,5,1
-42.06163,-20.72684,44,45,0,1
-42.05893,-20.72684,43,43,5,0
-42.05601,-20.72684,43,47,0,4
-42.05331,-20.72684,40,45,5,5
-42.05061,-20.72684,27,48,5,21
-42.04769,-20.72684,5,54,0,49
-42.045,-20.72684,19,53,0,34
-42.0423,-20.72684,27,62,0,35
-42.03938,-20.72684,23,69,2,46
-42.03106,-20.72684,24,66,5,42
-42.02837,-20.72684,7,58,5,51
-42.02545,-20.72684,40,56,5,16
-42.02275,-20.72684,44,45,5,1
-42.02005,-20.72684,44,45,5,1
-42.01713,-20.72684,44,47,5,3
-42.01444,-20.72684,46,46,5,0
-42.01174,-20.72684,43,41,5,-2
-42.00882,-20.72684,45,40,5,-5
-42.00612,-20.72684,44,41,5,-3
-42.00342,-20.72684,62,42,5,-20
-42.0005,-20.72684,72,32,0,-40
-41.99781,-20.72684,71,36,5,-35
-41.99511,-20.72684,58,35,5,-23
-41.99219,-20.72684,64,36,0,-28
-41.98949,-20.72684,59,36,0,-23
-41.98657,-20.72684,63,41,0,-22
-41.98387,-20.72684,60,33,0,-27
-41.98118,-20.72684,57,42,0,-15
-41.97826,-20.72684,60,30,5,-30
-41.97556,-20.72684,57,44,0,-13
-41.97286,-20.72684,55,45,0,-10
-41.96994,-20.72684,53,47,0,-6
-42.1005,-20.72663,61,35,0,-26
-42.0978,-20.72663,61,32,0,-29
-42.09511,-20.72663,67,25,5,-42
-42.09219,-20.72663,66,26,5,-40
-42.08949,-20.72663,63,28,5,-35
-42.08657,-20.72663,60,35,5,-25
-42.08387,-20.72663,60,33,5,-27
-42.08118,-20.72663,62,32,5,-30
-42.07825,-20.72663,55,42,0,-13
-42.07556,-20.72663,56,41,0,-15
-42.07286,-20.72663,58,40,0,-18
-42.06994,-20.72663,58,37,5,-21
-42.06724,-20.72663,39,39,5,0
-42.06455,-20.72663,41,41,5,0
-42.06163,-20.72663,44,45,0,1
-42.05893,-20.72663,43,43,5,0
-42.05601,-20.72663,43,44,0,1
-42.05331,-20.72663,42,45,5,3
-42.05061,-20.72663,26,48,11,22
-42.04769,-20.72663,7,54,0,47
-42.045,-20.72663,28,55,0,27
-42.0423,-20.72663,19,63,0,44
-42.03938,-20.72663,26,68,2,42
-42.03668,-20.72663,3,78,2,75
-42.03106,-20.72663,23,66,5,43
-42.02837,-20.72663,1,58,5,57
-42.02545,-20.72663,41,56,5,15
-42.02275,-20.72663,49,49,5,0
-42.02005,-20.72663,44,46,5,2
-42.01713,-20.72663,44,47,5,3
-42.01444,-20.72663,46,47,5,1
-42.01174,-20.72663,43,42,5,-1
-42.00882,-20.72663,44,40,5,-4
-42.00612,-20.72663,45,41,5,-4
-42.00342,-20.72663,62,42,5,-20
-42.0005,-20.72663,74,33,0,-41
-41.99781,-20.72663,72,34,5,-38
-41.99511,-20.72663,60,39,5,-21
-41.99219,-20.72663,63,35,0,-28
-41.98949,-20.72663,59,36,0,-23
-41.98657,-20.72663,65,41,0,-24
-41.98387,-20.72663,61,34,0,-27
-41.98118,-20.72663,57,43,0,-14
-41.97826,-20.72663,58,30,5,-28
-41.97556,-20.72663,57,44,0,-13
-41.97286,-20.72663,55,45,0,-10
-41.96994,-20.72663,53,47,0,-6
-42.1005,-20.72642,61,35,0,-26
-42.0978,-20.72642,61,32,0,-29
-42.09511,-20.72642,67,25,5,-42
-42.09219,-20.72642,62,25,5,-37
-42.08949,-20.72642,66,28,5,-38
-42.08657,-20.72642,60,35,5,-25
-42.08387,-20.72642,60,33,5,-27
-42.08118,-20.72642,65,32,5,-33
-42.07825,-20.72642,55,42,0,-13
-42.07556,-20.72642,56,41,0,-15
-42.07286,-20.72642,58,40,0,-18
-42.06994,-20.72642,59,36,5,-23
-42.06724,-20.72642,43,38,5,-5
-42.06455,-20.72642,41,41,5,0
-42.06163,-20.72642,44,45,0,1
-42.05893,-20.72642,43,42,0,-1
-42.05601,-20.72642,43,44,5,1
-42.05331,-20.72642,44,45,5,1
-42.05061,-20.72642,25,49,5,24
-42.04769,-20.72642,9,57,0,48
-42.045,-20.72642,30,54,0,24
-42.0423,-20.72642,22,64,0,42
-42.03938,-20.72642,25,69,2,44
-42.03106,-20.72642,25,66,5,41
-42.02837,-20.72642,1,59,5,58
-42.02545,-20.72642,41,55,5,14
-42.02275,-20.72642,49,49,5,0
-42.02005,-20.72642,45,46,5,1
-42.01713,-20.72642,44,47,5,3
-42.01444,-20.72642,44,44,5,0
-42.01174,-20.72642,43,42,5,-1
-42.00882,-20.72642,43,40,5,-3
-42.00612,-20.72642,44,41,5,-3
-42.00342,-20.72642,58,42,5,-16
-42.0005,-20.72642,76,32,0,-44
-41.99781,-20.72642,74,33,5,-41
-41.99511,-20.72642,65,39,5,-26
-41.99219,-20.72642,66,35,0,-31
-41.98949,-20.72642,62,36,0,-26
-41.98657,-20.72642,66,40,0,-26
-41.98387,-20.72642,60,33,5,-27
-41.98118,-20.72642,57,42,0,-15
-41.97826,-20.72642,65,30,5,-35
-41.97556,-20.72642,56,44,0,-12
-41.97286,-20.72642,54,45,0,-9
-41.96994,-20.72642,52,47,0,-5
-42.10297,-20.72621,61,36,0,-25
-42.10275,-20.72621,61,36,0,-25
-42.10252,-20.72621,61,35,0,-26
-42.1023,-20.72621,61,35,0,-26
-42.10185,-20.72621,61,35,0,-26
-42.10163,-20.72621,61,34,0,-27
-42.1014,-20.72621,61,34,0,-27
-42.10118,-20.72621,61,34,0,-27
-42.10073,-20.72621,61,35,0,-26
-42.1005,-20.72621,61,35,0,-26
-42.10028,-20.72621,61,35,0,-26
-42.10005,-20.72621,61,35,0,-26
-42.09983,-20.72621,61,35,0,-26
-42.09938,-20.72621,61,35,0,-26
-42.09915,-20.72621,61,35,0,-26
-42.09893,-20.72621,61,34,0,-27
-42.0987,-20.72621,61,34,0,-27
-42.09825,-20.72621,67,33,0,-34
-42.09803,-20.72621,61,33,0,-28
-42.0978,-20.72621,61,32,0,-29
-42.09758,-20.72621,61,32,0,-29
-42.09713,-20.72621,61,31,0,-30
-42.09691,-20.72621,61,31,0,-30
-42.09668,-20.72621,61,30,0,-31
-42.09646,-20.72621,62,29,5,-33
-42.09601,-20.72621,63,27,5,-36
-42.09578,-20.72621,65,27,5,-38
-42.09556,-20.72621,68,25,5,-43
-42.09533,-20.72621,68,25,5,-43
-42.09511,-20.72621,67,25,5,-42
-42.09466,-20.72621,67,26,5,-41
-42.09443,-20.72621,65,26,5,-39
-42.09421,-20.72621,61,26,5,-35
-42.09398,-20.72621,61,26,5,-35
-42.09354,-20.72621,61,26,5,-35
-42.09331,-20.72621,62,26,5,-36
-42.09309,-20.72621,64,26,5,-38
-42.09286,-20.72621,63,26,5,-37
-42.09241,-20.72621,62,26,5,-36
-42.09219,-20.72621,62,26,5,-36
-42.09196,-20.72621,60,26,5,-34
-42.09174,-20.72621,60,26,5,-34
-42.09129,-20.72621,60,26,5,-34
-42.09106,-20.72621,60,26,5,-34
-42.09084,-20.72621,61,26,5,-35
-42.09061,-20.72621,61,26,5,-35
-42.09039,-20.72621,63,26,5,-37
-42.08994,-20.72621,66,26,5,-40
-42.08972,-20.72621,67,28,5,-39
-42.08949,-20.72621,67,28,5,-39
-42.08927,-20.72621,67,28,5,-39
-42.08882,-20.72621,62,29,5,-33
-42.08859,-20.72621,59,31,5,-28
-42.08837,-20.72621,59,31,5,-28
-42.08814,-20.72621,59,31,5,-28
-42.08769,-20.72621,60,33,5,-27
-42.08747,-20.72621,60,33,5,-27
-42.08724,-20.72621,60,33,5,-27
-42.08702,-20.72621,60,33,5,-27
-42.08657,-20.72621,60,36,5,-24
-42.08634,-20.72621,60,36,0,-24
-42.08612,-20.72621,60,36,0,-24
-42.08589,-20.72621,60,35,0,-25
-42.08545,-20.72621,62,35,0,-27
-42.08522,-20.72621,60,35,0,-25
-42.085,-20.72621,61,35,0,-26
-42.08477,-20.72621,61,35,0,-26
-42.08455,-20.72621,60,34,0,-26
-42.0841,-20.72621,60,34,0,-26
-42.08387,-20.72621,61,33,5,-28
-42.08365,-20.72621,61,30,5,-31
-42.08342,-20.72621,61,30,5,-31
-42.08297,-20.72621,61,28,5,-33
-42.08275,-20.72621,61,28,5,-33
-42.08252,-20.72621,62,30,5,-32
-42.0823,-20.72621,62,30,5,-32
-42.08185,-20.72621,63,30,5,-33
-42.08163,-20.72621,64,29,5,-35
-42.0814,-20.72621,65,32,5,-33
-42.08118,-20.72621,66,32,5,-34
-42.08073,-20.72621,65,31,5,-34
-42.0805,-20.72621,63,32,5,-31
-42.08028,-20.72621,63,35,5,-28
-42.08005,-20.72621,55,35,5,-20
-42.07983,-20.72621,54,38,5,-16
-42.07938,-20.72621,54,42,5,-12
-42.07915,-20.72621,55,42,0,-13
-42.07893,-20.72621,55,42,0,-13
-42.0787,-20.72621,55,42,0,-13
-42.07825,-20.72621,55,41,0,-14
-42.07803,-20.72621,55,41,0,-14
-42.07781,-20.72621,55,41,0,-14
-42.07758,-20.72621,55,41,0,-14
-42.07713,-20.72621,55,41,0,-14
-42.07691,-20.72621,55,41,0,-14
-42.07668,-20.72621,56,41,0,-15
-42.07646,-20.72621,56,41,0,-15
-42.07601,-20.72621,56,41,0,-15
-42.07578,-20.72621,56,41,0,-15
-42.07556,-20.72621,56,41,0,-15
-42.07533,-20.72621,56,41,0,-15
-42.07511,-20.72621,56,41,0,-15
-42.07466,-20.72621,56,41,0,-15
-42.07443,-20.72621,56,41,0,-15
-42.07421,-20.72621,56,41,0,-15
-42.07399,-20.72621,57,41,0,-16
-42.07354,-20.72621,57,40,0,-17
-42.07331,-20.72621,57,40,0,-17
-42.07309,-20.72621,57,40,0,-17
-42.07286,-20.72621,57,39,0,-18
-42.07241,-20.72621,58,36,5,-22
-42.07219,-20.72621,58,35,5,-23
-42.07196,-20.72621,58,35,5,-23
-42.07174,-20.72621,58,36,5,-22
-42.07129,-20.72621,58,36,5,-22
-42.07106,-20.72621,59,36,5,-23
-42.07084,-20.72621,59,36,5,-23
-42.07061,-20.72621,60,37,5,-23
-42.07039,-20.72621,62,37,5,-25
-42.06994,-20.72621,59,36,5,-23
-42.06972,-20.72621,60,36,5,-24
-42.06949,-20.72621,57,38,5,-19
-42.06927,-20.72621,52,38,5,-14
-42.06882,-20.72621,51,37,5,-14
-42.06859,-20.72621,50,37,5,-13
-42.06837,-20.72621,50,38,5,-12
-42.06814,-20.72621,49,38,5,-11
-42.06769,-20.72621,46,38,5,-8
-42.06747,-20.72621,45,38,5,-7
-42.06724,-20.72621,44,38,5,-6
-42.06702,-20.72621,40,38,5,-2
-42.06657,-20.72621,35,38,5,3
-42.06634,-20.72621,39,39,5,0
-42.06612,-20.72621,39,39,5,0
-42.0659,-20.72621,36,39,5,3
-42.06545,-20.72621,39,39,5,0
-42.06522,-20.72621,40,41,5,1
-42.065,-20.72621,38,41,5,3
-42.06477,-20.72621,39,41,5,2
-42.06455,-20.72621,40,41,5,1
-42.0641,-20.72621,41,45,5,4
-42.06387,-20.72621,42,41,5,-1
-42.06365,-20.72621,43,43,5,0
-42.06342,-20.72621,43,42,0,-1
-42.06297,-20.72621,43,42,0,-1
-42.06275,-20.72621,43,45,0,2
-42.06252,-20.72621,43,51,0,8
-42.0623,-20.72621,43,51,0,8
-42.06185,-20.72621,43,45,0,2
-42.06163,-20.72621,44,45,0,1
-42.0614,-20.72621,44,45,5,1
-42.06118,-20.72621,44,42,5,-2
-42.06073,-20.72621,44,42,5,-2
-42.0605,-20.72621,44,42,5,-2
-42.06028,-20.72621,44,42,5,-2
-42.06005,-20.72621,44,42,5,-2
-42.05983,-20.72621,44,42,5,-2
-42.05938,-20.72621,43,43,5,0
-42.05915,-20.72621,43,43,5,0
-42.05893,-20.72621,43,43,5,0
-42.0587,-20.72621,43,42,5,-1
-42.05826,-20.72621,43,48,0,5
-42.05803,-20.72621,42,44,0,2
-42.05781,-20.72621,42,43,0,1
-42.05758,-20.72621,42,43,0,1
-42.05713,-20.72621,43,43,5,0
-42.05691,-20.72621,43,44,5,1
-42.05668,-20.72621,43,43,5,0
-42.05646,-20.72621,43,43,5,0
-42.05601,-20.72621,44,44,5,0
-42.05578,-20.72621,44,44,5,0
-42.05556,-20.72621,44,44,5,0
-42.05533,-20.72621,44,44,5,0
-42.05511,-20.72621,44,44,5,0
-42.05466,-20.72621,44,45,5,1
-42.05443,-20.72621,44,45,5,1
-42.05421,-20.72621,44,45,5,1
-42.05399,-20.72621,44,45,5,1
-42.05354,-20.72621,44,45,5,1
-42.05331,-20.72621,44,45,5,1
-42.05309,-20.72621,45,45,5,0
-42.05286,-20.72621,40,45,5,5
-42.05241,-20.72621,37,46,5,9
-42.05219,-20.72621,34,46,5,12
-42.05196,-20.72621,23,46,5,23
-42.05174,-20.72621,10,46,5,36
-42.05129,-20.72621,11,48,5,37
-42.05106,-20.72621,23,48,5,25
-42.05084,-20.72621,11,49,11,38
-42.05061,-20.72621,22,49,5,27
-42.05039,-20.72621,24,49,5,25
-42.04994,-20.72621,22,52,5,30
-42.04972,-20.72621,21,51,5,30
-42.04949,-20.72621,21,50,5,29
-42.04927,-20.72621,7,51,0,44
-42.04882,-20.72621,20,58,0,38
-42.04859,-20.72621,6,67,0,61
-42.04837,-20.72621,7,64,0,57
-42.04814,-20.72621,18,63,0,45
-42.04769,-20.72621,11,59,0,48
-42.04747,-20.72621,18,58,0,40
-42.04724,-20.72621,17,56,0,39
-42.04702,-20.72621,15,55,0,40
-42.04657,-20.72621,17,51,0,34
-42.04635,-20.72621,22,48,0,26
-42.04612,-20.72621,27,48,0,21
-42.0459,-20.72621,29,48,0,19
-42.04545,-20.72621,30,48,0,18
-42.04522,-20.72621,31,48,0,17
-42.045,-20.72621,32,49,0,17
-42.04477,-20.72621,33,55,0,22
-42.04455,-20.72621,34,56,0,22
-42.0441,-20.72621,34,63,0,29
-42.04387,-20.72621,34,68,0,34
-42.04365,-20.72621,35,70,0,35
-42.04342,-20.72621,34,70,0,36
-42.04297,-20.72621,34,67,0,33
-42.04275,-20.72621,31,64,0,33
-42.04253,-20.72621,31,64,0,33
-42.0423,-20.72621,23,65,0,42
-42.04185,-20.72621,18,65,0,47
-42.04163,-20.72621,18,65,0,47
-42.0414,-20.72621,17,64,0,47
-42.04118,-20.72621,18,63,0,45
-42.04073,-20.72621,18,63,0,45
-42.0405,-20.72621,29,63,0,34
-42.04028,-20.72621,30,66,0,36
-42.04005,-20.72621,28,68,0,40
-42.03983,-20.72621,26,64,2,38
-42.03938,-20.72621,24,69,2,45
-42.03915,-20.72621,25,69,2,44
-42.03893,-20.72621,24,70,2,46
-42.0387,-20.72621,19,70,2,51
-42.03826,-20.72621,15,73,11,58
-42.03803,-20.72621,8,71,2,63
-42.03466,-20.72621,3,74,2,71
-42.03241,-20.72621,5,60,2,55
-42.03219,-20.72621,6,60,2,54
-42.03196,-20.72621,5,60,5,55
-42.03174,-20.72621,8,60,5,52
-42.03129,-20.72621,21,67,5,46
-42.03106,-20.72621,24,67,5,43
-42.03084,-20.72621,23,66,5,43
-42.03062,-20.72621,23,64,5,41
-42.03017,-20.72621,20,64,5,44
-42.02994,-20.72621,15,64,5,49
-42.02972,-20.72621,8,64,5,56
-42.02949,-20.72621,10,64,5,54
-42.02859,-20.72621,14,60,5,46
-42.02837,-20.72621,1,59,5,58
-42.02814,-20.72621,16,58,5,42
-42.02769,-20.72621,18,58,5,40
-42.02747,-20.72621,29,58,5,29
-42.02724,-20.72621,31,58,5,27
-42.02702,-20.72621,33,61,5,28
-42.02657,-20.72621,37,57,5,20
-42.02635,-20.72621,37,57,5,20
-42.02612,-20.72621,40,55,5,15
-42.0259,-20.72621,41,54,5,13
-42.02545,-20.72621,40,53,5,13
-42.02522,-20.72621,41,52,5,11
-42.025,-20.72621,42,51,5,9
-42.02477,-20.72621,43,51,5,8
-42.02455,-20.72621,46,51,5,5
-42.0241,-20.72621,44,49,5,5
-42.02387,-20.72621,45,49,5,4
-42.02365,-20.72621,44,47,5,3
-42.02342,-20.72621,44,47,5,3
-42.02297,-20.72621,47,49,5,2
-42.02275,-20.72621,46,48,0,2
-42.02253,-20.72621,49,49,0,0
-42.0223,-20.72621,50,48,0,-2
-42.02185,-20.72621,50,47,0,-3
-42.02163,-20.72621,50,47,0,-3
-42.0214,-20.72621,50,47,0,-3
-42.02118,-20.72621,47,47,0,0
-42.02073,-20.72621,45,45,5,0
-42.0205,-20.72621,45,45,5,0
-42.02028,-20.72621,45,45,5,0
-42.02005,-20.72621,45,46,11,1
-42.01983,-20.72621,45,46,5,1
-42.01938,-20.72621,45,46,5,1
-42.01915,-20.72621,45,46,5,1
-42.01893,-20.72621,45,46,5,1
-42.01871,-20.72621,45,48,5,3
-42.01826,-20.72621,45,54,5,9
-42.01803,-20.72621,45,50,5,5
-42.01781,-20.72621,45,48,5,3
-42.01758,-20.72621,44,49,5,5
-42.01713,-20.72621,43,45,5,2
-42.01691,-20.72621,42,45,5,3
-42.01668,-20.72621,42,45,5,3
-42.01646,-20.72621,42,47,5,5
-42.01601,-20.72621,42,45,5,3
-42.01578,-20.72621,42,44,5,2
-42.01556,-20.72621,42,45,5,3
-42.01533,-20.72621,42,44,5,2
-42.01511,-20.72621,46,45,5,-1
-42.01466,-20.72621,46,46,5,0
-42.01444,-20.72621,46,46,5,0
-42.01421,-20.72621,46,46,5,0
-42.01399,-20.72621,43,44,5,1
-42.01354,-20.72621,43,44,5,1
-42.01331,-20.72621,43,44,5,1
-42.01309,-20.72621,43,46,5,3
-42.01286,-20.72621,43,45,5,2
-42.01241,-20.72621,43,43,5,0
-42.01219,-20.72621,43,43,5,0
-42.01196,-20.72621,43,43,5,0
-42.01174,-20.72621,43,42,5,-1
-42.01129,-20.72621,43,42,5,-1
-42.01106,-20.72621,48,42,5,-6
-42.01084,-20.72621,49,42,5,-7
-42.01062,-20.72621,50,43,5,-7
-42.01017,-20.72621,49,45,5,-4
-42.00994,-20.72621,47,45,5,-2
-42.00972,-20.72621,43,43,5,0
-42.00949,-20.72621,43,43,5,0
-42.00927,-20.72621,43,42,5,-1
-42.00882,-20.72621,43,40,5,-3
-42.00859,-20.72621,43,41,5,-2
-42.00837,-20.72621,44,42,5,-2
-42.00814,-20.72621,56,42,5,-14
-42.00769,-20.72621,54,39,5,-15
-42.00747,-20.72621,53,40,5,-13
-42.00724,-20.72621,51,40,5,-11
-42.00702,-20.72621,50,42,5,-8
-42.00657,-20.72621,48,41,5,-7
-42.00635,-20.72621,46,41,5,-5
-42.00612,-20.72621,45,41,5,-4
-42.0059,-20.72621,44,41,5,-3
-42.00545,-20.72621,49,41,5,-8
-42.00522,-20.72621,51,38,5,-13
-42.005,-20.72621,54,39,5,-15
-42.00477,-20.72621,49,42,5,-7
-42.00455,-20.72621,47,42,5,-5
-42.0041,-20.72621,45,42,5,-3
-42.00387,-20.72621,45,42,5,-3
-42.00365,-20.72621,45,42,5,-3
-42.00342,-20.72621,50,42,5,-8
-42.00298,-20.72621,54,41,0,-13
-42.00275,-20.72621,60,40,0,-20
-42.00253,-20.72621,61,40,0,-21
-42.0023,-20.72621,61,38,0,-23
-42.00185,-20.72621,64,36,0,-28
-42.00163,-20.72621,64,36,0,-28
-42.0014,-20.72621,77,35,0,-42
-42.00118,-20.72621,84,34,0,-50
-42.00073,-20.72621,79,31,0,-48
-42.0005,-20.72621,76,30,0,-46
-42.00028,-20.72621,83,29,0,-54
-42.00005,-20.72621,76,29,0,-47
-41.99983,-20.72621,75,30,0,-45
-41.99938,-20.72621,75,28,5,-47
-41.99916,-20.72621,75,27,5,-48
-41.99893,-20.72621,75,21,5,-54
-41.99871,-20.72621,75,24,5,-51
-41.99826,-20.72621,74,22,5,-52
-41.99803,-20.72621,74,27,5,-47
-41.99781,-20.72621,74,30,5,-44
-41.99758,-20.72621,74,31,5,-43
-41.99713,-20.72621,74,32,5,-42
-41.99691,-20.72621,74,32,5,-42
-41.99668,-20.72621,74,35,5,-39
-41.99646,-20.72621,74,35,5,-39
-41.99601,-20.72621,74,41,5,-33
-41.99578,-20.72621,74,40,5,-34
-41.99556,-20.72621,66,43,5,-23
-41.99533,-20.72621,64,43,5,-21
-41.99511,-20.72621,63,43,5,-20
-41.99466,-20.72621,61,43,5,-18
-41.99444,-20.72621,59,43,5,-16
-41.99421,-20.72621,59,43,5,-16
-41.99399,-20.72621,58,39,5,-19
-41.99354,-20.72621,55,35,5,-20
-41.99331,-20.72621,54,35,5,-19
-41.99309,-20.72621,53,35,5,-18
-41.99286,-20.72621,60,34,5,-26
-41.99241,-20.72621,63,35,0,-28
-41.99219,-20.72621,66,35,0,-31
-41.99196,-20.72621,64,35,0,-29
-41.99174,-20.72621,63,35,0,-28
-41.99129,-20.72621,63,35,0,-28
-41.99107,-20.72621,63,35,0,-28
-41.99084,-20.72621,63,35,0,-28
-41.99062,-20.72621,63,35,0,-28
-41.99017,-20.72621,63,35,0,-28
-41.98994,-20.72621,64,35,0,-29
-41.98972,-20.72621,64,36,0,-28
-41.98949,-20.72621,64,36,0,-28
-41.98927,-20.72621,64,36,0,-28
-41.98882,-20.72621,64,38,0,-26
-41.98859,-20.72621,64,38,0,-26
-41.98837,-20.72621,66,38,0,-28
-41.98814,-20.72621,67,35,0,-32
-41.98769,-20.72621,68,35,0,-33
-41.98747,-20.72621,68,37,0,-31
-41.98725,-20.72621,69,37,0,-32
-41.98702,-20.72621,69,38,0,-31
-41.98657,-20.72621,68,39,0,-29
-41.98635,-20.72621,66,40,0,-26
-41.98612,-20.72621,65,41,0,-24
-41.9859,-20.72621,65,41,0,-24
-41.98545,-20.72621,64,42,5,-22
-41.98522,-20.72621,63,42,5,-21
-41.985,-20.72621,63,36,5,-27
-41.98477,-20.72621,62,32,5,-30
-41.98455,-20.72621,61,32,5,-29
-41.9841,-20.72621,60,31,5,-29
-41.98387,-20.72621,60,30,5,-30
-41.98365,-20.72621,59,34,5,-25
-41.98343,-20.72621,59,35,0,-24
-41.98298,-20.72621,59,38,0,-21
-41.98275,-20.72621,58,40,0,-18
-41.98253,-20.72621,58,41,0,-17
-41.9823,-20.72621,58,43,0,-15
-41.98185,-20.72621,57,43,0,-14
-41.98163,-20.72621,57,43,0,-14
-41.9814,-20.72621,57,43,0,-14
-41.98118,-20.72621,57,43,0,-14
-41.98073,-20.72621,57,34,0,-23
-41.9805,-20.72621,61,34,0,-27
-41.98028,-20.72621,65,33,0,-32
-41.98005,-20.72621,63,33,0,-30
-41.97983,-20.72621,62,33,5,-29
-41.97938,-20.72621,61,30,5,-31
-41.97916,-20.72621,59,30,5,-29
-41.97893,-20.72621,58,30,5,-28
-41.97871,-20.72621,57,30,5,-27
-41.97826,-20.72621,61,35,5,-26
-41.97803,-20.72621,63,38,0,-25
-41.97781,-20.72621,67,42,0,-25
-41.97758,-20.72621,67,42,0,-25
-41.97713,-20.72621,63,40,5,-23
-41.97691,-20.72621,60,43,5,-17
-41.97668,-20.72621,58,43,5,-15
-41.97646,-20.72621,57,43,5,-14
-41.97601,-20.72621,57,43,0,-14
-41.97578,-20.72621,56,44,0,-12
-41.97556,-20.72621,56,44,0,-12
-41.97534,-20.72621,56,44,0,-12
-41.97511,-20.72621,56,44,0,-12
-41.97466,-20.72621,56,44,0,-12
-41.97444,-20.72621,56,44,0,-12
-41.97421,-20.72621,56,45,0,-11
-41.97399,-20.72621,56,45,11,-11
-41.97354,-20.72621,56,45,0,-11
-41.97331,-20.72621,55,45,0,-10
-41.97309,-20.72621,55,45,0,-10
-41.97286,-20.72621,55,45,0,-10
-41.97241,-20.72621,54,46,0,-8
-41.97219,-20.72621,53,46,0,-7
-41.97196,-20.72621,53,46,0,-7
-41.97174,-20.72621,52,46,0,-6
-41.97129,-20.72621,51,46,0,-5
-41.97107,-20.72621,51,47,0,-4
-41.97084,-20.72621,51,47,0,-4
-41.97062,-20.72621,51,47,0,-4
-41.97017,-20.72621,51,47,0,-4
-41.96994,-20.72621,51,47,0,-4
-41.96972,-20.72621,55,47,5,-8
-41.96949,-20.72621,51,47,5,-4
-41.96927,-20.72621,51,47,5,-4
-42.1005,-20.72578,62,36,0,-26
-42.0978,-20.72578,61,34,0,-27
-42.09511,-20.72578,67,26,5,-41
-42.09219,-20.72578,61,27,5,-34
-42.08949,-20.72578,66,28,5,-38
-42.08657,-20.72578,60,36,0,-24
-42.08387,-20.72578,61,34,5,-27
-42.08118,-20.72578,65,32,5,-33
-42.07825,-20.72578,55,41,0,-14
-42.07556,-20.72578,56,40,0,-16
-42.07286,-20.72578,57,38,0,-19
-42.06994,-20.72578,57,36,5,-21
-42.06724,-20.72578,44,39,5,-5
-42.06455,-20.72578,39,40,5,1
-42.06163,-20.72578,43,45,0,2
-42.05893,-20.72578,43,43,5,0
-42.05601,-20.72578,44,44,5,0
-42.05331,-20.72578,44,45,5,1
-42.05061,-20.72578,22,49,5,27
-42.04769,-20.72578,14,63,0,49
-42.045,-20.72578,34,49,0,15
-42.0423,-20.72578,15,71,0,56
-42.03938,-20.72578,25,63,2,38
-42.03106,-20.72578,15,65,5,50
-42.02837,-20.72578,1,60,5,59
-42.02545,-20.72578,40,50,5,10
-42.02275,-20.72578,46,46,0,0
-42.02005,-20.72578,46,48,11,2
-42.01713,-20.72578,42,48,5,6
-42.01444,-20.72578,45,45,5,0
-42.01174,-20.72578,42,42,5,0
-42.00882,-20.72578,47,43,5,-4
-42.00612,-20.72578,46,43,5,-3
-42.00342,-20.72578,45,41,5,-4
-42.0005,-20.72578,78,18,0,-60
-41.99781,-20.72578,75,21,5,-54
-41.99511,-20.72578,64,39,5,-25
-41.99219,-20.72578,67,35,0,-32
-41.98949,-20.72578,64,36,0,-28
-41.98657,-20.72578,69,35,0,-34
-41.98387,-20.72578,59,31,5,-28
-41.98118,-20.72578,57,36,0,-21
-41.97826,-20.72578,58,32,5,-26
-41.97556,-20.72578,56,43,5,-13
-41.97286,-20.72578,54,45,0,-9
-41.96994,-20.72578,51,47,0,-4
-42.1005,-20.72557,61,36,0,-25
-42.0978,-20.72557,61,34,0,-27
-42.09511,-20.72557,64,26,5,-38
-42.09219,-20.72557,62,27,5,-35
-42.08949,-20.72557,68,28,5,-40
-42.08657,-20.72557,60,36,0,-24
-42.08387,-20.72557,61,34,5,-27
-42.08118,-20.72557,64,32,5,-32
-42.07825,-20.72557,55,40,0,-15
-42.07556,-20.72557,56,40,0,-16
-42.07286,-20.72557,57,39,0,-18
-42.06994,-20.72557,56,37,5,-19
-42.06724,-20.72557,45,40,5,-5
-42.06455,-20.72557,39,41,5,2
-42.06163,-20.72557,43,42,0,-1
-42.05893,-20.72557,42,42,5,0
-42.05601,-20.72557,43,44,5,1
-42.05331,-20.72557,43,45,5,2
-42.05061,-20.72557,22,49,5,27
-42.04769,-20.72557,16,64,0,48
-42.045,-20.72557,37,50,0,13
-42.0423,-20.72557,12,73,0,61
-42.03938,-20.72557,25,62,2,37
-42.03106,-20.72557,13,63,5,50
-42.02837,-20.72557,1,62,5,61
-42.02545,-20.72557,40,52,5,12
-42.02275,-20.72557,46,46,5,0
-42.02005,-20.72557,46,49,11,3
-42.01713,-20.72557,43,47,5,4
-42.01444,-20.72557,43,45,5,2
-42.01174,-20.72557,42,42,5,0
-42.00882,-20.72557,49,42,5,-7
-42.00612,-20.72557,49,42,5,-7
-42.00342,-20.72557,47,40,5,-7
-42.0005,-20.72557,79,20,0,-59
-41.99781,-20.72557,76,22,5,-54
-41.99511,-20.72557,65,39,5,-26
-41.99219,-20.72557,66,35,0,-31
-41.98949,-20.72557,65,36,0,-29
-41.98657,-20.72557,69,33,0,-36
-41.98387,-20.72557,57,31,5,-26
-41.98118,-20.72557,57,35,0,-22
-41.97826,-20.72557,58,39,5,-19
-41.97556,-20.72557,56,32,5,-24
-41.97286,-20.72557,54,46,0,-8
-41.96994,-20.72557,51,47,0,-4
-42.1005,-20.72536,62,36,0,-26
-42.0978,-20.72536,62,34,0,-28
-42.09511,-20.72536,64,28,5,-36
-42.09219,-20.72536,67,27,5,-40
-42.08949,-20.72536,68,28,5,-40
-42.08657,-20.72536,60,36,0,-24
-42.08387,-20.72536,61,34,5,-27
-42.08118,-20.72536,64,32,5,-32
-42.07825,-20.72536,54,40,0,-14
-42.07556,-20.72536,56,40,0,-16
-42.07286,-20.72536,56,38,0,-18
-42.06994,-20.72536,54,36,5,-18
-42.06724,-20.72536,46,40,5,-6
-42.06455,-20.72536,38,41,5,3
-42.06163,-20.72536,42,42,5,0
-42.05893,-20.72536,42,42,5,0
-42.05601,-20.72536,42,44,5,2
-42.05331,-20.72536,42,45,5,3
-42.05061,-20.72536,22,48,5,26
-42.04769,-20.72536,20,66,0,46
-42.045,-20.72536,43,51,0,8
-42.0423,-20.72536,13,67,0,54
-42.03938,-20.72536,23,61,2,38
-42.03106,-20.72536,5,59,5,54
-42.02837,-20.72536,1,61,5,60
-42.02545,-20.72536,37,53,5,16
-42.02275,-20.72536,48,49,5,1
-42.02005,-20.72536,53,53,5,0
-42.01713,-20.72536,42,48,5,6
-42.01444,-20.72536,41,45,5,4
-42.01174,-20.72536,41,42,5,1
-42.00882,-20.72536,50,42,5,-8
-42.00612,-20.72536,50,41,5,-9
-42.00342,-20.72536,48,40,5,-8
-42.0005,-20.72536,83,22,0,-61
-41.99781,-20.72536,78,23,5,-55
-41.99511,-20.72536,60,38,5,-22
-41.99219,-20.72536,66,36,0,-30
-41.98949,-20.72536,64,36,0,-28
-41.98657,-20.72536,67,34,0,-33
-41.98387,-20.72536,56,31,5,-25
-41.98118,-20.72536,56,36,0,-20
-41.97826,-20.72536,59,41,0,-18
-41.97556,-20.72536,55,30,5,-25
-41.97286,-20.72536,53,46,0,-7
-41.96994,-20.72536,50,47,0,-3
-42.1005,-20.72494,66,36,0,-30
-42.0978,-20.72494,62,35,0,-27
-42.09511,-20.72494,65,30,0,-35
-42.09219,-20.72494,65,28,5,-37
-42.08949,-20.72494,67,32,5,-35
-42.08657,-20.72494,59,36,0,-23
-42.08387,-20.72494,61,35,0,-26
-42.08118,-20.72494,64,32,5,-32
-42.07825,-20.72494,54,40,0,-14
-42.07556,-20.72494,55,39,0,-16
-42.07286,-20.72494,56,38,0,-18
-42.06994,-20.72494,53,36,5,-17
-42.06724,-20.72494,44,40,5,-4
-42.06455,-20.72494,36,41,5,5
-42.06163,-20.72494,43,42,5,-1
-42.05893,-20.72494,44,43,5,-1
-42.05601,-20.72494,42,43,5,1
-42.05331,-20.72494,42,45,5,3
-42.05061,-20.72494,22,48,5,26
-42.04769,-20.72494,20,69,0,49
-42.045,-20.72494,42,53,0,11
-42.0423,-20.72494,12,61,0,49
-42.03938,-20.72494,14,59,2,45
-42.02837,-20.72494,11,61,5,50
-42.02545,-20.72494,34,52,5,18
-42.02275,-20.72494,51,50,5,-1
-42.02005,-20.72494,54,50,5,-4
-42.01713,-20.72494,43,46,5,3
-42.01444,-20.72494,42,45,5,3
-42.01174,-20.72494,46,44,5,-2
-42.00882,-20.72494,51,44,5,-7
-42.00612,-20.72494,51,41,5,-10
-42.00342,-20.72494,50,39,5,-11
-42.0005,-20.72494,68,25,0,-43
-41.99781,-20.72494,78,24,5,-54
-41.99511,-20.72494,58,37,5,-21
-41.99219,-20.72494,65,37,0,-28
-41.98949,-20.72494,65,36,0,-29
-41.98657,-20.72494,67,35,0,-32
-41.98387,-20.72494,63,39,5,-24
-41.98118,-20.72494,56,42,0,-14
-41.97826,-20.72494,61,39,0,-22
-41.97556,-20.72494,55,33,5,-22
-41.97286,-20.72494,53,46,0,-7
-41.96994,-20.72494,50,46,0,-4
-42.1005,-20.72473,66,36,0,-30
-42.0978,-20.72473,63,35,0,-28
-42.09511,-20.72473,68,30,0,-38
-42.09219,-20.72473,65,28,5,-37
-42.08949,-20.72473,68,32,5,-36
-42.08657,-20.72473,60,36,0,-24
-42.08387,-20.72473,62,35,0,-27
-42.08118,-20.72473,64,30,5,-34
-42.07825,-20.72473,53,40,0,-13
-42.07556,-20.72473,55,39,0,-16
-42.07286,-20.72473,55,38,0,-17
-42.06994,-20.72473,53,36,5,-17
-42.06724,-20.72473,46,40,5,-6
-42.06455,-20.72473,34,41,5,7
-42.06163,-20.72473,42,42,5,0
-42.05893,-20.72473,43,43,5,0
-42.05601,-20.72473,42,44,5,2
-42.05331,-20.72473,41,45,5,4
-42.05061,-20.72473,25,50,5,25
-42.04769,-20.72473,17,70,0,53
-42.045,-20.72473,36,54,0,18
-42.0423,-20.72473,18,62,0,44
-42.03938,-20.72473,4,60,2,56
-42.02837,-20.72473,16,61,5,45
-42.02545,-20.72473,35,53,0,18
-42.02275,-20.72473,50,50,5,0
-42.02005,-20.72473,55,50,5,-5
-42.01713,-20.72473,44,46,5,2
-42.01444,-20.72473,44,46,5,2
-42.01174,-20.72473,49,44,5,-5
-42.00882,-20.72473,51,42,5,-9
-42.00612,-20.72473,52,41,5,-11
-42.00342,-20.72473,50,39,5,-11
-42.0005,-20.72473,66,26,0,-40
-41.99781,-20.72473,69,24,5,-45
-41.99511,-20.72473,55,37,5,-18
-41.99219,-20.72473,65,37,0,-28
-41.98949,-20.72473,64,36,0,-28
-41.98657,-20.72473,61,35,0,-26
-41.98387,-20.72473,64,40,0,-24
-41.98118,-20.72473,56,42,0,-14
-41.97826,-20.72473,59,34,0,-25
-41.97556,-20.72473,55,29,5,-26
-41.97286,-20.72473,52,45,0,-7
-41.96994,-20.72473,50,46,0,-4
-42.1005,-20.72452,61,36,0,-25
-42.0978,-20.72452,63,35,0,-28
-42.09511,-20.72452,67,32,0,-35
-42.09219,-20.72452,64,28,5,-36
-42.08949,-20.72452,69,32,5,-37
-42.08657,-20.72452,60,36,0,-24
-42.08387,-20.72452,62,36,0,-26
-42.08118,-20.72452,63,30,5,-33
-42.07825,-20.72452,52,40,0,-12
-42.07556,-20.72452,54,39,0,-15
-42.07286,-20.72452,54,38,0,-16
-42.06994,-20.72452,53,37,5,-16
-42.06724,-20.72452,47,39,5,-8
-42.06455,-20.72452,33,41,5,8
-42.06163,-20.72452,42,42,5,0
-42.05893,-20.72452,42,42,5,0
-42.05601,-20.72452,42,45,5,3
-42.05331,-20.72452,41,46,5,5
-42.05061,-20.72452,29,50,5,21
-42.04769,-20.72452,22,70,0,48
-42.045,-20.72452,33,55,0,22
-42.0423,-20.72452,27,61,0,34
-42.03938,-20.72452,5,59,2,54
-42.03399,-20.72452,9,75,5,66
-42.02837,-20.72452,20,61,5,41
-42.02545,-20.72452,33,52,5,19
-42.02275,-20.72452,46,49,5,3
-42.02005,-20.72452,54,51,5,-3
-42.01713,-20.72452,44,47,5,3
-42.01444,-20.72452,47,47,5,0
-42.01174,-20.72452,42,43,5,1
-42.00882,-20.72452,51,42,5,-9
-42.00612,-20.72452,53,40,5,-13
-42.00342,-20.72452,51,39,5,-12
-42.0005,-20.72452,66,28,0,-38
-41.99781,-20.72452,66,25,5,-41
-41.99511,-20.72452,55,36,5,-19
-41.99219,-20.72452,66,38,0,-28
-41.98949,-20.72452,64,36,0,-28
-41.98657,-20.72452,60,36,0,-24
-41.98387,-20.72452,67,41,0,-26
-41.98118,-20.72452,56,43,0,-13
-41.97826,-20.72452,57,39,0,-18
-41.97556,-20.72452,55,29,5,-26
-41.97286,-20.72452,53,45,0,-8
-41.96994,-20.72452,51,46,0,-5
-42.1005,-20.72409,61,36,0,-25
-42.0978,-20.72409,63,36,0,-27
-42.09511,-20.72409,68,31,0,-37
-42.09219,-20.72409,65,28,5,-37
-42.08949,-20.72409,69,32,5,-37
-42.08657,-20.72409,60,36,0,-24
-42.08387,-20.72409,61,36,0,-25
-42.08118,-20.72409,61,31,5,-30
-42.07825,-20.72409,51,40,0,-11
-42.07556,-20.72409,53,39,0,-14
-42.07286,-20.72409,54,38,0,-16
-42.06994,-20.72409,54,35,5,-19
-42.06724,-20.72409,48,39,5,-9
-42.06455,-20.72409,33,41,5,8
-42.06163,-20.72409,41,41,5,0
-42.05893,-20.72409,42,42,5,0
-42.05601,-20.72409,41,45,5,4
-42.05331,-20.72409,42,46,5,4
-42.05061,-20.72409,31,50,5,19
-42.04769,-20.72409,23,72,0,49
-42.045,-20.72409,29,59,0,30
-42.0423,-20.72409,27,56,2,29
-42.03938,-20.72409,8,62,11,54
-42.03399,-20.72409,12,75,11,63
-42.02837,-20.72409,21,60,5,39
-42.02545,-20.72409,19,52,5,33
-42.02275,-20.72409,45,49,5,4
-42.02005,-20.72409,54,50,5,-4
-42.01713,-20.72409,45,47,5,2
-42.01444,-20.72409,50,50,5,0
-42.01174,-20.72409,42,45,5,3
-42.00882,-20.72409,51,44,5,-7
-42.00612,-20.72409,52,42,5,-10
-42.00342,-20.72409,51,39,5,-12
-42.0005,-20.72409,66,29,5,-37
-41.99781,-20.72409,63,32,5,-31
-41.99511,-20.72409,55,40,5,-15
-41.99219,-20.72409,63,37,0,-26
-41.98949,-20.72409,64,40,0,-24
-41.98657,-20.72409,60,38,0,-22
-41.98387,-20.72409,68,40,11,-28
-41.98118,-20.72409,58,42,0,-16
-41.97826,-20.72409,57,42,0,-15
-41.97556,-20.72409,55,42,0,-13
-41.97286,-20.72409,53,44,0,-9
-41.96994,-20.72409,50,45,0,-5
-42.1005,-20.72388,61,36,0,-25
-42.0978,-20.72388,63,36,0,-27
-42.09511,-20.72388,70,31,0,-39
-42.09219,-20.72388,65,28,5,-37
-42.08949,-20.72388,69,33,5,-36
-42.08657,-20.72388,60,37,0,-23
-42.08387,-20.72388,62,36,0,-26
-42.08118,-20.72388,62,30,5,-32
-42.07825,-20.72388,50,40,0,-10
-42.07556,-20.72388,53,39,0,-14
-42.07286,-20.72388,53,38,0,-15
-42.06994,-20.72388,54,36,5,-18
-42.06724,-20.72388,50,39,5,-11
-42.06455,-20.72388,32,42,5,10
-42.06163,-20.72388,41,41,5,0
-42.05893,-20.72388,41,44,5,3
-42.05601,-20.72388,41,45,5,4
-42.05331,-20.72388,40,46,5,6
-42.05061,-20.72388,34,51,5,17
-42.04769,-20.72388,23,73,0,50
-42.045,-20.72388,23,60,0,37
-42.0423,-20.72388,29,56,2,27
-42.03938,-20.72388,2,64,2,62
-42.03668,-20.72388,2,67,5,65
-42.03399,-20.72388,19,75,5,56
-42.02837,-20.72388,32,64,5,32
-42.02545,-20.72388,19,52,5,33
-42.02275,-20.72388,45,49,5,4
-42.02005,-20.72388,54,49,5,-5
-42.01713,-20.72388,45,47,5,2
-42.01444,-20.72388,51,52,11,1
-42.01174,-20.72388,44,45,5,1
-42.00882,-20.72388,53,45,5,-8
-42.00612,-20.72388,52,41,5,-11
-42.00342,-20.72388,51,39,5,-12
-42.0005,-20.72388,65,36,5,-29
-41.99781,-20.72388,64,35,5,-29
-41.99511,-20.72388,54,42,5,-12
-41.99219,-20.72388,57,37,0,-20
-41.98949,-20.72388,64,40,0,-24
-41.98657,-20.72388,59,39,0,-20
-41.98387,-20.72388,68,40,0,-28
-41.98118,-20.72388,58,42,0,-16
-41.97826,-20.72388,57,42,0,-15
-41.97556,-20.72388,55,42,0,-13
-41.97286,-20.72388,53,44,0,-9
-41.96994,-20.72388,50,45,0,-5
-42.1005,-20.72367,61,36,0,-25
-42.0978,-20.72367,64,36,0,-28
-42.09511,-20.72367,71,32,0,-39
-42.09219,-20.72367,66,28,5,-38
-42.08949,-20.72367,68,33,5,-35
-42.08657,-20.72367,60,37,0,-23
-42.08387,-20.72367,62,36,0,-26
-42.08118,-20.72367,61,30,5,-31
-42.07825,-20.72367,50,40,0,-10
-42.07556,-20.72367,52,39,0,-13
-42.07286,-20.72367,53,38,0,-15
-42.06994,-20.72367,54,36,5,-18
-42.06724,-20.72367,51,39,5,-12
-42.06455,-20.72367,31,41,5,10
-42.06163,-20.72367,40,41,5,1
-42.05893,-20.72367,41,44,5,3
-42.05601,-20.72367,41,45,5,4
-42.05331,-20.72367,39,46,5,7
-42.05061,-20.72367,35,51,5,16
-42.04769,-20.72367,16,73,0,57
-42.045,-20.72367,21,60,0,39
-42.0423,-20.72367,29,55,2,26
-42.03938,-20.72367,2,62,11,60
-42.03668,-20.72367,4,65,5,61
-42.03399,-20.72367,20,70,5,50
-42.02837,-20.72367,30,68,5,38
-42.02545,-20.72367,19,52,5,33
-42.02275,-20.72367,46,49,5,3
-42.02005,-20.72367,54,50,5,-4
-42.01713,-20.72367,45,48,5,3
-42.01444,-20.72367,53,52,5,-1
-42.01174,-20.72367,44,45,5,1
-42.00882,-20.72367,53,45,5,-8
-42.00612,-20.72367,53,41,5,-12
-42.00342,-20.72367,52,38,5,-14
-42.0005,-20.72367,65,37,5,-28
-41.99781,-20.72367,66,36,5,-30
-41.99511,-20.72367,54,40,5,-14
-41.99219,-20.72367,57,38,0,-19
-41.98949,-20.72367,64,40,0,-24
-41.98657,-20.72367,59,40,0,-19
-41.98387,-20.72367,68,40,0,-28
-41.98118,-20.72367,57,42,0,-15
-41.97826,-20.72367,57,42,0,-15
-41.97556,-20.72367,55,42,0,-13
-41.97286,-20.72367,53,44,0,-9
-41.96994,-20.72367,50,45,0,-5
-42.10297,-20.72325,61,36,0,-25
-42.10275,-20.72325,61,36,0,-25
-42.10252,-20.72325,61,36,0,-25
-42.1023,-20.72325,61,36,0,-25
-42.10185,-20.72325,61,36,0,-25
-42.10163,-20.72325,61,36,0,-25
-42.1014,-20.72325,61,36,0,-25
-42.10118,-20.72325,61,36,0,-25
-42.10073,-20.72325,61,36,0,-25
-42.1005,-20.72325,61,36,0,-25
-42.10028,-20.72325,61,35,0,-26
-42.10005,-20.72325,61,36,0,-25
-42.09983,-20.72325,61,35,0,-26
-42.09938,-20.72325,61,35,0,-26
-42.09915,-20.72325,62,36,0,-26
-42.09893,-20.72325,62,36,0,-26
-42.0987,-20.72325,62,35,0,-27
-42.09825,-20.72325,63,35,0,-28
-42.09803,-20.72325,63,36,0,-27
-42.0978,-20.72325,64,36,0,-28
-42.09758,-20.72325,65,35,0,-30
-42.09713,-20.72325,65,35,0,-30
-42.09691,-20.72325,65,35,0,-30
-42.09668,-20.72325,65,35,0,-30
-42.09646,-20.72325,66,35,0,-31
-42.09601,-20.72325,67,34,0,-33
-42.09578,-20.72325,67,34,0,-33
-42.09556,-20.72325,70,34,0,-36
-42.09533,-20.72325,73,34,0,-39
-42.09511,-20.72325,72,34,0,-38
-42.09466,-20.72325,71,33,0,-38
-42.09443,-20.72325,70,32,0,-38
-42.09421,-20.72325,68,30,5,-38
-42.09398,-20.72325,68,27,5,-41
-42.09354,-20.72325,68,27,5,-41
-42.09331,-20.72325,67,27,5,-40
-42.09309,-20.72325,66,28,5,-38
-42.09286,-20.72325,65,28,5,-37
-42.09241,-20.72325,66,28,5,-38
-42.09219,-20.72325,66,32,5,-34
-42.09196,-20.72325,66,32,5,-34
-42.09174,-20.72325,67,32,5,-35
-42.09129,-20.72325,67,31,5,-36
-42.09106,-20.72325,67,30,5,-37
-42.09084,-20.72325,69,28,5,-41
-42.09061,-20.72325,69,28,5,-41
-42.09039,-20.72325,70,28,5,-42
-42.08994,-20.72325,71,28,5,-43
-42.08972,-20.72325,67,28,5,-39
-42.08949,-20.72325,67,30,5,-37
-42.08927,-20.72325,66,30,5,-36
-42.08882,-20.72325,66,28,5,-38
-42.08859,-20.72325,66,28,5,-38
-42.08837,-20.72325,66,28,5,-38
-42.08814,-20.72325,61,28,5,-33
-42.08769,-20.72325,59,28,5,-31
-42.08747,-20.72325,59,31,5,-28
-42.08724,-20.72325,59,36,5,-23
-42.08702,-20.72325,60,37,0,-23
-42.08657,-20.72325,60,37,0,-23
-42.08634,-20.72325,60,37,0,-23
-42.08612,-20.72325,60,37,0,-23
-42.08589,-20.72325,60,37,0,-23
-42.08545,-20.72325,60,37,0,-23
-42.08522,-20.72325,60,37,0,-23
-42.085,-20.72325,60,37,0,-23
-42.08477,-20.72325,61,37,0,-24
-42.08455,-20.72325,61,36,0,-25
-42.0841,-20.72325,61,36,0,-25
-42.08387,-20.72325,62,36,0,-26
-42.08365,-20.72325,62,36,0,-26
-42.08342,-20.72325,63,35,0,-28
-42.08297,-20.72325,63,36,0,-27
-42.08275,-20.72325,63,36,0,-27
-42.08252,-20.72325,63,35,0,-28
-42.0823,-20.72325,63,33,0,-30
-42.08185,-20.72325,64,31,5,-33
-42.08163,-20.72325,67,29,5,-38
-42.0814,-20.72325,62,30,5,-32
-42.08118,-20.72325,62,30,5,-32
-42.08073,-20.72325,64,30,5,-34
-42.0805,-20.72325,60,30,5,-30
-42.08028,-20.72325,61,31,5,-30
-42.08005,-20.72325,60,31,5,-29
-42.07983,-20.72325,56,34,5,-22
-42.07938,-20.72325,53,40,5,-13
-42.07915,-20.72325,49,40,5,-9
-42.07893,-20.72325,49,40,0,-9
-42.0787,-20.72325,49,40,0,-9
-42.07825,-20.72325,50,40,0,-10
-42.07803,-20.72325,50,40,0,-10
-42.07781,-20.72325,51,40,0,-11
-42.07758,-20.72325,51,40,0,-11
-42.07713,-20.72325,51,39,0,-12
-42.07691,-20.72325,52,39,0,-13
-42.07668,-20.72325,52,39,0,-13
-42.07646,-20.72325,52,39,0,-13
-42.07601,-20.72325,52,39,0,-13
-42.07578,-20.72325,52,39,0,-13
-42.07556,-20.72325,52,39,0,-13
-42.07533,-20.72325,52,39,0,-13
-42.07511,-20.72325,52,38,0,-14
-42.07466,-20.72325,52,38,0,-14
-42.07443,-20.72325,52,38,0,-14
-42.07421,-20.72325,53,38,0,-15
-42.07399,-20.72325,53,37,0,-16
-42.07354,-20.72325,53,36,0,-17
-42.07331,-20.72325,53,36,0,-17
-42.07309,-20.72325,53,36,0,-17
-42.07286,-20.72325,53,36,0,-17
-42.07241,-20.72325,53,35,0,-18
-42.07219,-20.72325,54,35,5,-19
-42.07196,-20.72325,54,33,5,-21
-42.07174,-20.72325,54,33,5,-21
-42.07129,-20.72325,54,33,5,-21
-42.07106,-20.72325,54,32,5,-22
-42.07084,-20.72325,54,32,5,-22
-42.07061,-20.72325,54,32,5,-22
-42.07039,-20.72325,56,32,5,-24
-42.06994,-20.72325,54,35,5,-19
-42.06972,-20.72325,53,35,5,-18
-42.06949,-20.72325,54,36,5,-18
-42.06927,-20.72325,54,36,5,-18
-42.06882,-20.72325,54,38,5,-16
-42.06859,-20.72325,53,38,5,-15
-42.06837,-20.72325,54,39,5,-15
-42.06814,-20.72325,55,39,5,-16
-42.06769,-20.72325,52,39,5,-13
-42.06747,-20.72325,53,39,5,-14
-42.06724,-20.72325,56,39,5,-17
-42.06702,-20.72325,51,39,5,-12
-42.06657,-20.72325,51,39,5,-12
-42.06634,-20.72325,48,39,5,-9
-42.06612,-20.72325,47,40,5,-7
-42.0659,-20.72325,44,39,5,-5
-42.06545,-20.72325,38,39,5,1
-42.06522,-20.72325,38,40,5,2
-42.065,-20.72325,38,41,5,3
-42.06477,-20.72325,36,41,5,5
-42.06455,-20.72325,31,41,0,10
-42.0641,-20.72325,31,42,5,11
-42.06387,-20.72325,37,40,5,3
-42.06365,-20.72325,33,41,5,8
-42.06342,-20.72325,37,41,5,4
-42.06297,-20.72325,37,41,5,4
-42.06275,-20.72325,36,41,5,5
-42.06252,-20.72325,37,41,5,4
-42.0623,-20.72325,38,41,5,3
-42.06185,-20.72325,39,41,5,2
-42.06163,-20.72325,39,41,5,2
-42.0614,-20.72325,40,42,5,2
-42.06118,-20.72325,42,42,5,0
-42.06073,-20.72325,39,42,5,3
-42.0605,-20.72325,39,43,5,4
-42.06028,-20.72325,39,43,5,4
-42.06005,-20.72325,39,43,5,4
-42.05983,-20.72325,39,43,5,4
-42.05938,-20.72325,39,44,0,5
-42.05915,-20.72325,40,45,5,5
-42.05893,-20.72325,40,44,5,4
-42.0587,-20.72325,40,45,5,5
-42.05826,-20.72325,39,47,5,8
-42.05803,-20.72325,40,46,5,6
-42.05781,-20.72325,40,47,5,7
-42.05758,-20.72325,40,46,5,6
-42.05713,-20.72325,40,47,5,7
-42.05691,-20.72325,40,52,5,12
-42.05668,-20.72325,40,50,5,10
-42.05646,-20.72325,40,47,5,7
-42.05601,-20.72325,40,46,5,6
-42.05578,-20.72325,40,47,5,7
-42.05556,-20.72325,40,47,5,7
-42.05533,-20.72325,40,47,5,7
-42.05511,-20.72325,39,46,5,7
-42.05466,-20.72325,39,48,5,9
-42.05443,-20.72325,39,47,5,8
-42.05421,-20.72325,39,46,5,7
-42.05399,-20.72325,39,46,5,7
-42.05354,-20.72325,39,47,5,8
-42.05331,-20.72325,39,47,0,8
-42.05309,-20.72325,39,47,0,8
-42.05286,-20.72325,37,48,0,11
-42.05241,-20.72325,37,48,0,11
-42.05219,-20.72325,37,48,5,11
-42.05196,-20.72325,37,48,11,11
-42.05174,-20.72325,38,48,5,10
-42.05129,-20.72325,38,48,5,10
-42.05106,-20.72325,39,48,5,9
-42.05084,-20.72325,38,50,5,12
-42.05061,-20.72325,37,51,5,14
-42.05039,-20.72325,36,53,5,17
-42.04994,-20.72325,32,73,0,41
-42.04972,-20.72325,25,73,0,48
-42.04949,-20.72325,21,73,0,52
-42.04927,-20.72325,11,73,0,62
-42.04882,-20.72325,20,73,0,53
-42.04859,-20.72325,12,73,0,61
-42.04837,-20.72325,15,73,0,58
-42.04814,-20.72325,19,73,0,54
-42.04769,-20.72325,15,73,0,58
-42.04747,-20.72325,19,73,0,54
-42.04724,-20.72325,19,73,0,54
-42.04702,-20.72325,18,73,0,55
-42.04657,-20.72325,20,71,0,51
-42.04635,-20.72325,18,70,0,52
-42.04612,-20.72325,20,69,0,49
-42.0459,-20.72325,25,69,0,44
-42.04545,-20.72325,22,68,0,46
-42.04522,-20.72325,23,67,0,44
-42.045,-20.72325,25,66,0,41
-42.04477,-20.72325,24,65,0,41
-42.04455,-20.72325,29,66,0,37
-42.0441,-20.72325,32,67,11,35
-42.04387,-20.72325,31,57,0,26
-42.04365,-20.72325,31,56,5,25
-42.04342,-20.72325,32,56,5,24
-42.04297,-20.72325,34,58,5,24
-42.04275,-20.72325,32,59,5,27
-42.04253,-20.72325,32,59,5,27
-42.0423,-20.72325,30,60,5,30
-42.04185,-20.72325,27,61,5,34
-42.04163,-20.72325,24,61,5,37
-42.0414,-20.72325,23,61,5,38
-42.04118,-20.72325,15,58,11,43
-42.04073,-20.72325,12,59,11,47
-42.0405,-20.72325,13,59,5,46
-42.04028,-20.72325,7,59,2,52
-42.04005,-20.72325,12,59,2,47
-42.03983,-20.72325,12,59,2,47
-42.03915,-20.72325,10,61,2,51
-42.03826,-20.72325,3,61,2,58
-42.03758,-20.72325,3,61,2,58
-42.03713,-20.72325,5,62,2,57
-42.03691,-20.72325,6,63,5,57
-42.03668,-20.72325,8,63,5,55
-42.03646,-20.72325,3,64,6,61
-42.03578,-20.72325,1,66,5,65
-42.03556,-20.72325,2,67,11,65
-42.03533,-20.72325,2,69,11,67
-42.03511,-20.72325,4,69,5,65
-42.03466,-20.72325,16,69,5,53
-42.03444,-20.72325,22,70,5,48
-42.03421,-20.72325,23,70,5,47
-42.03399,-20.72325,17,72,5,55
-42.03354,-20.72325,14,75,5,61
-42.03331,-20.72325,13,78,5,65
-42.03309,-20.72325,12,76,5,64
-42.03286,-20.72325,6,69,5,63
-42.03241,-20.72325,5,69,5,64
-42.03219,-20.72325,4,70,5,66
-42.03174,-20.72325,5,66,5,61
-42.03084,-20.72325,7,62,5,55
-42.03062,-20.72325,8,59,5,51
-42.03017,-20.72325,8,59,5,51
-42.02994,-20.72325,10,59,5,49
-42.02972,-20.72325,6,59,5,53
-42.02949,-20.72325,12,60,5,48
-42.02927,-20.72325,13,61,5,48
-42.02882,-20.72325,22,63,5,41
-42.02859,-20.72325,22,65,5,43
-42.02837,-20.72325,27,66,5,39
-42.02814,-20.72325,28,66,5,38
-42.02769,-20.72325,29,65,5,36
-42.02747,-20.72325,29,62,5,33
-42.02724,-20.72325,28,61,5,33
-42.02702,-20.72325,26,59,5,33
-42.02657,-20.72325,24,59,5,35
-42.02635,-20.72325,22,58,5,36
-42.02612,-20.72325,9,57,5,48
-42.0259,-20.72325,4,54,5,50
-42.02545,-20.72325,18,54,5,36
-42.02522,-20.72325,31,50,5,19
-42.025,-20.72325,32,50,5,18
-42.02477,-20.72325,37,50,5,13
-42.02455,-20.72325,44,50,5,6
-42.0241,-20.72325,44,50,5,6
-42.02387,-20.72325,45,50,5,5
-42.02365,-20.72325,45,50,5,5
-42.02342,-20.72325,45,48,5,3
-42.02297,-20.72325,47,48,5,1
-42.02275,-20.72325,47,50,5,3
-42.02253,-20.72325,47,49,5,2
-42.0223,-20.72325,47,48,5,1
-42.02185,-20.72325,47,48,5,1
-42.02163,-20.72325,47,49,5,2
-42.0214,-20.72325,47,49,5,2
-42.02118,-20.72325,48,49,5,1
-42.02073,-20.72325,50,50,5,0
-42.0205,-20.72325,50,50,5,0
-42.02028,-20.72325,54,51,5,-3
-42.02005,-20.72325,54,49,5,-5
-42.01983,-20.72325,54,48,5,-6
-42.01938,-20.72325,49,48,5,-1
-42.01915,-20.72325,48,46,5,-2
-42.01893,-20.72325,48,46,5,-2
-42.01871,-20.72325,47,46,5,-1
-42.01826,-20.72325,47,47,5,0
-42.01803,-20.72325,47,47,5,0
-42.01781,-20.72325,46,46,5,0
-42.01758,-20.72325,46,46,5,0
-42.01713,-20.72325,45,46,5,1
-42.01691,-20.72325,46,46,5,0
-42.01668,-20.72325,45,47,11,2
-42.01646,-20.72325,45,46,11,1
-42.01601,-20.72325,45,46,5,1
-42.01578,-20.72325,45,46,5,1
-42.01556,-20.72325,51,48,5,-3
-42.01533,-20.72325,50,48,5,-2
-42.01511,-20.72325,49,46,5,-3
-42.01466,-20.72325,53,46,5,-7
-42.01444,-20.72325,53,45,5,-8
-42.01421,-20.72325,52,46,5,-6
-42.01399,-20.72325,50,45,5,-5
-42.01354,-20.72325,50,50,11,0
-42.01331,-20.72325,49,49,5,0
-42.01309,-20.72325,48,49,5,1
-42.01286,-20.72325,46,45,5,-1
-42.01241,-20.72325,46,45,5,-1
-42.01219,-20.72325,46,45,5,-1
-42.01196,-20.72325,45,45,5,0
-42.01174,-20.72325,45,46,5,1
-42.01129,-20.72325,45,45,5,0
-42.01106,-20.72325,51,48,5,-3
-42.01084,-20.72325,56,45,5,-11
-42.01062,-20.72325,55,45,5,-10
-42.01017,-20.72325,58,46,5,-12
-42.00994,-20.72325,57,46,5,-11
-42.00972,-20.72325,56,46,5,-10
-42.00949,-20.72325,55,46,5,-9
-42.00927,-20.72325,55,46,5,-9
-42.00882,-20.72325,54,48,5,-6
-42.00859,-20.72325,54,48,5,-6
-42.00837,-20.72325,54,48,5,-6
-42.00814,-20.72325,54,48,5,-6
-42.00769,-20.72325,54,48,5,-6
-42.00747,-20.72325,54,43,5,-11
-42.00724,-20.72325,54,43,5,-11
-42.00702,-20.72325,53,42,5,-11
-42.00657,-20.72325,53,44,5,-9
-42.00635,-20.72325,53,44,5,-9
-42.00612,-20.72325,53,42,5,-11
-42.0059,-20.72325,53,42,5,-11
-42.00545,-20.72325,54,42,5,-12
-42.00522,-20.72325,53,42,5,-11
-42.005,-20.72325,53,40,5,-13
-42.00477,-20.72325,53,40,5,-13
-42.00455,-20.72325,53,38,5,-15
-42.0041,-20.72325,53,38,5,-15
-42.00387,-20.72325,53,37,5,-16
-42.00365,-20.72325,53,38,5,-15
-42.00342,-20.72325,52,38,5,-14
-42.00298,-20.72325,52,38,5,-14
-42.00275,-20.72325,52,37,5,-15
-42.00253,-20.72325,57,37,5,-20
-42.0023,-20.72325,53,38,5,-15
-42.00185,-20.72325,55,38,5,-17
-42.00163,-20.72325,59,38,5,-21
-42.0014,-20.72325,62,38,5,-24
-42.00118,-20.72325,64,38,5,-26
-42.00073,-20.72325,64,38,5,-26
-42.0005,-20.72325,64,38,5,-26
-42.00028,-20.72325,65,37,5,-28
-42.00005,-20.72325,66,37,5,-29
-41.99983,-20.72325,65,38,5,-27
-41.99938,-20.72325,64,38,5,-26
-41.99916,-20.72325,65,37,5,-28
-41.99893,-20.72325,64,37,5,-27
-41.99871,-20.72325,64,39,5,-25
-41.99826,-20.72325,64,39,5,-25
-41.99803,-20.72325,63,37,5,-26
-41.99781,-20.72325,62,36,5,-26
-41.99758,-20.72325,61,36,5,-25
-41.99713,-20.72325,60,37,5,-23
-41.99691,-20.72325,58,37,5,-21
-41.99668,-20.72325,58,37,5,-21
-41.99646,-20.72325,57,37,5,-20
-41.99601,-20.72325,57,36,5,-21
-41.99578,-20.72325,56,41,5,-15
-41.99556,-20.72325,55,41,5,-14
-41.99533,-20.72325,54,42,5,-12
-41.99511,-20.72325,54,41,5,-13
-41.99466,-20.72325,54,43,5,-11
-41.99444,-20.72325,54,43,5,-11
-41.99421,-20.72325,54,43,5,-11
-41.99399,-20.72325,53,42,5,-11
-41.99354,-20.72325,53,36,0,-17
-41.99331,-20.72325,52,36,0,-16
-41.99309,-20.72325,52,36,0,-16
-41.99286,-20.72325,52,36,0,-16
-41.99241,-20.72325,51,37,0,-14
-41.99219,-20.72325,51,38,0,-13
-41.99196,-20.72325,63,38,0,-25
-41.99174,-20.72325,64,38,0,-26
-41.99129,-20.72325,64,39,0,-25
-41.99107,-20.72325,63,39,0,-24
-41.99084,-20.72325,63,39,0,-24
-41.99062,-20.72325,66,39,0,-27
-41.99017,-20.72325,65,39,0,-26
-41.98994,-20.72325,64,40,0,-24
-41.98972,-20.72325,64,40,0,-24
-41.98949,-20.72325,64,40,0,-24
-41.98927,-20.72325,63,40,0,-23
-41.98882,-20.72325,63,40,0,-23
-41.98859,-20.72325,62,39,0,-23
-41.98837,-20.72325,62,39,0,-23
-41.98814,-20.72325,63,40,0,-23
-41.98769,-20.72325,63,40,0,-23
-41.98747,-20.72325,64,40,0,-24
-41.98725,-20.72325,63,40,0,-23
-41.98702,-20.72325,61,40,0,-21
-41.98657,-20.72325,59,41,0,-18
-41.98635,-20.72325,58,42,0,-16
-41.98612,-20.72325,62,42,0,-20
-41.9859,-20.72325,63,42,0,-21
-41.98545,-20.72325,63,42,0,-21
-41.98522,-20.72325,60,42,0,-18
-41.985,-20.72325,58,42,0,-16
-41.98477,-20.72325,58,41,0,-17
-41.98455,-20.72325,58,39,0,-19
-41.9841,-20.72325,58,39,0,-19
-41.98387,-20.72325,67,40,0,-27
-41.98365,-20.72325,69,40,0,-29
-41.98343,-20.72325,67,41,0,-26
-41.98298,-20.72325,66,41,0,-25
-41.98275,-20.72325,64,41,0,-23
-41.98253,-20.72325,60,41,0,-19
-41.9823,-20.72325,59,41,0,-18
-41.98185,-20.72325,59,42,0,-17
-41.98163,-20.72325,59,42,11,-17
-41.9814,-20.72325,58,42,11,-16
-41.98118,-20.72325,58,42,11,-16
-41.98073,-20.72325,57,42,11,-15
-41.9805,-20.72325,57,42,11,-15
-41.98028,-20.72325,57,42,0,-15
-41.98005,-20.72325,57,42,0,-15
-41.97983,-20.72325,57,42,0,-15
-41.97938,-20.72325,62,42,0,-20
-41.97916,-20.72325,65,42,0,-23
-41.97893,-20.72325,60,42,0,-18
-41.97871,-20.72325,57,42,0,-15
-41.97826,-20.72325,57,42,0,-15
-41.97803,-20.72325,57,42,0,-15
-41.97781,-20.72325,57,42,0,-15
-41.97758,-20.72325,56,42,0,-14
-41.97713,-20.72325,56,42,0,-14
-41.97691,-20.72325,56,42,0,-14
-41.97668,-20.72325,56,42,0,-14
-41.97646,-20.72325,55,42,0,-13
-41.97601,-20.72325,55,42,0,-13
-41.97578,-20.72325,55,42,0,-13
-41.97556,-20.72325,55,42,0,-13
-41.97534,-20.72325,54,42,0,-12
-41.97511,-20.72325,54,42,0,-12
-41.97466,-20.72325,54,43,0,-11
-41.97444,-20.72325,54,43,0,-11
-41.97421,-20.72325,54,43,11,-11
-41.97399,-20.72325,54,43,0,-11
-41.97354,-20.72325,54,43,0,-11
-41.97331,-20.72325,53,43,0,-10
-41.97309,-20.72325,53,44,0,-9
-41.97286,-20.72325,53,44,11,-9
-41.97241,-20.72325,52,44,11,-8
-41.97219,-20.72325,52,44,0,-8
-41.97196,-20.72325,52,44,0,-8
-41.97174,-20.72325,52,44,0,-8
-41.97129,-20.72325,52,44,0,-8
-41.97107,-20.72325,51,44,0,-7
-41.97084,-20.72325,51,44,0,-7
-41.97062,-20.72325,50,45,0,-5
-41.97017,-20.72325,50,45,0,-5
-41.96994,-20.72325,50,45,0,-5
-41.96972,-20.72325,50,45,0,-5
-41.96949,-20.72325,50,46,0,-4
-41.96927,-20.72325,49,46,0,-3
-42.1005,-20.72304,61,36,0,-25
-42.0978,-20.72304,64,36,0,-28
-42.09511,-20.72304,74,34,0,-40
-42.09219,-20.72304,66,31,5,-35
-42.08949,-20.72304,67,28,5,-39
-42.08657,-20.72304,60,36,0,-24
-42.08387,-20.72304,62,35,0,-27
-42.08118,-20.72304,62,29,5,-33
-42.07825,-20.72304,50,40,0,-10
-42.07556,-20.72304,51,39,0,-12
-42.07286,-20.72304,53,36,0,-17
-42.06994,-20.72304,54,35,5,-19
-42.06724,-20.72304,55,38,5,-17
-42.06455,-20.72304,28,44,0,16
-42.06163,-20.72304,38,41,5,3
-42.05893,-20.72304,39,45,5,6
-42.05601,-20.72304,40,46,5,6
-42.05331,-20.72304,38,49,0,11
-42.05061,-20.72304,39,50,5,11
-42.04769,-20.72304,16,73,0,57
-42.045,-20.72304,35,68,0,33
-42.0423,-20.72304,31,59,5,28
-42.03399,-20.72304,18,70,5,52
-42.03106,-20.72304,9,63,5,54
-42.02837,-20.72304,22,66,5,44
-42.02545,-20.72304,18,55,5,37
-42.02275,-20.72304,47,50,5,3
-42.02005,-20.72304,48,48,5,0
-42.01713,-20.72304,46,46,5,0
-42.01444,-20.72304,51,45,5,-6
-42.01174,-20.72304,45,46,5,1
-42.00882,-20.72304,55,47,5,-8
-42.00612,-20.72304,53,42,5,-11
-42.00342,-20.72304,53,38,5,-15
-42.0005,-20.72304,62,38,5,-24
-41.99781,-20.72304,67,36,5,-31
-41.99511,-20.72304,55,42,5,-13
-41.99219,-20.72304,51,38,0,-13
-41.98949,-20.72304,64,39,0,-25
-41.98657,-20.72304,61,41,0,-20
-41.98387,-20.72304,66,38,0,-28
-41.98118,-20.72304,59,42,0,-17
-41.97826,-20.72304,57,42,11,-15
-41.97556,-20.72304,54,42,0,-12
-41.97286,-20.72304,52,44,11,-8
-41.96994,-20.72304,50,45,0,-5
-42.1005,-20.72282,61,36,0,-25
-42.0978,-20.72282,63,36,0,-27
-42.09511,-20.72282,83,33,0,-50
-42.09219,-20.72282,66,37,5,-29
-42.08949,-20.72282,67,27,5,-40
-42.08657,-20.72282,60,36,0,-24
-42.08387,-20.72282,62,35,0,-27
-42.08118,-20.72282,62,29,5,-33
-42.07825,-20.72282,49,40,0,-9
-42.07556,-20.72282,51,39,0,-12
-42.07286,-20.72282,53,35,0,-18
-42.06994,-20.72282,54,36,5,-18
-42.06724,-20.72282,55,38,5,-17
-42.06455,-20.72282,37,46,0,9
-42.06163,-20.72282,36,35,5,-1
-42.05893,-20.72282,38,45,5,7
-42.05601,-20.72282,39,46,5,7
-42.05331,-20.72282,38,49,0,11
-42.05061,-20.72282,40,50,5,10
-42.04769,-20.72282,21,73,0,52
-42.045,-20.72282,39,68,0,29
-42.0423,-20.72282,37,58,5,21
-42.03668,-20.72282,14,61,6,47
-42.03399,-20.72282,20,72,5,52
-42.03106,-20.72282,1,62,5,61
-42.02837,-20.72282,23,65,5,42
-42.02545,-20.72282,18,55,5,37
-42.02275,-20.72282,46,50,5,4
-42.02005,-20.72282,48,48,5,0
-42.01713,-20.72282,46,46,11,0
-42.01444,-20.72282,50,46,5,-4
-42.01174,-20.72282,45,44,5,-1
-42.00882,-20.72282,56,48,5,-8
-42.00612,-20.72282,53,43,5,-10
-42.00342,-20.72282,53,38,5,-15
-42.0005,-20.72282,63,38,5,-25
-41.99781,-20.72282,64,36,5,-28
-41.99511,-20.72282,54,41,5,-13
-41.99219,-20.72282,52,37,0,-15
-41.98949,-20.72282,64,39,0,-25
-41.98657,-20.72282,61,41,0,-20
-41.98387,-20.72282,65,37,0,-28
-41.98118,-20.72282,60,41,0,-19
-41.97826,-20.72282,57,42,0,-15
-41.97556,-20.72282,54,42,0,-12
-41.97286,-20.72282,52,43,0,-9
-41.96994,-20.72282,50,45,0,-5
-42.1005,-20.7224,61,36,0,-25
-42.0978,-20.7224,63,36,0,-27
-42.09511,-20.7224,83,30,0,-53
-42.09219,-20.7224,67,37,0,-30
-42.08949,-20.7224,68,27,5,-41
-42.08657,-20.7224,60,35,0,-25
-42.08387,-20.7224,62,34,0,-28
-42.08118,-20.7224,61,30,5,-31
-42.07825,-20.7224,50,41,0,-9
-42.07556,-20.7224,51,36,0,-15
-42.07286,-20.7224,53,28,0,-25
-42.06994,-20.7224,53,33,5,-20
-42.06724,-20.7224,56,38,5,-18
-42.06455,-20.7224,38,40,5,2
-42.06163,-20.7224,36,35,5,-1
-42.05893,-20.7224,37,45,5,8
-42.05601,-20.7224,37,46,5,9
-42.05331,-20.7224,37,51,0,14
-42.05061,-20.7224,39,49,5,10
-42.04769,-20.7224,26,73,0,47
-42.045,-20.7224,43,71,0,28
-42.0423,-20.7224,40,63,2,23
-42.03938,-20.7224,7,56,2,49
-42.03668,-20.7224,26,60,2,34
-42.03399,-20.7224,21,70,5,49
-42.02837,-20.7224,18,63,5,45
-42.02545,-20.7224,18,56,5,38
-42.02275,-20.7224,46,51,5,5
-42.02005,-20.7224,48,48,5,0
-42.01713,-20.7224,46,46,5,0
-42.01444,-20.7224,47,46,5,-1
-42.01174,-20.7224,45,44,5,-1
-42.00882,-20.7224,56,45,5,-11
-42.00612,-20.7224,54,43,5,-11
-42.00342,-20.7224,53,38,5,-15
-42.0005,-20.7224,62,39,5,-23
-41.99781,-20.7224,64,35,5,-29
-41.99511,-20.7224,54,41,5,-13
-41.99219,-20.7224,52,37,0,-15
-41.98949,-20.7224,64,39,0,-25
-41.98657,-20.7224,59,42,0,-17
-41.98387,-20.7224,66,37,0,-29
-41.98118,-20.7224,60,41,0,-19
-41.97826,-20.7224,57,41,0,-16
-41.97556,-20.7224,54,42,0,-12
-41.97286,-20.7224,52,43,0,-9
-41.96994,-20.7224,50,44,0,-6
-42.1005,-20.72219,61,35,0,-26
-42.0978,-20.72219,62,36,0,-26
-42.09511,-20.72219,74,30,5,-44
-42.09219,-20.72219,68,36,0,-32
-42.08949,-20.72219,69,27,5,-42
-42.08657,-20.72219,59,35,0,-24
-42.08387,-20.72219,63,33,5,-30
-42.08118,-20.72219,60,30,5,-30
-42.07825,-20.72219,50,41,0,-9
-42.07556,-20.72219,50,28,0,-22
-42.07286,-20.72219,52,28,0,-24
-42.06994,-20.72219,53,34,5,-19
-42.06724,-20.72219,55,38,5,-17
-42.06455,-20.72219,42,43,5,1
-42.06163,-20.72219,35,35,5,0
-42.05893,-20.72219,37,44,5,7
-42.05601,-20.72219,37,45,5,8
-42.05331,-20.72219,38,52,0,14
-42.05061,-20.72219,38,49,5,11
-42.04769,-20.72219,28,73,0,45
-42.045,-20.72219,44,71,0,27
-42.0423,-20.72219,42,64,11,22
-42.03938,-20.72219,10,55,11,45
-42.03668,-20.72219,29,60,2,31
-42.03399,-20.72219,18,70,5,52
-42.02837,-20.72219,21,64,5,43
-42.02545,-20.72219,18,57,5,39
-42.02275,-20.72219,46,50,5,4
-42.02005,-20.72219,47,47,5,0
-42.01713,-20.72219,46,47,5,1
-42.01444,-20.72219,47,46,5,-1
-42.01174,-20.72219,46,46,5,0
-42.00882,-20.72219,56,44,5,-12
-42.00612,-20.72219,54,42,5,-12
-42.00342,-20.72219,54,38,5,-16
-42.0005,-20.72219,59,38,5,-21
-41.99781,-20.72219,63,35,5,-28
-41.99511,-20.72219,54,41,5,-13
-41.99219,-20.72219,52,37,0,-15
-41.98949,-20.72219,65,39,0,-26
-41.98657,-20.72219,59,41,0,-18
-41.98387,-20.72219,67,37,0,-30
-41.98118,-20.72219,61,41,0,-20
-41.97826,-20.72219,57,41,0,-16
-41.97556,-20.72219,54,42,0,-12
-41.97286,-20.72219,52,43,0,-9
-41.96994,-20.72219,50,44,0,-6
-42.1005,-20.72198,60,35,0,-25
-42.0978,-20.72198,62,35,0,-27
-42.09511,-20.72198,72,28,5,-44
-42.09219,-20.72198,71,35,5,-36
-42.08949,-20.72198,69,27,5,-42
-42.08657,-20.72198,59,34,0,-25
-42.08387,-20.72198,62,27,5,-35
-42.08118,-20.72198,59,29,5,-30
-42.07825,-20.72198,50,41,0,-9
-42.07556,-20.72198,49,28,0,-21
-42.07286,-20.72198,51,29,0,-22
-42.06994,-20.72198,52,34,5,-18
-42.06724,-20.72198,53,38,5,-15
-42.06455,-20.72198,46,40,5,-6
-42.06163,-20.72198,35,36,5,1
-42.05893,-20.72198,38,43,5,5
-42.05601,-20.72198,37,46,5,9
-42.05331,-20.72198,38,50,0,12
-42.05061,-20.72198,38,48,5,10
-42.04769,-20.72198,34,73,0,39
-42.045,-20.72198,46,69,0,23
-42.0423,-20.72198,47,62,11,15
-42.03938,-20.72198,12,55,2,43
-42.03668,-20.72198,30,59,11,29
-42.03399,-20.72198,19,70,5,51
-42.03106,-20.72198,2,61,5,59
-42.02837,-20.72198,27,64,5,37
-42.02545,-20.72198,31,56,5,25
-42.02275,-20.72198,46,49,5,3
-42.02005,-20.72198,47,48,5,1
-42.01713,-20.72198,46,47,5,1
-42.01444,-20.72198,48,48,5,0
-42.01174,-20.72198,46,46,5,0
-42.00882,-20.72198,55,46,5,-9
-42.00612,-20.72198,54,44,5,-10
-42.00342,-20.72198,54,39,5,-15
-42.0005,-20.72198,57,38,5,-19
-41.99781,-20.72198,58,35,5,-23
-41.99511,-20.72198,54,41,5,-13
-41.99219,-20.72198,52,37,0,-15
-41.98949,-20.72198,65,39,0,-26
-41.98657,-20.72198,64,41,0,-23
-41.98387,-20.72198,67,36,0,-31
-41.98118,-20.72198,61,40,0,-21
-41.97826,-20.72198,57,41,0,-16
-41.97556,-20.72198,54,42,0,-12
-41.97286,-20.72198,51,43,0,-8
-41.96994,-20.72198,50,44,0,-6
-42.1005,-20.72177,61,35,0,-26
-42.0978,-20.72177,62,35,0,-27
-42.09511,-20.72177,72,29,5,-43
-42.09219,-20.72177,72,33,5,-39
-42.08949,-20.72177,70,27,5,-43
-42.08657,-20.72177,58,34,0,-24
-42.08387,-20.72177,63,27,5,-36
-42.08118,-20.72177,60,29,5,-31
-42.07825,-20.72177,49,41,0,-8
-42.07556,-20.72177,49,28,0,-21
-42.07286,-20.72177,50,29,0,-21
-42.06994,-20.72177,51,33,5,-18
-42.06724,-20.72177,52,36,5,-16
-42.06455,-20.72177,49,40,5,-9
-42.06163,-20.72177,35,36,5,1
-42.05893,-20.72177,37,43,5,6
-42.05601,-20.72177,37,45,5,8
-42.05331,-20.72177,37,51,0,14
-42.05061,-20.72177,40,47,5,7
-42.04769,-20.72177,33,73,0,40
-42.045,-20.72177,47,58,0,11
-42.0423,-20.72177,46,63,5,17
-42.03938,-20.72177,29,55,2,26
-42.03668,-20.72177,30,65,11,35
-42.03399,-20.72177,16,70,5,54
-42.03106,-20.72177,3,61,5,58
-42.02837,-20.72177,29,63,5,34
-42.02545,-20.72177,34,54,5,20
-42.02275,-20.72177,46,47,5,1
-42.02005,-20.72177,47,49,5,2
-42.01713,-20.72177,46,46,5,0
-42.01444,-20.72177,48,45,0,-3
-42.01174,-20.72177,47,46,0,-1
-42.00882,-20.72177,55,46,5,-9
-42.00612,-20.72177,54,45,5,-9
-42.00342,-20.72177,55,39,5,-16
-42.0005,-20.72177,56,38,5,-18
-41.99781,-20.72177,55,35,5,-20
-41.99511,-20.72177,54,40,5,-14
-41.99219,-20.72177,64,38,0,-26
-41.98949,-20.72177,65,39,0,-26
-41.98657,-20.72177,64,41,0,-23
-41.98387,-20.72177,66,36,0,-30
-41.98118,-20.72177,60,40,0,-20
-41.97826,-20.72177,56,41,0,-15
-41.97556,-20.72177,54,41,0,-13
-41.97286,-20.72177,53,43,0,-10
-41.96994,-20.72177,51,44,0,-7
-42.1005,-20.72134,60,35,0,-25
-42.0978,-20.72134,62,35,0,-27
-42.09511,-20.72134,72,27,5,-45
-42.09219,-20.72134,73,33,5,-40
-42.08949,-20.72134,72,26,5,-46
-42.08657,-20.72134,58,25,0,-33
-42.08387,-20.72134,64,26,5,-38
-42.08118,-20.72134,60,28,5,-32
-42.07825,-20.72134,49,37,0,-12
-42.07556,-20.72134,48,29,0,-19
-42.07286,-20.72134,49,31,0,-18
-42.06994,-20.72134,51,35,5,-16
-42.06724,-20.72134,52,39,0,-13
-42.06455,-20.72134,50,39,5,-11
-42.06163,-20.72134,35,40,5,5
-42.05893,-20.72134,35,43,5,8
-42.05601,-20.72134,36,45,5,9
-42.05331,-20.72134,36,51,0,15
-42.05061,-20.72134,36,47,5,11
-42.04769,-20.72134,26,58,0,32
-42.045,-20.72134,41,65,0,24
-42.0423,-20.72134,45,65,11,20
-42.03938,-20.72134,32,54,2,22
-42.03668,-20.72134,23,59,11,36
-42.03399,-20.72134,18,63,5,45
-42.03106,-20.72134,11,61,5,50
-42.02837,-20.72134,31,62,5,31
-42.02545,-20.72134,16,55,5,39
-42.02275,-20.72134,47,49,5,2
-42.02005,-20.72134,47,49,5,2
-42.01713,-20.72134,46,45,0,-1
-42.01444,-20.72134,48,55,0,7
-42.01174,-20.72134,47,50,0,3
-42.00882,-20.72134,55,50,5,-5
-42.00612,-20.72134,54,44,5,-10
-42.00342,-20.72134,55,41,5,-14
-42.0005,-20.72134,56,40,5,-16
-41.99781,-20.72134,55,35,5,-20
-41.99511,-20.72134,54,38,5,-16
-41.99219,-20.72134,63,39,0,-24
-41.98949,-20.72134,65,39,0,-26
-41.98657,-20.72134,63,41,0,-22
-41.98387,-20.72134,66,37,0,-29
-41.98118,-20.72134,60,40,0,-20
-41.97826,-20.72134,56,41,0,-15
-41.97556,-20.72134,54,42,0,-12
-41.97286,-20.72134,53,42,0,-11
-41.96994,-20.72134,51,44,0,-7
-42.1005,-20.72113,61,33,0,-28
-42.0978,-20.72113,64,34,0,-30
-42.09511,-20.72113,72,27,5,-45
-42.09219,-20.72113,72,30,5,-42
-42.08949,-20.72113,72,26,5,-46
-42.08657,-20.72113,58,28,0,-30
-42.08387,-20.72113,68,25,5,-43
-42.08118,-20.72113,55,27,5,-28
-42.07825,-20.72113,49,37,0,-12
-42.07556,-20.72113,48,31,0,-17
-42.07286,-20.72113,48,32,0,-16
-42.06994,-20.72113,50,36,5,-14
-42.06724,-20.72113,52,39,0,-13
-42.06455,-20.72113,50,39,5,-11
-42.06163,-20.72113,34,40,5,6
-42.05893,-20.72113,33,43,5,10
-42.05601,-20.72113,36,44,5,8
-42.05331,-20.72113,36,48,11,12
-42.05061,-20.72113,32,47,0,15
-42.04769,-20.72113,25,54,0,29
-42.045,-20.72113,39,64,0,25
-42.0423,-20.72113,43,70,5,27
-42.03938,-20.72113,31,57,11,26
-42.03668,-20.72113,22,58,11,36
-42.03399,-20.72113,18,63,5,45
-42.03106,-20.72113,18,61,5,43
-42.02837,-20.72113,33,62,5,29
-42.02545,-20.72113,17,55,5,38
-42.02275,-20.72113,46,46,5,0
-42.02005,-20.72113,47,51,5,4
-42.01713,-20.72113,45,45,5,0
-42.01444,-20.72113,47,54,0,7
-42.01174,-20.72113,47,50,0,3
-42.00882,-20.72113,55,52,5,-3
-42.00612,-20.72113,54,43,5,-11
-42.00342,-20.72113,55,42,5,-13
-42.0005,-20.72113,56,37,5,-19
-41.99781,-20.72113,55,36,5,-19
-41.99511,-20.72113,54,41,5,-13
-41.99219,-20.72113,63,39,0,-24
-41.98949,-20.72113,64,39,0,-25
-41.98657,-20.72113,60,41,0,-19
-41.98387,-20.72113,66,37,0,-29
-41.98118,-20.72113,60,40,0,-20
-41.97826,-20.72113,56,41,0,-15
-41.97556,-20.72113,54,41,0,-13
-41.97286,-20.72113,53,42,0,-11
-41.96994,-20.72113,51,44,0,-7
-42.1005,-20.72092,61,33,0,-28
-42.0978,-20.72092,65,34,0,-31
-42.09511,-20.72092,71,27,5,-44
-42.09219,-20.72092,72,26,5,-46
-42.08949,-20.72092,72,25,5,-47
-42.08657,-20.72092,58,28,0,-30
-42.08387,-20.72092,69,25,5,-44
-42.08118,-20.72092,50,27,5,-23
-42.07825,-20.72092,48,38,0,-10
-42.07556,-20.72092,48,31,0,-17
-42.07286,-20.72092,46,33,0,-13
-42.06994,-20.72092,50,36,5,-14
-42.06724,-20.72092,51,39,5,-12
-42.06455,-20.72092,51,37,5,-14
-42.06163,-20.72092,34,40,5,6
-42.05893,-20.72092,32,43,5,11
-42.05601,-20.72092,35,44,5,9
-42.05331,-20.72092,36,46,5,10
-42.05061,-20.72092,29,50,0,21
-42.04769,-20.72092,27,51,0,24
-42.045,-20.72092,38,61,0,23
-42.0423,-20.72092,40,68,11,28
-42.03938,-20.72092,31,59,11,28
-42.03668,-20.72092,22,63,11,41
-42.03399,-20.72092,25,61,5,36
-42.03106,-20.72092,25,59,5,34
-42.02837,-20.72092,34,62,5,28
-42.02545,-20.72092,18,54,5,36
-42.02275,-20.72092,46,46,5,0
-42.02005,-20.72092,47,51,5,4
-42.01713,-20.72092,47,47,5,0
-42.01444,-20.72092,47,54,0,7
-42.01174,-20.72092,47,52,0,5
-42.00882,-20.72092,54,54,5,0
-42.00612,-20.72092,55,44,5,-11
-42.00342,-20.72092,54,42,5,-12
-42.0005,-20.72092,55,37,5,-18
-41.99781,-20.72092,55,36,5,-19
-41.99511,-20.72092,54,38,5,-16
-41.99219,-20.72092,65,39,0,-26
-41.98949,-20.72092,63,39,0,-24
-41.98657,-20.72092,60,41,0,-19
-41.98387,-20.72092,65,37,0,-28
-41.98118,-20.72092,59,40,0,-19
-41.97826,-20.72092,55,41,0,-14
-41.97556,-20.72092,54,41,0,-13
-41.97286,-20.72092,53,42,0,-11
-41.96994,-20.72092,51,44,0,-7
-42.10297,-20.7205,69,35,0,-34
-42.10275,-20.7205,70,34,0,-36
-42.10252,-20.7205,70,34,0,-36
-42.1023,-20.7205,69,34,0,-35
-42.10185,-20.7205,69,34,0,-35
-42.10163,-20.7205,66,33,0,-33
-42.1014,-20.7205,67,32,0,-35
-42.10118,-20.7205,65,32,0,-33
-42.10073,-20.7205,60,32,0,-28
-42.1005,-20.7205,61,31,0,-30
-42.10028,-20.7205,61,31,0,-30
-42.10005,-20.7205,61,31,0,-30
-42.09983,-20.7205,62,30,0,-32
-42.09938,-20.7205,62,29,0,-33
-42.09915,-20.7205,63,29,0,-34
-42.09893,-20.7205,64,30,0,-34
-42.0987,-20.7205,65,30,0,-35
-42.09825,-20.7205,66,30,0,-36
-42.09803,-20.7205,66,33,0,-33
-42.0978,-20.7205,66,33,0,-33
-42.09758,-20.7205,67,32,0,-35
-42.09713,-20.7205,68,29,0,-39
-42.09691,-20.7205,70,29,0,-41
-42.09668,-20.7205,71,29,0,-42
-42.09646,-20.7205,71,29,0,-42
-42.09601,-20.7205,71,30,0,-41
-42.09578,-20.7205,71,30,0,-41
-42.09556,-20.7205,71,30,0,-41
-42.09533,-20.7205,70,28,0,-42
-42.09511,-20.7205,70,26,0,-44
-42.09466,-20.7205,71,22,5,-49
-42.09443,-20.7205,71,25,5,-46
-42.09421,-20.7205,72,24,5,-48
-42.09398,-20.7205,72,25,5,-47
-42.09354,-20.7205,73,25,5,-48
-42.09331,-20.7205,73,27,5,-46
-42.09309,-20.7205,72,27,5,-45
-42.09286,-20.7205,72,27,0,-45
-42.09241,-20.7205,72,26,5,-46
-42.09219,-20.7205,72,25,5,-47
-42.09196,-20.7205,72,25,5,-47
-42.09174,-20.7205,71,25,5,-46
-42.09129,-20.7205,71,25,5,-46
-42.09106,-20.7205,71,26,5,-45
-42.09084,-20.7205,71,26,5,-45
-42.09061,-20.7205,71,26,5,-45
-42.09039,-20.7205,71,26,5,-45
-42.08994,-20.7205,72,26,5,-46
-42.08972,-20.7205,73,26,5,-47
-42.08949,-20.7205,73,26,5,-47
-42.08927,-20.7205,74,25,5,-49
-42.08882,-20.7205,77,26,5,-51
-42.08859,-20.7205,82,26,5,-56
-42.08837,-20.7205,72,26,5,-46
-42.08814,-20.7205,59,26,5,-33
-42.08769,-20.7205,61,26,5,-35
-42.08747,-20.7205,56,26,5,-30
-42.08724,-20.7205,56,26,5,-30
-42.08702,-20.7205,56,28,5,-28
-42.08657,-20.7205,57,28,0,-29
-42.08634,-20.7205,58,18,0,-40
-42.08612,-20.7205,58,17,0,-41
-42.08589,-20.7205,58,16,0,-42
-42.08545,-20.7205,59,15,0,-44
-42.08522,-20.7205,60,16,0,-44
-42.085,-20.7205,61,20,0,-41
-42.08477,-20.7205,61,20,0,-41
-42.08455,-20.7205,62,23,5,-39
-42.0841,-20.7205,65,24,5,-41
-42.08387,-20.7205,67,25,5,-42
-42.08365,-20.7205,61,24,5,-37
-42.08342,-20.7205,64,25,5,-39
-42.08297,-20.7205,62,27,5,-35
-42.08275,-20.7205,63,29,0,-34
-42.08252,-20.7205,65,31,0,-34
-42.0823,-20.7205,62,31,0,-31
-42.08185,-20.7205,60,29,0,-31
-42.08163,-20.7205,61,25,0,-36
-42.0814,-20.7205,52,26,0,-26
-42.08118,-20.7205,44,27,5,-17
-42.08073,-20.7205,44,27,5,-17
-42.0805,-20.7205,44,27,5,-17
-42.08028,-20.7205,45,27,5,-18
-42.08005,-20.7205,45,28,5,-17
-42.07983,-20.7205,45,28,5,-17
-42.07938,-20.7205,46,29,5,-17
-42.07915,-20.7205,47,31,5,-16
-42.07893,-20.7205,47,34,5,-13
-42.0787,-20.7205,48,37,0,-11
-42.07825,-20.7205,48,36,0,-12
-42.07803,-20.7205,48,35,0,-13
-42.07781,-20.7205,48,35,0,-13
-42.07758,-20.7205,48,38,0,-10
-42.07713,-20.7205,48,41,0,-7
-42.07691,-20.7205,48,42,0,-6
-42.07668,-20.7205,48,42,0,-6
-42.07646,-20.7205,48,41,0,-7
-42.07601,-20.7205,49,40,0,-9
-42.07578,-20.7205,48,37,0,-11
-42.07556,-20.7205,49,33,0,-16
-42.07533,-20.7205,50,33,0,-17
-42.07511,-20.7205,52,33,0,-19
-42.07466,-20.7205,54,33,0,-21
-42.07443,-20.7205,55,33,0,-22
-42.07421,-20.7205,55,34,0,-21
-42.07399,-20.7205,53,34,0,-19
-42.07354,-20.7205,52,34,0,-18
-42.07331,-20.7205,50,34,0,-16
-42.07309,-20.7205,45,34,0,-11
-42.07286,-20.7205,45,33,0,-12
-42.07241,-20.7205,45,39,0,-6
-42.07219,-20.7205,45,39,0,-6
-42.07196,-20.7205,46,36,0,-10
-42.07174,-20.7205,47,36,5,-11
-42.07129,-20.7205,47,36,5,-11
-42.07106,-20.7205,48,37,5,-11
-42.07084,-20.7205,48,40,5,-8
-42.07061,-20.7205,49,40,0,-9
-42.07039,-20.7205,49,40,0,-9
-42.06994,-20.7205,49,39,0,-10
-42.06972,-20.7205,50,41,0,-9
-42.06949,-20.7205,50,42,0,-8
-42.06927,-20.7205,50,41,0,-9
-42.06882,-20.7205,50,36,0,-14
-42.06859,-20.7205,50,36,0,-14
-42.06837,-20.7205,49,36,0,-13
-42.06814,-20.7205,50,35,5,-15
-42.06769,-20.7205,50,35,5,-15
-42.06747,-20.7205,50,35,5,-15
-42.06724,-20.7205,50,36,5,-14
-42.06702,-20.7205,51,37,5,-14
-42.06657,-20.7205,51,40,5,-11
-42.06634,-20.7205,51,38,0,-13
-42.06612,-20.7205,51,36,0,-15
-42.0659,-20.7205,51,37,5,-14
-42.06545,-20.7205,51,37,5,-14
-42.06522,-20.7205,50,36,5,-14
-42.065,-20.7205,50,34,5,-16
-42.06477,-20.7205,51,32,5,-19
-42.06455,-20.7205,50,35,5,-15
-42.0641,-20.7205,46,33,5,-13
-42.06387,-20.7205,34,33,5,-1
-42.06365,-20.7205,28,31,5,3
-42.06342,-20.7205,33,33,5,0
-42.06297,-20.7205,34,32,5,-2
-42.06275,-20.7205,30,31,5,1
-42.06252,-20.7205,34,34,5,0
-42.0623,-20.7205,33,33,5,0
-42.06185,-20.7205,33,34,5,1
-42.06163,-20.7205,34,35,5,1
-42.0614,-20.7205,33,38,5,5
-42.06118,-20.7205,34,38,5,4
-42.06073,-20.7205,33,41,5,8
-42.0605,-20.7205,37,41,5,4
-42.06028,-20.7205,38,42,5,4
-42.06005,-20.7205,39,42,5,3
-42.05983,-20.7205,40,42,5,2
-42.05938,-20.7205,37,42,5,5
-42.05915,-20.7205,35,43,5,8
-42.05893,-20.7205,32,45,0,13
-42.0587,-20.7205,32,44,0,12
-42.05826,-20.7205,31,45,0,14
-42.05803,-20.7205,31,46,0,15
-42.05781,-20.7205,32,47,0,15
-42.05758,-20.7205,33,47,0,14
-42.05713,-20.7205,33,48,0,15
-42.05691,-20.7205,34,46,0,12
-42.05668,-20.7205,33,46,0,13
-42.05646,-20.7205,33,46,0,13
-42.05601,-20.7205,33,45,0,12
-42.05578,-20.7205,33,45,0,12
-42.05556,-20.7205,34,46,0,12
-42.05533,-20.7205,34,46,0,12
-42.05511,-20.7205,37,44,11,7
-42.05466,-20.7205,39,45,11,6
-42.05443,-20.7205,38,46,5,8
-42.05421,-20.7205,37,45,5,8
-42.05399,-20.7205,35,46,11,11
-42.05354,-20.7205,35,46,5,11
-42.05331,-20.7205,36,46,5,10
-42.05309,-20.7205,35,46,5,11
-42.05286,-20.7205,34,47,5,13
-42.05241,-20.7205,36,47,5,11
-42.05219,-20.7205,38,48,5,10
-42.05196,-20.7205,42,51,5,9
-42.05174,-20.7205,43,57,0,14
-42.05129,-20.7205,45,64,0,19
-42.05106,-20.7205,42,56,0,14
-42.05084,-20.7205,40,52,0,12
-42.05061,-20.7205,30,52,0,22
-42.05039,-20.7205,30,52,0,22
-42.04994,-20.7205,31,52,0,21
-42.04972,-20.7205,32,52,0,20
-42.04949,-20.7205,29,52,0,23
-42.04927,-20.7205,26,52,0,26
-42.04882,-20.7205,30,50,0,20
-42.04859,-20.7205,26,51,0,25
-42.04837,-20.7205,26,51,0,25
-42.04814,-20.7205,29,50,0,21
-42.04769,-20.7205,27,51,0,24
-42.04747,-20.7205,29,52,0,23
-42.04724,-20.7205,30,52,0,22
-42.04702,-20.7205,32,54,0,22
-42.04657,-20.7205,34,59,0,25
-42.04635,-20.7205,36,59,0,23
-42.04612,-20.7205,37,59,0,22
-42.0459,-20.7205,37,60,0,23
-42.04545,-20.7205,38,60,0,22
-42.04522,-20.7205,38,60,0,22
-42.045,-20.7205,38,60,0,22
-42.04477,-20.7205,39,60,0,21
-42.04455,-20.7205,39,62,0,23
-42.0441,-20.7205,39,64,0,25
-42.04387,-20.7205,39,64,0,25
-42.04365,-20.7205,39,64,0,25
-42.04342,-20.7205,39,66,0,27
-42.04297,-20.7205,38,66,0,28
-42.04275,-20.7205,43,69,0,26
-42.04253,-20.7205,43,68,11,25
-42.0423,-20.7205,37,68,11,31
-42.04185,-20.7205,37,64,11,27
-42.04163,-20.7205,37,64,11,27
-42.0414,-20.7205,34,63,11,29
-42.04118,-20.7205,34,64,11,30
-42.04073,-20.7205,33,64,0,31
-42.0405,-20.7205,33,61,0,28
-42.04028,-20.7205,32,61,2,29
-42.04005,-20.7205,30,61,11,31
-42.03983,-20.7205,30,61,2,31
-42.03938,-20.7205,25,60,2,35
-42.03915,-20.7205,22,51,11,29
-42.03893,-20.7205,11,51,2,40
-42.0387,-20.7205,2,49,11,47
-42.03781,-20.7205,4,53,2,49
-42.03758,-20.7205,6,50,11,44
-42.03713,-20.7205,15,55,11,40
-42.03691,-20.7205,17,57,5,40
-42.03668,-20.7205,21,57,5,36
-42.03646,-20.7205,23,58,5,35
-42.03601,-20.7205,23,59,5,36
-42.03578,-20.7205,27,60,11,33
-42.03556,-20.7205,30,63,2,33
-42.03533,-20.7205,31,61,2,30
-42.03511,-20.7205,29,60,2,31
-42.03466,-20.7205,27,60,11,33
-42.03444,-20.7205,25,63,11,38
-42.03421,-20.7205,24,64,5,40
-42.03399,-20.7205,22,62,11,40
-42.03354,-20.7205,28,62,5,34
-42.03331,-20.7205,28,62,5,34
-42.03309,-20.7205,26,68,5,42
-42.03286,-20.7205,24,69,5,45
-42.03241,-20.7205,22,65,5,43
-42.03219,-20.7205,22,65,5,43
-42.03196,-20.7205,23,64,5,41
-42.03174,-20.7205,26,63,5,37
-42.03129,-20.7205,27,60,5,33
-42.03106,-20.7205,31,59,5,28
-42.03084,-20.7205,32,58,5,26
-42.03062,-20.7205,34,58,5,24
-42.03017,-20.7205,37,55,5,18
-42.02994,-20.7205,40,54,5,14
-42.02972,-20.7205,39,54,5,15
-42.02949,-20.7205,38,53,5,15
-42.02927,-20.7205,37,54,5,17
-42.02882,-20.7205,36,54,5,18
-42.02859,-20.7205,36,57,5,21
-42.02837,-20.7205,35,58,5,23
-42.02814,-20.7205,34,62,5,28
-42.02769,-20.7205,32,61,5,29
-42.02747,-20.7205,32,62,5,30
-42.02724,-20.7205,31,61,5,30
-42.02702,-20.7205,29,59,5,30
-42.02657,-20.7205,28,57,5,29
-42.02635,-20.7205,28,58,0,30
-42.02612,-20.7205,27,57,0,30
-42.0259,-20.7205,24,56,0,32
-42.02545,-20.7205,18,53,0,35
-42.02522,-20.7205,5,54,0,49
-42.025,-20.7205,19,51,0,32
-42.02477,-20.7205,26,52,0,26
-42.02455,-20.7205,35,51,5,16
-42.0241,-20.7205,38,51,5,13
-42.02387,-20.7205,42,50,5,8
-42.02365,-20.7205,44,50,5,6
-42.02342,-20.7205,43,49,5,6
-42.02297,-20.7205,47,47,5,0
-42.02275,-20.7205,45,46,5,1
-42.02253,-20.7205,45,47,5,2
-42.0223,-20.7205,48,47,5,-1
-42.02185,-20.7205,46,51,5,5
-42.02163,-20.7205,47,51,5,4
-42.0214,-20.7205,50,51,5,1
-42.02118,-20.7205,48,51,5,3
-42.02073,-20.7205,47,51,5,4
-42.0205,-20.7205,47,52,5,5
-42.02028,-20.7205,47,51,5,4
-42.02005,-20.7205,47,49,5,2
-42.01983,-20.7205,47,49,5,2
-42.01938,-20.7205,47,48,5,1
-42.01915,-20.7205,47,47,5,0
-42.01893,-20.7205,47,47,5,0
-42.01871,-20.7205,47,47,5,0
-42.01826,-20.7205,46,46,5,0
-42.01803,-20.7205,46,46,5,0
-42.01781,-20.7205,46,45,5,-1
-42.01758,-20.7205,46,45,5,-1
-42.01713,-20.7205,46,45,5,-1
-42.01691,-20.7205,50,49,5,-1
-42.01668,-20.7205,50,50,5,0
-42.01646,-20.7205,50,50,5,0
-42.01601,-20.7205,49,50,5,1
-42.01578,-20.7205,49,51,5,2
-42.01556,-20.7205,48,49,0,1
-42.01533,-20.7205,48,51,0,3
-42.01511,-20.7205,47,52,0,5
-42.01466,-20.7205,47,52,11,5
-42.01444,-20.7205,47,53,0,6
-42.01421,-20.7205,47,53,0,6
-42.01399,-20.7205,47,53,0,6
-42.01354,-20.7205,47,53,0,6
-42.01331,-20.7205,47,53,0,6
-42.01309,-20.7205,47,52,0,5
-42.01286,-20.7205,47,52,0,5
-42.01241,-20.7205,47,50,0,3
-42.01219,-20.7205,47,46,0,-1
-42.01196,-20.7205,47,47,5,0
-42.01174,-20.7205,46,46,5,0
-42.01129,-20.7205,45,45,5,0
-42.01106,-20.7205,44,44,5,0
-42.01084,-20.7205,44,44,5,0
-42.01062,-20.7205,44,44,5,0
-42.01017,-20.7205,52,44,5,-8
-42.00994,-20.7205,53,43,5,-10
-42.00972,-20.7205,53,44,5,-9
-42.00949,-20.7205,55,47,5,-8
-42.00927,-20.7205,54,47,5,-7
-42.00882,-20.7205,54,54,5,0
-42.00859,-20.7205,57,54,5,-3
-42.00837,-20.7205,56,45,5,-11
-42.00814,-20.7205,56,44,5,-12
-42.00769,-20.7205,54,55,5,1
-42.00747,-20.7205,54,55,5,1
-42.00724,-20.7205,55,56,5,1
-42.00702,-20.7205,54,49,5,-5
-42.00657,-20.7205,54,44,5,-10
-42.00635,-20.7205,54,44,5,-10
-42.00612,-20.7205,54,44,5,-10
-42.0059,-20.7205,54,44,5,-10
-42.00545,-20.7205,54,42,5,-12
-42.00522,-20.7205,54,41,5,-13
-42.005,-20.7205,54,41,5,-13
-42.00477,-20.7205,58,40,5,-18
-42.00455,-20.7205,57,41,5,-16
-42.0041,-20.7205,59,41,5,-18
-42.00387,-20.7205,55,41,5,-14
-42.00365,-20.7205,55,43,5,-12
-42.00342,-20.7205,55,46,5,-9
-42.00298,-20.7205,55,46,5,-9
-42.00275,-20.7205,61,40,5,-21
-42.00253,-20.7205,58,39,5,-19
-42.0023,-20.7205,55,39,5,-16
-42.00185,-20.7205,55,40,5,-15
-42.00163,-20.7205,55,38,5,-17
-42.0014,-20.7205,55,39,5,-16
-42.00118,-20.7205,55,38,5,-17
-42.00073,-20.7205,55,39,5,-16
-42.0005,-20.7205,55,37,5,-18
-42.00028,-20.7205,55,36,5,-19
-42.00005,-20.7205,55,37,5,-18
-41.99983,-20.7205,55,37,5,-18
-41.99938,-20.7205,55,36,5,-19
-41.99916,-20.7205,55,35,5,-20
-41.99893,-20.7205,55,36,5,-19
-41.99871,-20.7205,55,37,5,-18
-41.99826,-20.7205,55,37,5,-18
-41.99803,-20.7205,55,37,5,-18
-41.99781,-20.7205,55,37,5,-18
-41.99758,-20.7205,55,36,5,-19
-41.99713,-20.7205,55,38,5,-17
-41.99691,-20.7205,55,38,5,-17
-41.99668,-20.7205,54,38,5,-16
-41.99646,-20.7205,54,38,5,-16
-41.99601,-20.7205,54,36,5,-18
-41.99578,-20.7205,54,36,5,-18
-41.99556,-20.7205,54,36,5,-18
-41.99533,-20.7205,54,37,5,-17
-41.99511,-20.7205,53,38,5,-15
-41.99466,-20.7205,53,41,5,-12
-41.99444,-20.7205,53,39,5,-14
-41.99421,-20.7205,53,41,5,-12
-41.99399,-20.7205,52,42,0,-10
-41.99354,-20.7205,52,42,0,-10
-41.99331,-20.7205,52,42,0,-10
-41.99309,-20.7205,52,42,0,-10
-41.99286,-20.7205,64,42,0,-22
-41.99241,-20.7205,63,40,0,-23
-41.99219,-20.7205,65,40,0,-25
-41.99196,-20.7205,66,39,0,-27
-41.99174,-20.7205,64,39,0,-25
-41.99129,-20.7205,64,39,0,-25
-41.99107,-20.7205,64,40,0,-24
-41.99084,-20.7205,63,39,0,-24
-41.99062,-20.7205,64,40,0,-24
-41.99017,-20.7205,63,39,0,-24
-41.98994,-20.7205,63,39,0,-24
-41.98972,-20.7205,63,39,0,-24
-41.98949,-20.7205,63,39,0,-24
-41.98927,-20.7205,65,40,0,-25
-41.98882,-20.7205,64,41,0,-23
-41.98859,-20.7205,63,41,0,-22
-41.98837,-20.7205,61,41,0,-20
-41.98814,-20.7205,59,41,0,-18
-41.98769,-20.7205,58,41,0,-17
-41.98747,-20.7205,57,41,0,-16
-41.98725,-20.7205,57,41,0,-16
-41.98702,-20.7205,58,41,0,-17
-41.98657,-20.7205,57,42,0,-15
-41.98635,-20.7205,60,42,0,-18
-41.98612,-20.7205,65,42,0,-23
-41.9859,-20.7205,65,42,5,-23
-41.98545,-20.7205,65,42,5,-23
-41.98522,-20.7205,67,39,5,-28
-41.985,-20.7205,66,34,5,-32
-41.98477,-20.7205,66,34,0,-32
-41.98455,-20.7205,66,35,0,-31
-41.9841,-20.7205,66,36,0,-30
-41.98387,-20.7205,65,36,0,-29
-41.98365,-20.7205,63,36,0,-27
-41.98343,-20.7205,62,37,0,-25
-41.98298,-20.7205,61,37,0,-24
-41.98275,-20.7205,60,37,0,-23
-41.98253,-20.7205,60,38,0,-22
-41.9823,-20.7205,60,38,0,-22
-41.98185,-20.7205,60,39,0,-21
-41.98163,-20.7205,60,39,0,-21
-41.9814,-20.7205,59,40,0,-19
-41.98118,-20.7205,59,40,0,-19
-41.98073,-20.7205,58,40,0,-18
-41.9805,-20.7205,58,41,0,-17
-41.98028,-20.7205,57,40,0,-17
-41.98005,-20.7205,57,40,0,-17
-41.97983,-20.7205,56,40,0,-16
-41.97938,-20.7205,56,40,5,-16
-41.97916,-20.7205,55,40,5,-15
-41.97893,-20.7205,54,40,5,-14
-41.97871,-20.7205,54,40,5,-14
-41.97826,-20.7205,54,41,0,-13
-41.97803,-20.7205,54,41,0,-13
-41.97781,-20.7205,54,41,0,-13
-41.97758,-20.7205,54,41,0,-13
-41.97713,-20.7205,54,41,0,-13
-41.97691,-20.7205,54,41,0,-13
-41.97668,-20.7205,54,41,0,-13
-41.97646,-20.7205,54,41,0,-13
-41.97601,-20.7205,54,41,0,-13
-41.97578,-20.7205,54,41,0,-13
-41.97556,-20.7205,53,41,0,-12
-41.97534,-20.7205,53,41,0,-12
-41.97511,-20.7205,53,42,0,-11
-41.97466,-20.7205,53,42,0,-11
-41.97444,-20.7205,53,42,0,-11
-41.97421,-20.7205,53,42,0,-11
-41.97399,-20.7205,53,42,0,-11
-41.97354,-20.7205,53,42,0,-11
-41.97331,-20.7205,53,42,0,-11
-41.97309,-20.7205,53,42,0,-11
-41.97286,-20.7205,53,42,0,-11
-41.97241,-20.7205,52,42,0,-10
-41.97219,-20.7205,52,43,0,-9
-41.97196,-20.7205,52,43,11,-9
-41.97174,-20.7205,52,43,0,-9
-41.97129,-20.7205,52,43,0,-9
-41.97107,-20.7205,52,43,0,-9
-41.97084,-20.7205,52,43,0,-9
-41.97062,-20.7205,52,43,0,-9
-41.97017,-20.7205,51,43,0,-8
-41.96994,-20.7205,51,44,0,-7
-41.96972,-20.7205,51,44,0,-7
-41.96949,-20.7205,51,44,0,-7
-41.96927,-20.7205,51,44,5,-7
-42.1005,-20.72029,62,31,0,-31
-42.0978,-20.72029,66,28,0,-38
-42.09511,-20.72029,70,22,0,-48
-42.09219,-20.72029,72,24,5,-48
-42.08949,-20.72029,73,26,5,-47
-42.08657,-20.72029,56,28,0,-28
-42.08387,-20.72029,65,24,5,-41
-42.08118,-20.72029,44,27,5,-17
-42.07825,-20.72029,48,38,0,-10
-42.07556,-20.72029,50,37,0,-13
-42.07286,-20.72029,44,35,0,-9
-42.06994,-20.72029,49,40,0,-9
-42.06724,-20.72029,50,37,5,-13
-42.06455,-20.72029,52,34,5,-18
-42.06163,-20.72029,34,38,5,4
-42.05893,-20.72029,31,47,0,16
-42.05601,-20.72029,27,49,0,22
-42.05331,-20.72029,38,46,5,8
-42.05061,-20.72029,36,52,0,16
-42.04769,-20.72029,28,55,0,27
-42.045,-20.72029,38,59,0,21
-42.0423,-20.72029,37,68,0,31
-42.03938,-20.72029,23,60,2,37
-42.03668,-20.72029,21,57,5,36
-42.03399,-20.72029,22,63,11,41
-42.03106,-20.72029,30,59,5,29
-42.02837,-20.72029,35,58,5,23
-42.02545,-20.72029,18,52,5,34
-42.02275,-20.72029,44,47,5,3
-42.02005,-20.72029,47,50,5,3
-42.01713,-20.72029,46,45,5,-1
-42.01444,-20.72029,47,52,11,5
-42.01174,-20.72029,46,46,5,0
-42.00882,-20.72029,53,54,5,1
-42.00612,-20.72029,54,44,5,-10
-42.00342,-20.72029,55,44,5,-11
-42.0005,-20.72029,55,37,5,-18
-41.99781,-20.72029,55,37,5,-18
-41.99511,-20.72029,53,38,5,-15
-41.99219,-20.72029,66,39,0,-27
-41.98949,-20.72029,63,39,0,-24
-41.98657,-20.72029,58,42,0,-16
-41.98387,-20.72029,64,35,0,-29
-41.98118,-20.72029,57,40,0,-17
-41.97826,-20.72029,54,40,0,-14
-41.97556,-20.72029,53,41,0,-12
-41.97286,-20.72029,53,42,0,-11
-41.96994,-20.72029,51,44,0,-7
-42.1005,-20.72008,63,29,0,-34
-42.0978,-20.72008,66,28,5,-38
-42.09511,-20.72008,70,19,0,-51
-42.09219,-20.72008,72,25,5,-47
-42.08949,-20.72008,74,26,5,-48
-42.08657,-20.72008,55,15,0,-40
-42.08387,-20.72008,65,24,5,-41
-42.08118,-20.72008,44,32,0,-12
-42.07825,-20.72008,48,39,0,-9
-42.07556,-20.72008,51,42,0,-9
-42.07286,-20.72008,43,38,0,-5
-42.06994,-20.72008,48,39,0,-9
-42.06724,-20.72008,49,37,5,-12
-42.06455,-20.72008,50,34,5,-16
-42.06163,-20.72008,34,38,5,4
-42.05893,-20.72008,35,45,0,10
-42.05601,-20.72008,26,47,5,21
-42.05331,-20.72008,39,46,5,7
-42.05061,-20.72008,38,56,0,18
-42.04769,-20.72008,28,62,0,34
-42.045,-20.72008,37,59,0,22
-42.0423,-20.72008,35,62,0,27
-42.03938,-20.72008,19,59,2,40
-42.03668,-20.72008,21,54,5,33
-42.03399,-20.72008,25,59,5,34
-42.03106,-20.72008,36,56,5,20
-42.02837,-20.72008,34,58,5,24
-42.02545,-20.72008,18,52,5,34
-42.02275,-20.72008,43,49,5,6
-42.02005,-20.72008,47,49,5,2
-42.01713,-20.72008,47,46,5,-1
-42.01444,-20.72008,47,52,0,5
-42.01174,-20.72008,45,44,5,-1
-42.00882,-20.72008,52,45,5,-7
-42.00612,-20.72008,53,44,5,-9
-42.00342,-20.72008,55,44,5,-11
-42.0005,-20.72008,55,39,5,-16
-41.99781,-20.72008,55,37,5,-18
-41.99511,-20.72008,53,37,5,-16
-41.99219,-20.72008,64,39,0,-25
-41.98949,-20.72008,63,39,0,-24
-41.98657,-20.72008,58,42,0,-16
-41.98387,-20.72008,62,35,0,-27
-41.98118,-20.72008,57,39,0,-18
-41.97826,-20.72008,54,40,0,-14
-41.97556,-20.72008,53,41,0,-12
-41.97286,-20.72008,53,42,0,-11
-41.96994,-20.72008,51,44,0,-7
-42.1005,-20.71965,63,27,0,-36
-42.0978,-20.71965,67,26,5,-41
-42.09511,-20.71965,70,19,0,-51
-42.09219,-20.71965,72,24,5,-48
-42.08949,-20.71965,73,17,0,-56
-42.08657,-20.71965,54,26,0,-28
-42.08387,-20.71965,65,26,5,-39
-42.08118,-20.71965,43,38,0,-5
-42.07825,-20.71965,48,39,0,-9
-42.07556,-20.71965,51,42,5,-9
-42.07286,-20.71965,41,40,0,-1
-42.06994,-20.71965,47,40,0,-7
-42.06724,-20.71965,48,38,5,-10
-42.06455,-20.71965,48,34,5,-14
-42.06163,-20.71965,33,34,5,1
-42.05893,-20.71965,40,47,0,7
-42.05601,-20.71965,27,45,5,18
-42.05331,-20.71965,39,47,5,8
-42.05061,-20.71965,34,52,0,18
-42.04769,-20.71965,28,64,0,36
-42.045,-20.71965,37,60,0,23
-42.0423,-20.71965,33,58,0,25
-42.03938,-20.71965,22,54,2,32
-42.03668,-20.71965,19,52,5,33
-42.03399,-20.71965,26,58,5,32
-42.03106,-20.71965,36,57,0,21
-42.02837,-20.71965,34,56,5,22
-42.02545,-20.71965,18,52,5,34
-42.02275,-20.71965,43,50,5,7
-42.02005,-20.71965,47,48,5,1
-42.01713,-20.71965,47,47,5,0
-42.01444,-20.71965,47,49,0,2
-42.01174,-20.71965,45,45,5,0
-42.00882,-20.71965,50,44,5,-6
-42.00612,-20.71965,53,56,5,3
-42.00342,-20.71965,55,40,5,-15
-42.0005,-20.71965,55,37,5,-18
-41.99781,-20.71965,55,36,5,-19
-41.99511,-20.71965,53,37,5,-16
-41.99219,-20.71965,64,42,0,-22
-41.98949,-20.71965,63,38,0,-25
-41.98657,-20.71965,58,42,0,-16
-41.98387,-20.71965,61,35,0,-26
-41.98118,-20.71965,56,38,0,-18
-41.97826,-20.71965,54,40,0,-14
-41.97556,-20.71965,54,41,0,-13
-41.97286,-20.71965,53,42,11,-11
-41.96994,-20.71965,51,43,5,-8
-42.1005,-20.71944,63,23,0,-40
-42.0978,-20.71944,67,26,5,-41
-42.09511,-20.71944,70,19,0,-51
-42.09219,-20.71944,71,22,5,-49
-42.08949,-20.71944,73,17,0,-56
-42.08657,-20.71944,54,21,0,-33
-42.08387,-20.71944,63,27,5,-36
-42.08118,-20.71944,44,38,0,-6
-42.07825,-20.71944,48,39,0,-9
-42.07556,-20.71944,54,42,5,-12
-42.07286,-20.71944,40,40,0,0
-42.06994,-20.71944,46,40,0,-6
-42.06724,-20.71944,48,38,5,-10
-42.06455,-20.71944,46,34,5,-12
-42.06163,-20.71944,35,35,5,0
-42.05893,-20.71944,42,45,0,3
-42.05601,-20.71944,28,46,5,18
-42.05331,-20.71944,39,46,5,7
-42.05061,-20.71944,35,52,0,17
-42.04769,-20.71944,29,63,0,34
-42.045,-20.71944,37,61,0,24
-42.0423,-20.71944,32,57,0,25
-42.03938,-20.71944,19,52,2,33
-42.03668,-20.71944,19,51,5,32
-42.03399,-20.71944,28,57,5,29
-42.03106,-20.71944,35,58,0,23
-42.02837,-20.71944,32,63,5,31
-42.02545,-20.71944,18,46,5,28
-42.02275,-20.71944,44,49,5,5
-42.02005,-20.71944,47,48,5,1
-42.01713,-20.71944,48,47,5,-1
-42.01444,-20.71944,47,49,0,2
-42.01174,-20.71944,45,45,5,0
-42.00882,-20.71944,51,47,5,-4
-42.00612,-20.71944,53,47,5,-6
-42.00342,-20.71944,55,40,5,-15
-42.0005,-20.71944,57,37,5,-20
-41.99781,-20.71944,55,36,5,-19
-41.99511,-20.71944,53,37,5,-16
-41.99219,-20.71944,67,41,0,-26
-41.98949,-20.71944,63,38,0,-25
-41.98657,-20.71944,58,42,0,-16
-41.98387,-20.71944,60,34,0,-26
-41.98118,-20.71944,56,38,0,-18
-41.97826,-20.71944,60,41,0,-19
-41.97556,-20.71944,54,41,0,-13
-41.97286,-20.71944,53,42,0,-11
-41.96994,-20.71944,51,43,5,-8
-42.1005,-20.71923,63,24,0,-39
-42.0978,-20.71923,67,26,5,-41
-42.09511,-20.71923,70,18,0,-52
-42.09219,-20.71923,71,23,5,-48
-42.08949,-20.71923,72,17,0,-55
-42.08657,-20.71923,54,29,0,-25
-42.08387,-20.71923,61,27,5,-34
-42.08118,-20.71923,49,39,0,-10
-42.07825,-20.71923,47,39,0,-8
-42.07556,-20.71923,54,38,5,-16
-42.07286,-20.71923,36,39,0,3
-42.06994,-20.71923,42,36,0,-6
-42.06724,-20.71923,47,38,5,-9
-42.06455,-20.71923,45,34,5,-11
-42.06163,-20.71923,39,40,5,1
-42.05893,-20.71923,39,43,5,4
-42.05601,-20.71923,31,47,5,16
-42.05331,-20.71923,39,47,5,8
-42.05061,-20.71923,38,61,0,23
-42.04769,-20.71923,30,60,0,30
-42.045,-20.71923,36,62,0,26
-42.0423,-20.71923,30,57,5,27
-42.03938,-20.71923,19,52,2,33
-42.03668,-20.71923,16,51,5,35
-42.03399,-20.71923,27,55,5,28
-42.03106,-20.71923,37,55,0,18
-42.02837,-20.71923,32,58,5,26
-42.02545,-20.71923,17,46,5,29
-42.02275,-20.71923,45,49,5,4
-42.02005,-20.71923,47,48,5,1
-42.01713,-20.71923,47,45,5,-2
-42.01444,-20.71923,47,49,0,2
-42.01174,-20.71923,46,44,5,-2
-42.00882,-20.71923,52,48,5,-4
-42.00612,-20.71923,55,55,5,0
-42.00342,-20.71923,57,40,5,-17
-42.0005,-20.71923,56,37,5,-19
-41.99781,-20.71923,55,36,5,-19
-41.99511,-20.71923,53,37,5,-16
-41.99219,-20.71923,65,42,0,-23
-41.98949,-20.71923,63,38,0,-25
-41.98657,-20.71923,59,42,0,-17
-41.98387,-20.71923,58,34,0,-24
-41.98118,-20.71923,55,38,0,-17
-41.97826,-20.71923,62,40,0,-22
-41.97556,-20.71923,54,41,0,-13
-41.97286,-20.71923,53,43,0,-10
-41.96994,-20.71923,51,37,5,-14
-42.1005,-20.71881,63,24,5,-39
-42.0978,-20.71881,67,26,0,-41
-42.09511,-20.71881,68,17,0,-51
-42.09219,-20.71881,70,20,0,-50
-42.08949,-20.71881,71,29,0,-42
-42.08657,-20.71881,55,32,0,-23
-42.08387,-20.71881,61,31,0,-30
-42.08118,-20.71881,55,39,0,-16
-42.07825,-20.71881,48,38,0,-10
-42.07556,-20.71881,53,40,5,-13
-42.07286,-20.71881,32,41,0,9
-42.06994,-20.71881,38,38,0,0
-42.06724,-20.71881,45,37,5,-8
-42.06455,-20.71881,48,34,5,-14
-42.06163,-20.71881,36,36,5,0
-42.05893,-20.71881,32,43,5,11
-42.05601,-20.71881,35,46,5,11
-42.05331,-20.71881,40,50,0,10
-42.05061,-20.71881,37,64,0,27
-42.04769,-20.71881,30,59,0,29
-42.045,-20.71881,36,64,0,28
-42.0423,-20.71881,29,57,5,28
-42.03938,-20.71881,19,55,11,36
-42.03668,-20.71881,12,50,11,38
-42.03399,-20.71881,27,52,5,25
-42.03106,-20.71881,37,52,5,15
-42.02837,-20.71881,32,55,5,23
-42.02545,-20.71881,18,47,5,29
-42.02275,-20.71881,45,50,5,5
-42.02005,-20.71881,47,48,5,1
-42.01713,-20.71881,48,45,5,-3
-42.01444,-20.71881,47,51,0,4
-42.01174,-20.71881,45,45,5,0
-42.00882,-20.71881,49,49,5,0
-42.00612,-20.71881,55,51,5,-4
-42.00342,-20.71881,58,39,5,-19
-42.0005,-20.71881,57,38,5,-19
-41.99781,-20.71881,55,38,0,-17
-41.99511,-20.71881,53,37,5,-16
-41.99219,-20.71881,65,40,0,-25
-41.98949,-20.71881,64,38,0,-26
-41.98657,-20.71881,60,42,0,-18
-41.98387,-20.71881,58,34,0,-24
-41.98118,-20.71881,55,37,0,-18
-41.97826,-20.71881,59,41,0,-18
-41.97556,-20.71881,53,41,0,-12
-41.97286,-20.71881,53,43,0,-10
-41.96994,-20.71881,51,39,5,-12
-42.1005,-20.7186,63,24,5,-39
-42.0978,-20.7186,67,26,0,-41
-42.09511,-20.7186,68,17,0,-51
-42.09219,-20.7186,70,18,0,-52
-42.08949,-20.7186,71,29,0,-42
-42.08657,-20.7186,56,33,0,-23
-42.08387,-20.7186,64,31,0,-33
-42.08118,-20.7186,60,39,0,-21
-42.07825,-20.7186,49,37,0,-12
-42.07556,-20.7186,54,42,0,-12
-42.07286,-20.7186,30,41,0,11
-42.06994,-20.7186,36,39,0,3
-42.06724,-20.7186,38,37,5,-1
-42.06455,-20.7186,53,33,5,-20
-42.06163,-20.7186,35,34,5,-1
-42.05893,-20.7186,31,44,5,13
-42.05601,-20.7186,35,46,5,11
-42.05331,-20.7186,40,58,0,18
-42.05061,-20.7186,33,72,0,39
-42.04769,-20.7186,30,59,0,29
-42.045,-20.7186,35,61,0,26
-42.0423,-20.7186,27,57,5,30
-42.03938,-20.7186,24,56,5,32
-42.03668,-20.7186,8,49,2,41
-42.03399,-20.7186,27,50,5,23
-42.03106,-20.7186,35,52,5,17
-42.02837,-20.7186,33,57,5,24
-42.02545,-20.7186,21,51,5,30
-42.02275,-20.7186,44,50,5,6
-42.02005,-20.7186,47,47,5,0
-42.01713,-20.7186,48,45,5,-3
-42.01444,-20.7186,47,52,0,5
-42.01174,-20.7186,45,43,0,-2
-42.00882,-20.7186,49,49,5,0
-42.00612,-20.7186,54,46,5,-8
-42.00342,-20.7186,58,39,5,-19
-42.0005,-20.7186,58,37,5,-21
-41.99781,-20.7186,55,38,0,-17
-41.99511,-20.7186,53,37,5,-16
-41.99219,-20.7186,64,38,0,-26
-41.98949,-20.7186,64,38,0,-26
-41.98657,-20.7186,61,42,5,-19
-41.98387,-20.7186,59,33,0,-26
-41.98118,-20.7186,56,37,0,-19
-41.97826,-20.7186,56,41,0,-15
-41.97556,-20.7186,53,41,0,-12
-41.97286,-20.7186,53,43,0,-10
-41.96994,-20.7186,51,44,5,-7
-42.1005,-20.71838,63,24,5,-39
-42.0978,-20.71838,66,28,0,-38
-42.09511,-20.71838,67,28,0,-39
-42.09219,-20.71838,70,26,0,-44
-42.08949,-20.71838,71,29,0,-42
-42.08657,-20.71838,56,34,0,-22
-42.08387,-20.71838,68,32,0,-36
-42.08118,-20.71838,59,38,0,-21
-42.07825,-20.71838,49,37,0,-12
-42.07556,-20.71838,56,42,0,-14
-42.07286,-20.71838,28,41,0,13
-42.06994,-20.71838,35,38,0,3
-42.06724,-20.71838,30,37,5,7
-42.06455,-20.71838,57,33,5,-24
-42.06163,-20.71838,35,36,5,1
-42.05893,-20.71838,36,45,5,9
-42.05601,-20.71838,37,44,5,7
-42.05331,-20.71838,40,53,0,13
-42.05061,-20.71838,31,68,0,37
-42.04769,-20.71838,31,62,0,31
-42.045,-20.71838,33,57,5,24
-42.0423,-20.71838,26,57,5,31
-42.03938,-20.71838,20,56,5,36
-42.03668,-20.71838,3,49,11,46
-42.03399,-20.71838,26,49,5,23
-42.03106,-20.71838,36,52,5,16
-42.02837,-20.71838,34,53,5,19
-42.02545,-20.71838,28,51,5,23
-42.02275,-20.71838,45,49,5,4
-42.02005,-20.71838,47,47,5,0
-42.01713,-20.71838,48,47,5,-1
-42.01444,-20.71838,47,49,0,2
-42.01174,-20.71838,45,49,0,4
-42.00882,-20.71838,51,49,5,-2
-42.00612,-20.71838,54,46,5,-8
-42.00342,-20.71838,59,39,5,-20
-42.0005,-20.71838,59,37,5,-22
-41.99781,-20.71838,55,37,5,-18
-41.99511,-20.71838,53,37,5,-16
-41.99219,-20.71838,66,40,0,-26
-41.98949,-20.71838,65,37,0,-28
-41.98657,-20.71838,61,42,5,-19
-41.98387,-20.71838,59,32,0,-27
-41.98118,-20.71838,57,37,0,-20
-41.97826,-20.71838,54,41,0,-13
-41.97556,-20.71838,53,41,0,-12
-41.97286,-20.71838,52,43,0,-9
-41.96994,-20.71838,51,44,5,-7
-42.1005,-20.71796,63,25,5,-38
-42.0978,-20.71796,66,30,0,-36
-42.09511,-20.71796,68,28,0,-40
-42.09219,-20.71796,71,30,5,-41
-42.08949,-20.71796,72,30,0,-42
-42.08657,-20.71796,57,34,0,-23
-42.08387,-20.71796,69,34,0,-35
-42.08118,-20.71796,57,37,0,-20
-42.07825,-20.71796,48,36,0,-12
-42.07556,-20.71796,56,41,0,-15
-42.07286,-20.71796,26,41,0,15
-42.06994,-20.71796,27,37,0,10
-42.06724,-20.71796,29,35,0,6
-42.06455,-20.71796,51,32,5,-19
-42.06163,-20.71796,34,37,5,3
-42.05893,-20.71796,40,45,5,5
-42.05601,-20.71796,37,43,5,6
-42.05331,-20.71796,40,53,0,13
-42.05061,-20.71796,31,62,0,31
-42.04769,-20.71796,32,63,0,31
-42.045,-20.71796,33,57,5,24
-42.0423,-20.71796,22,57,5,35
-42.03938,-20.71796,23,53,2,30
-42.03668,-20.71796,14,47,6,33
-42.03399,-20.71796,24,49,5,25
-42.03106,-20.71796,32,51,5,19
-42.02837,-20.71796,34,55,5,21
-42.02545,-20.71796,28,51,5,23
-42.02275,-20.71796,45,49,5,4
-42.02005,-20.71796,46,46,5,0
-42.01713,-20.71796,48,49,5,1
-42.01444,-20.71796,47,52,0,5
-42.01174,-20.71796,45,47,5,2
-42.00882,-20.71796,51,49,5,-2
-42.00612,-20.71796,55,43,5,-12
-42.00342,-20.71796,59,42,5,-17
-42.0005,-20.71796,58,38,5,-20
-41.99781,-20.71796,55,35,5,-20
-41.99511,-20.71796,53,38,5,-15
-41.99219,-20.71796,63,41,0,-22
-41.98949,-20.71796,66,37,0,-29
-41.98657,-20.71796,61,42,5,-19
-41.98387,-20.71796,59,32,0,-27
-41.98118,-20.71796,57,37,0,-20
-41.97826,-20.71796,54,41,0,-13
-41.97556,-20.71796,53,41,0,-12
-41.97286,-20.71796,52,43,0,-9
-41.96994,-20.71796,51,43,5,-8
-42.10297,-20.71775,67,21,0,-46
-42.10275,-20.71775,67,20,0,-47
-42.10252,-20.71775,67,16,0,-51
-42.1023,-20.71775,68,18,0,-50
-42.10185,-20.71775,69,21,0,-48
-42.10163,-20.71775,67,23,0,-44
-42.1014,-20.71775,67,24,0,-43
-42.10118,-20.71775,65,25,0,-40
-42.10073,-20.71775,63,26,0,-37
-42.1005,-20.71775,63,26,5,-37
-42.10028,-20.71775,63,24,5,-39
-42.10005,-20.71775,63,25,5,-38
-42.09983,-20.71775,63,27,5,-36
-42.09938,-20.71775,63,28,0,-35
-42.09915,-20.71775,64,29,0,-35
-42.09893,-20.71775,64,29,0,-35
-42.0987,-20.71775,65,29,0,-36
-42.09825,-20.71775,65,30,0,-35
-42.09803,-20.71775,66,30,0,-36
-42.0978,-20.71775,66,30,0,-36
-42.09758,-20.71775,67,30,0,-37
-42.09713,-20.71775,67,30,0,-37
-42.09691,-20.71775,67,31,0,-36
-42.09668,-20.71775,68,30,0,-38
-42.09646,-20.71775,66,33,0,-33
-42.09601,-20.71775,66,31,0,-35
-42.09578,-20.71775,66,30,0,-36
-42.09556,-20.71775,66,24,0,-42
-42.09533,-20.71775,67,21,0,-46
-42.09511,-20.71775,67,20,0,-47
-42.09466,-20.71775,68,19,0,-49
-42.09443,-20.71775,68,24,5,-44
-42.09421,-20.71775,68,25,5,-43
-42.09398,-20.71775,68,25,5,-43
-42.09354,-20.71775,69,26,5,-43
-42.09331,-20.71775,69,26,5,-43
-42.09309,-20.71775,71,27,5,-44
-42.09286,-20.71775,71,27,5,-44
-42.09241,-20.71775,70,27,5,-43
-42.09219,-20.71775,70,30,5,-40
-42.09196,-20.71775,69,31,5,-38
-42.09174,-20.71775,69,32,0,-37
-42.09129,-20.71775,70,32,0,-38
-42.09106,-20.71775,69,32,0,-37
-42.09084,-20.71775,69,32,0,-37
-42.09061,-20.71775,69,32,0,-37
-42.09039,-20.71775,69,32,0,-37
-42.08994,-20.71775,69,34,0,-35
-42.08972,-20.71775,69,34,0,-35
-42.08949,-20.71775,70,31,0,-39
-42.08927,-20.71775,70,33,0,-37
-42.08882,-20.71775,74,34,0,-40
-42.08859,-20.71775,74,35,0,-39
-42.08837,-20.71775,73,33,0,-40
-42.08814,-20.71775,73,33,0,-40
-42.08769,-20.71775,71,31,0,-40
-42.08747,-20.71775,67,31,0,-36
-42.08724,-20.71775,65,33,0,-32
-42.08702,-20.71775,59,33,0,-26
-42.08657,-20.71775,58,31,0,-27
-42.08634,-20.71775,59,31,0,-28
-42.08612,-20.71775,59,34,0,-25
-42.08589,-20.71775,62,33,0,-29
-42.08545,-20.71775,63,35,0,-28
-42.08522,-20.71775,63,35,0,-28
-42.085,-20.71775,63,35,0,-28
-42.08477,-20.71775,64,35,0,-29
-42.08455,-20.71775,66,35,0,-31
-42.0841,-20.71775,67,35,0,-32
-42.08387,-20.71775,69,34,0,-35
-42.08365,-20.71775,61,34,0,-27
-42.08342,-20.71775,63,34,0,-29
-42.08297,-20.71775,59,32,0,-27
-42.08275,-20.71775,57,34,0,-23
-42.08252,-20.71775,57,34,0,-23
-42.0823,-20.71775,58,37,0,-21
-42.08185,-20.71775,58,37,0,-21
-42.08163,-20.71775,59,37,0,-22
-42.0814,-20.71775,57,37,0,-20
-42.08118,-20.71775,56,37,0,-19
-42.08073,-20.71775,56,37,0,-19
-42.0805,-20.71775,55,37,0,-18
-42.08028,-20.71775,56,37,0,-19
-42.08005,-20.71775,56,37,0,-19
-42.07983,-20.71775,57,37,0,-20
-42.07938,-20.71775,57,36,0,-21
-42.07915,-20.71775,50,36,0,-14
-42.07893,-20.71775,48,36,0,-12
-42.0787,-20.71775,47,37,0,-10
-42.07825,-20.71775,47,36,0,-11
-42.07803,-20.71775,48,38,0,-10
-42.07781,-20.71775,50,38,0,-12
-42.07758,-20.71775,51,38,0,-13
-42.07713,-20.71775,52,38,0,-14
-42.07691,-20.71775,52,38,0,-14
-42.07668,-20.71775,53,38,0,-15
-42.07646,-20.71775,54,38,0,-16
-42.07601,-20.71775,54,39,0,-15
-42.07578,-20.71775,55,39,0,-16
-42.07556,-20.71775,55,40,0,-15
-42.07533,-20.71775,53,41,0,-12
-42.07511,-20.71775,53,41,0,-12
-42.07466,-20.71775,50,41,5,-9
-42.07443,-20.71775,48,41,5,-7
-42.07421,-20.71775,47,41,5,-6
-42.07399,-20.71775,40,41,5,1
-42.07354,-20.71775,30,41,0,11
-42.07331,-20.71775,25,41,0,16
-42.07309,-20.71775,29,41,0,12
-42.07286,-20.71775,25,41,0,16
-42.07241,-20.71775,25,41,0,16
-42.07219,-20.71775,28,40,0,12
-42.07196,-20.71775,27,39,0,12
-42.07174,-20.71775,33,39,0,6
-42.07129,-20.71775,34,39,0,5
-42.07106,-20.71775,30,39,0,9
-42.07084,-20.71775,31,40,0,9
-42.07061,-20.71775,28,41,0,13
-42.07039,-20.71775,25,41,0,16
-42.06994,-20.71775,28,39,0,11
-42.06972,-20.71775,26,37,0,11
-42.06949,-20.71775,26,34,0,8
-42.06927,-20.71775,32,34,0,2
-42.06882,-20.71775,35,36,0,1
-42.06859,-20.71775,34,33,0,-1
-42.06837,-20.71775,35,36,0,1
-42.06814,-20.71775,29,32,0,3
-42.06769,-20.71775,36,36,0,0
-42.06747,-20.71775,29,33,0,4
-42.06724,-20.71775,29,35,5,6
-42.06702,-20.71775,37,36,5,-1
-42.06657,-20.71775,31,31,5,0
-42.06634,-20.71775,39,36,5,-3
-42.06612,-20.71775,40,36,5,-4
-42.0659,-20.71775,42,35,5,-7
-42.06545,-20.71775,46,32,5,-14
-42.06522,-20.71775,47,32,5,-15
-42.065,-20.71775,47,32,5,-15
-42.06477,-20.71775,49,32,5,-17
-42.06455,-20.71775,50,32,5,-18
-42.0641,-20.71775,49,32,5,-17
-42.06387,-20.71775,49,32,5,-17
-42.06365,-20.71775,50,33,5,-17
-42.06342,-20.71775,50,34,5,-16
-42.06297,-20.71775,49,33,5,-16
-42.06275,-20.71775,50,35,5,-15
-42.06252,-20.71775,50,38,5,-12
-42.0623,-20.71775,51,37,5,-14
-42.06185,-20.71775,46,39,5,-7
-42.06163,-20.71775,35,37,5,2
-42.0614,-20.71775,32,38,5,6
-42.06118,-20.71775,34,39,5,5
-42.06073,-20.71775,36,39,5,3
-42.0605,-20.71775,30,40,5,10
-42.06028,-20.71775,36,40,5,4
-42.06005,-20.71775,36,40,5,4
-42.05983,-20.71775,31,41,5,10
-42.05938,-20.71775,36,42,5,6
-42.05915,-20.71775,33,43,5,10
-42.05893,-20.71775,41,43,5,2
-42.0587,-20.71775,40,44,5,4
-42.05826,-20.71775,40,44,5,4
-42.05803,-20.71775,36,44,5,8
-42.05781,-20.71775,37,44,5,7
-42.05758,-20.71775,37,44,5,7
-42.05713,-20.71775,41,44,5,3
-42.05691,-20.71775,37,44,5,7
-42.05668,-20.71775,38,44,5,6
-42.05646,-20.71775,38,43,5,5
-42.05601,-20.71775,38,43,5,5
-42.05578,-20.71775,38,44,5,6
-42.05556,-20.71775,38,44,5,6
-42.05533,-20.71775,39,43,5,4
-42.05511,-20.71775,39,44,5,5
-42.05466,-20.71775,39,45,0,6
-42.05443,-20.71775,40,47,0,7
-42.05421,-20.71775,40,47,0,7
-42.05399,-20.71775,41,46,0,5
-42.05354,-20.71775,40,51,0,11
-42.05331,-20.71775,40,55,0,15
-42.05309,-20.71775,40,60,0,20
-42.05286,-20.71775,42,51,0,9
-42.05241,-20.71775,43,60,0,17
-42.05219,-20.71775,44,62,0,18
-42.05196,-20.71775,41,66,0,25
-42.05174,-20.71775,34,62,0,28
-42.05129,-20.71775,28,69,0,41
-42.05106,-20.71775,32,61,0,29
-42.05084,-20.71775,27,63,0,36
-42.05061,-20.71775,31,62,0,31
-42.05039,-20.71775,32,66,0,34
-42.04994,-20.71775,26,65,0,39
-42.04972,-20.71775,32,64,0,32
-42.04949,-20.71775,31,56,0,25
-42.04927,-20.71775,29,56,0,27
-42.04882,-20.71775,31,59,0,28
-42.04859,-20.71775,30,56,0,26
-42.04837,-20.71775,30,56,0,26
-42.04814,-20.71775,30,63,0,33
-42.04769,-20.71775,31,64,0,33
-42.04747,-20.71775,32,63,0,31
-42.04724,-20.71775,33,63,0,30
-42.04702,-20.71775,32,61,0,29
-42.04657,-20.71775,33,58,0,25
-42.04635,-20.71775,34,56,5,22
-42.04612,-20.71775,33,56,5,23
-42.0459,-20.71775,32,56,5,24
-42.04545,-20.71775,32,55,5,23
-42.04522,-20.71775,32,56,5,24
-42.045,-20.71775,28,57,5,29
-42.04477,-20.71775,28,57,5,29
-42.04455,-20.71775,27,55,5,28
-42.0441,-20.71775,26,55,5,29
-42.04387,-20.71775,27,55,5,28
-42.04365,-20.71775,25,56,0,31
-42.04342,-20.71775,26,56,5,30
-42.04297,-20.71775,24,56,5,32
-42.04275,-20.71775,25,56,5,31
-42.04253,-20.71775,22,57,5,35
-42.0423,-20.71775,20,57,5,37
-42.04185,-20.71775,15,58,5,43
-42.04163,-20.71775,15,58,5,43
-42.0414,-20.71775,14,58,5,44
-42.04118,-20.71775,13,58,5,45
-42.04073,-20.71775,12,58,5,46
-42.0405,-20.71775,12,54,5,42
-42.04028,-20.71775,15,54,5,39
-42.04005,-20.71775,21,53,5,32
-42.03983,-20.71775,27,53,5,26
-42.03938,-20.71775,29,53,2,24
-42.03915,-20.71775,27,53,2,26
-42.03893,-20.71775,21,51,2,30
-42.0387,-20.71775,15,53,2,38
-42.03826,-20.71775,15,42,5,27
-42.03803,-20.71775,15,41,5,26
-42.03781,-20.71775,15,42,6,27
-42.03758,-20.71775,14,42,5,28
-42.03713,-20.71775,15,42,5,27
-42.03691,-20.71775,15,47,6,32
-42.03668,-20.71775,14,48,5,34
-42.03646,-20.71775,14,47,6,33
-42.03601,-20.71775,13,51,11,38
-42.03578,-20.71775,17,49,11,32
-42.03556,-20.71775,20,49,5,29
-42.03533,-20.71775,21,47,5,26
-42.03511,-20.71775,21,47,5,26
-42.03466,-20.71775,22,48,5,26
-42.03444,-20.71775,23,49,5,26
-42.03421,-20.71775,22,49,5,27
-42.03399,-20.71775,23,49,5,26
-42.03354,-20.71775,24,52,5,28
-42.03331,-20.71775,25,53,5,28
-42.03309,-20.71775,26,51,5,25
-42.03286,-20.71775,26,51,5,25
-42.03241,-20.71775,28,55,0,27
-42.03219,-20.71775,33,55,0,22
-42.03196,-20.71775,33,54,0,21
-42.03174,-20.71775,32,55,0,23
-42.03129,-20.71775,31,52,0,21
-42.03106,-20.71775,32,52,5,20
-42.03084,-20.71775,33,50,5,17
-42.03062,-20.71775,34,51,5,17
-42.03017,-20.71775,34,50,5,16
-42.02994,-20.71775,34,50,5,16
-42.02972,-20.71775,35,51,5,16
-42.02949,-20.71775,35,52,5,17
-42.02927,-20.71775,36,52,5,16
-42.02882,-20.71775,36,55,5,19
-42.02859,-20.71775,37,55,5,18
-42.02837,-20.71775,35,55,5,20
-42.02814,-20.71775,35,55,5,20
-42.02769,-20.71775,35,54,5,19
-42.02747,-20.71775,35,57,5,22
-42.02724,-20.71775,35,55,5,20
-42.02702,-20.71775,36,55,5,19
-42.02657,-20.71775,35,53,5,18
-42.02635,-20.71775,35,53,5,18
-42.02612,-20.71775,35,52,5,17
-42.0259,-20.71775,32,52,5,20
-42.02545,-20.71775,30,51,5,21
-42.02522,-20.71775,28,49,5,21
-42.025,-20.71775,26,49,5,23
-42.02477,-20.71775,29,47,5,18
-42.02455,-20.71775,35,48,5,13
-42.0241,-20.71775,38,47,5,9
-42.02387,-20.71775,39,46,5,7
-42.02365,-20.71775,41,46,5,5
-42.02342,-20.71775,43,46,5,3
-42.02297,-20.71775,43,49,5,6
-42.02275,-20.71775,44,49,5,5
-42.02253,-20.71775,45,51,5,6
-42.0223,-20.71775,44,51,5,7
-42.02185,-20.71775,44,49,5,5
-42.02163,-20.71775,44,48,5,4
-42.0214,-20.71775,44,48,5,4
-42.02118,-20.71775,45,47,5,2
-42.02073,-20.71775,45,46,5,1
-42.0205,-20.71775,45,45,5,0
-42.02028,-20.71775,45,45,5,0
-42.02005,-20.71775,45,45,5,0
-42.01983,-20.71775,45,45,5,0
-42.01938,-20.71775,46,46,5,0
-42.01915,-20.71775,52,47,5,-5
-42.01893,-20.71775,50,46,5,-4
-42.01871,-20.71775,51,48,5,-3
-42.01826,-20.71775,52,46,5,-6
-42.01803,-20.71775,52,47,5,-5
-42.01781,-20.71775,50,48,5,-2
-42.01758,-20.71775,49,48,5,-1
-42.01713,-20.71775,49,49,5,0
-42.01691,-20.71775,48,47,5,-1
-42.01668,-20.71775,48,46,5,-2
-42.01646,-20.71775,48,46,5,-2
-42.01601,-20.71775,48,49,0,1
-42.01578,-20.71775,48,49,0,1
-42.01556,-20.71775,48,51,0,3
-42.01533,-20.71775,48,52,0,4
-42.01511,-20.71775,48,51,0,3
-42.01466,-20.71775,47,50,0,3
-42.01444,-20.71775,47,52,0,5
-42.01421,-20.71775,47,52,0,5
-42.01399,-20.71775,47,51,0,4
-42.01354,-20.71775,47,52,0,5
-42.01331,-20.71775,47,52,0,5
-42.01309,-20.71775,46,52,0,6
-42.01286,-20.71775,46,49,0,3
-42.01241,-20.71775,46,51,0,5
-42.01219,-20.71775,46,51,0,5
-42.01196,-20.71775,46,47,0,1
-42.01174,-20.71775,46,47,5,1
-42.01129,-20.71775,45,44,5,-1
-42.01106,-20.71775,44,43,5,-1
-42.01084,-20.71775,43,43,5,0
-42.01062,-20.71775,42,43,5,1
-42.01017,-20.71775,41,44,5,3
-42.00994,-20.71775,41,45,5,4
-42.00972,-20.71775,41,45,5,4
-42.00949,-20.71775,52,53,5,1
-42.00927,-20.71775,52,55,5,3
-42.00882,-20.71775,53,48,5,-5
-42.00859,-20.71775,53,46,5,-7
-42.00837,-20.71775,53,45,5,-8
-42.00814,-20.71775,56,45,5,-11
-42.00769,-20.71775,57,45,5,-12
-42.00747,-20.71775,55,44,5,-11
-42.00724,-20.71775,56,44,5,-12
-42.00702,-20.71775,55,44,5,-11
-42.00657,-20.71775,55,43,5,-12
-42.00635,-20.71775,56,43,5,-13
-42.00612,-20.71775,55,43,5,-12
-42.0059,-20.71775,56,42,5,-14
-42.00545,-20.71775,56,44,5,-12
-42.00522,-20.71775,55,42,5,-13
-42.005,-20.71775,55,42,5,-13
-42.00477,-20.71775,55,44,5,-11
-42.00455,-20.71775,54,46,5,-8
-42.0041,-20.71775,54,46,5,-8
-42.00387,-20.71775,54,44,5,-10
-42.00365,-20.71775,54,44,5,-10
-42.00342,-20.71775,55,42,5,-13
-42.00298,-20.71775,54,41,5,-13
-42.00275,-20.71775,60,41,5,-19
-42.00253,-20.71775,63,40,5,-23
-42.0023,-20.71775,61,40,5,-21
-42.00185,-20.71775,59,40,5,-19
-42.00163,-20.71775,59,40,5,-19
-42.0014,-20.71775,59,39,5,-20
-42.00118,-20.71775,60,38,5,-22
-42.00073,-20.71775,58,38,5,-20
-42.0005,-20.71775,58,38,5,-20
-42.00028,-20.71775,59,38,5,-21
-42.00005,-20.71775,59,38,5,-21
-41.99983,-20.71775,59,40,5,-19
-41.99938,-20.71775,60,38,5,-22
-41.99916,-20.71775,59,37,5,-22
-41.99893,-20.71775,59,37,5,-22
-41.99871,-20.71775,59,37,5,-22
-41.99826,-20.71775,59,36,5,-23
-41.99803,-20.71775,58,36,5,-22
-41.99781,-20.71775,56,35,5,-21
-41.99758,-20.71775,56,35,5,-21
-41.99713,-20.71775,55,37,5,-18
-41.99691,-20.71775,55,36,5,-19
-41.99668,-20.71775,55,36,5,-19
-41.99646,-20.71775,54,37,5,-17
-41.99601,-20.71775,54,38,5,-16
-41.99578,-20.71775,54,37,5,-17
-41.99556,-20.71775,54,37,5,-17
-41.99533,-20.71775,54,37,5,-17
-41.99511,-20.71775,54,39,5,-15
-41.99466,-20.71775,53,39,5,-14
-41.99444,-20.71775,52,39,5,-13
-41.99421,-20.71775,51,40,5,-11
-41.99399,-20.71775,51,40,5,-11
-41.99354,-20.71775,51,42,0,-9
-41.99331,-20.71775,51,42,0,-9
-41.99309,-20.71775,51,42,0,-9
-41.99286,-20.71775,51,42,0,-9
-41.99241,-20.71775,57,41,0,-16
-41.99219,-20.71775,62,39,0,-23
-41.99196,-20.71775,65,39,0,-26
-41.99174,-20.71775,63,38,0,-25
-41.99129,-20.71775,66,39,0,-27
-41.99107,-20.71775,65,39,0,-26
-41.99084,-20.71775,65,39,0,-26
-41.99062,-20.71775,64,39,0,-25
-41.99017,-20.71775,64,39,0,-25
-41.98994,-20.71775,64,37,0,-27
-41.98972,-20.71775,66,37,0,-29
-41.98949,-20.71775,65,37,0,-28
-41.98927,-20.71775,66,38,0,-28
-41.98882,-20.71775,64,39,0,-25
-41.98859,-20.71775,63,39,0,-24
-41.98837,-20.71775,62,40,0,-22
-41.98814,-20.71775,62,40,0,-22
-41.98769,-20.71775,62,41,5,-21
-41.98747,-20.71775,61,41,5,-20
-41.98725,-20.71775,61,41,5,-20
-41.98702,-20.71775,61,41,5,-20
-41.98657,-20.71775,61,40,5,-21
-41.98635,-20.71775,61,38,5,-23
-41.98612,-20.71775,61,36,5,-25
-41.9859,-20.71775,60,36,5,-24
-41.98545,-20.71775,60,35,5,-25
-41.98522,-20.71775,60,33,5,-27
-41.985,-20.71775,60,33,5,-27
-41.98477,-20.71775,60,32,5,-28
-41.98455,-20.71775,60,32,5,-28
-41.9841,-20.71775,60,32,5,-28
-41.98387,-20.71775,60,34,0,-26
-41.98365,-20.71775,60,34,0,-26
-41.98343,-20.71775,59,34,0,-25
-41.98298,-20.71775,59,34,0,-25
-41.98275,-20.71775,59,34,0,-25
-41.98253,-20.71775,59,35,0,-24
-41.9823,-20.71775,59,36,0,-23
-41.98185,-20.71775,59,37,0,-22
-41.98163,-20.71775,59,37,0,-22
-41.9814,-20.71775,58,37,0,-21
-41.98118,-20.71775,58,38,0,-20
-41.98073,-20.71775,58,38,0,-20
-41.9805,-20.71775,58,39,0,-19
-41.98028,-20.71775,57,39,0,-18
-41.98005,-20.71775,57,39,0,-18
-41.97983,-20.71775,57,40,0,-17
-41.97938,-20.71775,56,40,0,-16
-41.97916,-20.71775,56,41,11,-15
-41.97893,-20.71775,56,41,11,-15
-41.97871,-20.71775,56,41,0,-15
-41.97826,-20.71775,56,41,0,-15
-41.97803,-20.71775,55,41,0,-14
-41.97781,-20.71775,55,41,0,-14
-41.97758,-20.71775,54,41,0,-13
-41.97713,-20.71775,54,41,0,-13
-41.97691,-20.71775,54,41,0,-13
-41.97668,-20.71775,54,41,0,-13
-41.97646,-20.71775,53,41,0,-12
-41.97601,-20.71775,53,41,0,-12
-41.97578,-20.71775,53,41,0,-12
-41.97556,-20.71775,53,41,0,-12
-41.97534,-20.71775,53,41,0,-12
-41.97511,-20.71775,53,41,0,-12
-41.97466,-20.71775,53,42,0,-11
-41.97444,-20.71775,53,42,0,-11
-41.97421,-20.71775,53,42,0,-11
-41.97399,-20.71775,53,42,0,-11
-41.97354,-20.71775,53,42,0,-11
-41.97331,-20.71775,53,43,0,-10
-41.97309,-20.71775,52,43,11,-9
-41.97286,-20.71775,52,43,0,-9
-41.97241,-20.71775,52,43,0,-9
-41.97219,-20.71775,52,43,0,-9
-41.97196,-20.71775,52,43,0,-9
-41.97174,-20.71775,52,43,0,-9
-41.97129,-20.71775,51,37,0,-14
-41.97107,-20.71775,51,36,0,-15
-41.97084,-20.71775,51,36,5,-15
-41.97062,-20.71775,51,36,5,-15
-41.97017,-20.71775,51,36,5,-15
-41.96994,-20.71775,51,43,5,-8
-41.96972,-20.71775,51,34,5,-17
-41.96949,-20.71775,51,33,5,-18
-41.96927,-20.71775,51,31,5,-20
-42.1005,-20.71754,63,25,5,-38
-42.0978,-20.71754,65,30,0,-35
-42.09511,-20.71754,67,25,0,-42
-42.09219,-20.71754,71,31,5,-40
-42.08949,-20.71754,72,34,0,-38
-42.08657,-20.71754,60,31,0,-29
-42.08387,-20.71754,64,34,0,-30
-42.08118,-20.71754,57,37,0,-20
-42.07825,-20.71754,47,38,0,-9
-42.07556,-20.71754,55,39,5,-16
-42.07286,-20.71754,24,41,0,17
-42.06994,-20.71754,27,40,0,13
-42.06724,-20.71754,34,35,5,1
-42.06455,-20.71754,49,32,5,-17
-42.06163,-20.71754,37,37,5,0
-42.05893,-20.71754,37,42,5,5
-42.05601,-20.71754,39,42,5,3
-42.05331,-20.71754,40,57,0,17
-42.05061,-20.71754,32,67,0,35
-42.04769,-20.71754,30,63,0,33
-42.045,-20.71754,27,56,5,29
-42.0423,-20.71754,17,57,5,40
-42.03938,-20.71754,24,52,2,28
-42.03668,-20.71754,19,48,6,29
-42.03399,-20.71754,22,50,5,28
-42.03106,-20.71754,31,50,5,19
-42.02837,-20.71754,36,55,5,19
-42.02545,-20.71754,31,50,5,19
-42.02275,-20.71754,45,49,5,4
-42.02005,-20.71754,45,45,5,0
-42.01713,-20.71754,49,49,5,0
-42.01444,-20.71754,47,50,0,3
-42.01174,-20.71754,46,47,5,1
-42.00882,-20.71754,55,47,5,-8
-42.00612,-20.71754,56,42,5,-14
-42.00342,-20.71754,54,43,5,-11
-42.0005,-20.71754,58,40,5,-18
-41.99781,-20.71754,57,35,5,-22
-41.99511,-20.71754,54,39,5,-15
-41.99219,-20.71754,58,41,0,-17
-41.98949,-20.71754,65,37,0,-28
-41.98657,-20.71754,61,37,5,-24
-41.98387,-20.71754,60,34,0,-26
-41.98118,-20.71754,59,38,0,-21
-41.97826,-20.71754,57,41,0,-16
-41.97556,-20.71754,53,41,0,-12
-41.97286,-20.71754,52,43,0,-9
-41.96994,-20.71754,51,34,5,-17
-42.1005,-20.71733,63,27,0,-36
-42.0978,-20.71733,65,31,0,-34
-42.09511,-20.71733,71,30,0,-41
-42.09219,-20.71733,72,32,5,-40
-42.08949,-20.71733,66,35,0,-31
-42.08657,-20.71733,59,33,0,-26
-42.08387,-20.71733,67,34,5,-33
-42.08118,-20.71733,57,38,0,-19
-42.07825,-20.71733,47,36,0,-11
-42.07556,-20.71733,55,35,5,-20
-42.07286,-20.71733,23,41,0,18
-42.06994,-20.71733,34,41,0,7
-42.06724,-20.71733,40,36,5,-4
-42.06455,-20.71733,48,32,5,-16
-42.06163,-20.71733,41,39,5,-2
-42.05893,-20.71733,35,41,5,6
-42.05601,-20.71733,39,40,5,1
-42.05331,-20.71733,41,57,0,16
-42.05061,-20.71733,32,67,0,35
-42.04769,-20.71733,27,65,0,38
-42.045,-20.71733,23,55,5,32
-42.0423,-20.71733,10,57,5,47
-42.03938,-20.71733,20,51,2,31
-42.03668,-20.71733,25,47,6,22
-42.03399,-20.71733,21,49,5,28
-42.03106,-20.71733,36,50,0,14
-42.02837,-20.71733,35,52,5,17
-42.02545,-20.71733,33,50,5,17
-42.02275,-20.71733,43,50,5,7
-42.02005,-20.71733,49,45,5,-4
-42.01713,-20.71733,49,47,5,-2
-42.01444,-20.71733,48,51,0,3
-42.01174,-20.71733,46,46,5,0
-42.00882,-20.71733,56,47,5,-9
-42.00612,-20.71733,56,42,5,-14
-42.00342,-20.71733,55,43,5,-12
-42.0005,-20.71733,58,40,5,-18
-41.99781,-20.71733,57,35,5,-22
-41.99511,-20.71733,54,39,5,-15
-41.99219,-20.71733,54,40,0,-14
-41.98949,-20.71733,65,36,0,-29
-41.98657,-20.71733,61,37,5,-24
-41.98387,-20.71733,60,37,0,-23
-41.98118,-20.71733,58,39,0,-19
-41.97826,-20.71733,57,41,0,-16
-41.97556,-20.71733,53,41,0,-12
-41.97286,-20.71733,52,43,11,-9
-41.96994,-20.71733,55,43,5,-12
-42.1005,-20.7169,63,28,0,-35
-42.0978,-20.7169,64,30,0,-34
-42.09511,-20.7169,70,33,0,-37
-42.09219,-20.7169,71,36,0,-35
-42.08949,-20.7169,61,36,0,-25
-42.08657,-20.7169,59,35,5,-24
-42.08387,-20.7169,71,32,5,-39
-42.08118,-20.7169,57,38,0,-19
-42.07825,-20.7169,47,38,0,-9
-42.07556,-20.7169,54,33,5,-21
-42.07286,-20.7169,24,41,0,17
-42.06994,-20.7169,36,41,0,5
-42.06724,-20.7169,44,36,5,-8
-42.06455,-20.7169,47,33,5,-14
-42.06163,-20.7169,44,39,5,-5
-42.05893,-20.7169,35,40,5,5
-42.05601,-20.7169,39,40,5,1
-42.05331,-20.7169,43,59,0,16
-42.05061,-20.7169,32,67,0,35
-42.04769,-20.7169,25,57,0,32
-42.045,-20.7169,18,55,5,37
-42.0423,-20.7169,15,59,5,44
-42.03938,-20.7169,16,51,2,35
-42.03668,-20.7169,27,45,6,18
-42.03399,-20.7169,21,49,5,28
-42.03106,-20.7169,36,52,0,16
-42.02837,-20.7169,35,52,5,17
-42.02545,-20.7169,34,49,5,15
-42.02275,-20.7169,42,51,5,9
-42.02005,-20.7169,48,45,5,-3
-42.01713,-20.7169,50,47,5,-3
-42.01444,-20.7169,48,52,0,4
-42.01174,-20.7169,46,45,5,-1
-42.00882,-20.7169,55,45,5,-10
-42.00612,-20.7169,57,41,5,-16
-42.00342,-20.7169,55,45,5,-10
-42.0005,-20.7169,58,41,5,-17
-41.99781,-20.7169,56,36,5,-20
-41.99511,-20.7169,54,39,5,-15
-41.99219,-20.7169,57,38,0,-19
-41.98949,-20.7169,65,39,0,-26
-41.98657,-20.7169,61,38,5,-23
-41.98387,-20.7169,59,39,0,-20
-41.98118,-20.7169,58,40,0,-18
-41.97826,-20.7169,57,41,0,-16
-41.97556,-20.7169,53,41,0,-12
-41.97286,-20.7169,52,42,0,-10
-41.96994,-20.7169,51,42,5,-9
-42.1005,-20.71669,64,28,0,-36
-42.0978,-20.71669,66,34,0,-32
-42.09511,-20.71669,76,35,0,-41
-42.09219,-20.71669,70,37,0,-33
-42.08949,-20.71669,56,36,0,-20
-42.08657,-20.71669,58,36,5,-22
-42.08387,-20.71669,70,31,5,-39
-42.08118,-20.71669,56,39,0,-17
-42.07825,-20.71669,48,38,0,-10
-42.07556,-20.71669,54,34,5,-20
-42.07286,-20.71669,25,41,0,16
-42.06994,-20.71669,38,42,0,4
-42.06724,-20.71669,45,36,5,-9
-42.06455,-20.71669,48,33,5,-15
-42.06163,-20.71669,44,39,5,-5
-42.05893,-20.71669,34,40,5,6
-42.05601,-20.71669,39,42,5,3
-42.05331,-20.71669,42,61,0,19
-42.05061,-20.71669,32,67,0,35
-42.04769,-20.71669,20,56,5,36
-42.045,-20.71669,19,54,5,35
-42.0423,-20.71669,16,58,5,42
-42.03938,-20.71669,17,51,2,34
-42.03668,-20.71669,30,45,6,15
-42.03399,-20.71669,21,50,5,29
-42.03106,-20.71669,30,52,0,22
-42.02837,-20.71669,35,52,5,17
-42.02545,-20.71669,33,48,5,15
-42.02275,-20.71669,41,49,5,8
-42.02005,-20.71669,48,45,5,-3
-42.01713,-20.71669,50,47,5,-3
-42.01444,-20.71669,48,52,0,4
-42.01174,-20.71669,47,45,5,-2
-42.00882,-20.71669,55,46,5,-9
-42.00612,-20.71669,57,41,5,-16
-42.00342,-20.71669,56,45,5,-11
-42.0005,-20.71669,58,43,5,-15
-41.99781,-20.71669,56,37,5,-19
-41.99511,-20.71669,55,38,5,-17
-41.99219,-20.71669,59,38,0,-21
-41.98949,-20.71669,65,39,0,-26
-41.98657,-20.71669,60,38,5,-22
-41.98387,-20.71669,59,39,0,-20
-41.98118,-20.71669,59,40,0,-19
-41.97826,-20.71669,57,41,0,-16
-41.97556,-20.71669,53,41,0,-12
-41.97286,-20.71669,52,42,0,-10
-41.96994,-20.71669,51,39,5,-12
-42.1005,-20.71648,62,31,0,-31
-42.0978,-20.71648,67,34,0,-33
-42.09511,-20.71648,79,35,0,-44
-42.09219,-20.71648,70,37,0,-33
-42.08949,-20.71648,54,33,0,-21
-42.08657,-20.71648,58,37,5,-21
-42.08387,-20.71648,67,32,5,-35
-42.08118,-20.71648,56,39,0,-17
-42.07825,-20.71648,47,38,0,-9
-42.07556,-20.71648,54,34,5,-20
-42.07286,-20.71648,26,41,0,15
-42.06994,-20.71648,38,42,0,4
-42.06724,-20.71648,44,36,5,-8
-42.06455,-20.71648,47,33,5,-14
-42.06163,-20.71648,45,40,5,-5
-42.05893,-20.71648,32,40,5,8
-42.05601,-20.71648,38,44,5,6
-42.05331,-20.71648,41,62,0,21
-42.05061,-20.71648,32,68,0,36
-42.04769,-20.71648,25,55,5,30
-42.045,-20.71648,20,55,5,35
-42.0423,-20.71648,5,58,5,53
-42.03938,-20.71648,14,52,2,38
-42.03668,-20.71648,28,47,5,19
-42.03399,-20.71648,24,49,5,25
-42.03106,-20.71648,29,50,0,21
-42.02837,-20.71648,35,51,5,16
-42.02545,-20.71648,34,48,5,14
-42.02275,-20.71648,40,44,5,4
-42.02005,-20.71648,48,45,5,-3
-42.01713,-20.71648,50,47,5,-3
-42.01444,-20.71648,48,50,0,2
-42.01174,-20.71648,47,47,5,0
-42.00882,-20.71648,55,44,5,-11
-42.00612,-20.71648,57,41,5,-16
-42.00342,-20.71648,56,46,5,-10
-42.0005,-20.71648,58,44,5,-14
-41.99781,-20.71648,56,36,5,-20
-41.99511,-20.71648,54,38,5,-16
-41.99219,-20.71648,59,38,0,-21
-41.98949,-20.71648,66,39,0,-27
-41.98657,-20.71648,59,40,5,-19
-41.98387,-20.71648,59,40,0,-19
-41.98118,-20.71648,60,40,5,-20
-41.97826,-20.71648,57,41,0,-16
-41.97556,-20.71648,53,41,0,-12
-41.97286,-20.71648,52,42,0,-10
-41.96994,-20.71648,51,36,5,-15
-42.1005,-20.71606,63,32,0,-31
-42.0978,-20.71606,66,34,0,-32
-42.09511,-20.71606,75,35,0,-40
-42.09219,-20.71606,69,36,0,-33
-42.08949,-20.71606,53,33,0,-20
-42.08657,-20.71606,58,36,5,-22
-42.08387,-20.71606,67,36,0,-31
-42.08118,-20.71606,56,38,0,-18
-42.07825,-20.71606,47,38,0,-9
-42.07556,-20.71606,54,34,5,-20
-42.07286,-20.71606,32,41,0,9
-42.06994,-20.71606,39,41,0,2
-42.06724,-20.71606,41,37,5,-4
-42.06455,-20.71606,46,38,5,-8
-42.06163,-20.71606,46,39,5,-7
-42.05893,-20.71606,29,39,5,10
-42.05601,-20.71606,37,52,5,15
-42.05331,-20.71606,39,62,0,23
-42.05061,-20.71606,32,72,0,40
-42.04769,-20.71606,29,55,5,26
-42.045,-20.71606,6,56,5,50
-42.0423,-20.71606,5,61,0,56
-42.03938,-20.71606,5,52,2,47
-42.03668,-20.71606,27,47,5,20
-42.03399,-20.71606,27,41,5,14
-42.03106,-20.71606,27,48,0,21
-42.02837,-20.71606,35,49,5,14
-42.02545,-20.71606,34,47,5,13
-42.02275,-20.71606,39,43,5,4
-42.02005,-20.71606,49,42,5,-7
-42.01713,-20.71606,50,47,5,-3
-42.01444,-20.71606,48,46,5,-2
-42.01174,-20.71606,47,47,0,0
-42.00882,-20.71606,55,44,5,-11
-42.00612,-20.71606,57,40,5,-17
-42.00342,-20.71606,56,45,5,-11
-42.0005,-20.71606,58,44,5,-14
-41.99781,-20.71606,56,35,5,-21
-41.99511,-20.71606,55,39,5,-16
-41.99219,-20.71606,60,37,0,-23
-41.98949,-20.71606,65,39,0,-26
-41.98657,-20.71606,58,40,0,-18
-41.98387,-20.71606,61,40,0,-21
-41.98118,-20.71606,61,36,5,-25
-41.97826,-20.71606,58,41,0,-17
-41.97556,-20.71606,53,41,0,-12
-41.97286,-20.71606,52,42,0,-10
-41.96994,-20.71606,51,42,0,-9
-42.1005,-20.71585,64,32,11,-32
-42.0978,-20.71585,68,34,0,-34
-42.09511,-20.71585,71,35,0,-36
-42.09219,-20.71585,69,37,0,-32
-42.08949,-20.71585,52,34,0,-18
-42.08657,-20.71585,57,37,0,-20
-42.08387,-20.71585,64,36,0,-28
-42.08118,-20.71585,56,38,0,-18
-42.07825,-20.71585,47,39,0,-8
-42.07556,-20.71585,54,33,5,-21
-42.07286,-20.71585,28,41,0,13
-42.06994,-20.71585,40,41,0,1
-42.06724,-20.71585,40,37,5,-3
-42.06455,-20.71585,45,38,5,-7
-42.06163,-20.71585,49,39,5,-10
-42.05893,-20.71585,28,39,5,11
-42.05601,-20.71585,35,54,0,19
-42.05331,-20.71585,41,66,0,25
-42.05061,-20.71585,32,66,0,34
-42.04769,-20.71585,26,54,5,28
-42.045,-20.71585,21,56,5,35
-42.0423,-20.71585,18,63,0,45
-42.03938,-20.71585,19,52,2,33
-42.03668,-20.71585,28,47,5,19
-42.03399,-20.71585,28,42,0,14
-42.03106,-20.71585,25,48,0,23
-42.02837,-20.71585,35,48,5,13
-42.02545,-20.71585,35,39,5,4
-42.02275,-20.71585,35,41,5,6
-42.02005,-20.71585,48,41,5,-7
-42.01713,-20.71585,50,48,5,-2
-42.01444,-20.71585,48,45,5,-3
-42.01174,-20.71585,48,47,0,-1
-42.00882,-20.71585,55,43,5,-12
-42.00612,-20.71585,57,42,5,-15
-42.00342,-20.71585,57,45,5,-12
-42.0005,-20.71585,56,44,5,-12
-41.99781,-20.71585,56,34,5,-22
-41.99511,-20.71585,55,37,5,-18
-41.99219,-20.71585,63,38,0,-25
-41.98949,-20.71585,65,39,0,-26
-41.98657,-20.71585,57,40,0,-17
-41.98387,-20.71585,56,40,0,-16
-41.98118,-20.71585,62,39,11,-23
-41.97826,-20.71585,58,41,0,-17
-41.97556,-20.71585,53,41,0,-12
-41.97286,-20.71585,52,42,0,-10
-41.96994,-20.71585,51,42,0,-9
-42.1005,-20.71564,64,31,0,-33
-42.0978,-20.71564,68,34,0,-34
-42.09511,-20.71564,70,35,0,-35
-42.09219,-20.71564,68,37,0,-31
-42.08949,-20.71564,52,34,0,-18
-42.08657,-20.71564,57,37,0,-20
-42.08387,-20.71564,64,36,0,-28
-42.08118,-20.71564,56,38,0,-18
-42.07825,-20.71564,49,38,0,-11
-42.07556,-20.71564,54,34,5,-20
-42.07286,-20.71564,29,41,0,12
-42.06994,-20.71564,40,41,0,1
-42.06724,-20.71564,40,37,5,-3
-42.06455,-20.71564,43,38,5,-5
-42.06163,-20.71564,50,39,5,-11
-42.05893,-20.71564,28,39,5,11
-42.05601,-20.71564,35,61,0,26
-42.05331,-20.71564,29,64,0,35
-42.05061,-20.71564,31,57,0,26
-42.04769,-20.71564,32,54,5,22
-42.045,-20.71564,6,56,5,50
-42.0423,-20.71564,5,77,0,72
-42.03938,-20.71564,8,51,2,43
-42.03668,-20.71564,34,46,5,12
-42.03399,-20.71564,31,42,0,11
-42.03106,-20.71564,36,48,0,12
-42.02837,-20.71564,35,47,5,12
-42.02545,-20.71564,36,39,5,3
-42.02275,-20.71564,33,42,5,9
-42.02005,-20.71564,49,40,5,-9
-42.01713,-20.71564,51,50,5,-1
-42.01444,-20.71564,48,45,5,-3
-42.01174,-20.71564,48,47,5,-1
-42.00882,-20.71564,55,43,5,-12
-42.00612,-20.71564,57,43,0,-14
-42.00342,-20.71564,57,39,5,-18
-42.0005,-20.71564,56,46,5,-10
-41.99781,-20.71564,56,36,5,-20
-41.99511,-20.71564,55,37,5,-18
-41.99219,-20.71564,63,38,0,-25
-41.98949,-20.71564,64,39,0,-25
-41.98657,-20.71564,56,40,0,-16
-41.98387,-20.71564,54,40,0,-14
-41.98118,-20.71564,62,36,5,-26
-41.97826,-20.71564,57,41,0,-16
-41.97556,-20.71564,53,41,0,-12
-41.97286,-20.71564,52,42,0,-10
-41.96994,-20.71564,51,42,0,-9
-42.1005,-20.71521,62,34,0,-28
-42.0978,-20.71521,67,34,0,-33
-42.09511,-20.71521,69,35,0,-34
-42.09219,-20.71521,68,35,0,-33
-42.08949,-20.71521,53,31,0,-22
-42.08657,-20.71521,56,37,0,-19
-42.08387,-20.71521,63,37,0,-26
-42.08118,-20.71521,57,38,0,-19
-42.07825,-20.71521,48,37,0,-11
-42.07556,-20.71521,55,33,5,-22
-42.07286,-20.71521,30,41,0,11
-42.06994,-20.71521,42,41,0,-1
-42.06724,-20.71521,40,36,5,-4
-42.06455,-20.71521,42,38,5,-4
-42.06163,-20.71521,51,39,5,-12
-42.05893,-20.71521,28,40,5,12
-42.05601,-20.71521,36,76,0,40
-42.05331,-20.71521,25,64,0,39
-42.05061,-20.71521,23,53,5,30
-42.04769,-20.71521,33,55,5,22
-42.045,-20.71521,7,57,5,50
-42.0423,-20.71521,6,63,5,57
-42.03938,-20.71521,13,50,2,37
-42.03668,-20.71521,35,45,6,10
-42.03399,-20.71521,29,40,0,11
-42.03106,-20.71521,39,46,0,7
-42.02837,-20.71521,34,47,5,13
-42.02545,-20.71521,36,46,5,10
-42.02275,-20.71521,32,39,5,7
-42.02005,-20.71521,49,37,5,-12
-42.01713,-20.71521,51,51,0,0
-42.01444,-20.71521,48,46,5,-2
-42.01174,-20.71521,48,42,5,-6
-42.00882,-20.71521,55,45,5,-10
-42.00612,-20.71521,57,42,0,-15
-42.00342,-20.71521,57,38,5,-19
-42.0005,-20.71521,56,49,5,-7
-41.99781,-20.71521,56,38,5,-18
-41.99511,-20.71521,55,34,5,-21
-41.99219,-20.71521,63,38,0,-25
-41.98949,-20.71521,61,39,0,-22
-41.98657,-20.71521,56,40,0,-16
-41.98387,-20.71521,54,41,0,-13
-41.98118,-20.71521,61,34,5,-27
-41.97826,-20.71521,56,41,0,-15
-41.97556,-20.71521,53,38,0,-15
-41.97286,-20.71521,53,41,0,-12
-41.96994,-20.71521,51,42,0,-9
-42.10297,-20.715,61,35,0,-26
-42.10275,-20.715,62,35,0,-27
-42.10252,-20.715,62,35,0,-27
-42.1023,-20.715,62,35,0,-27
-42.10185,-20.715,62,35,0,-27
-42.10163,-20.715,62,35,0,-27
-42.1014,-20.715,62,35,0,-27
-42.10118,-20.715,63,35,0,-28
-42.10073,-20.715,66,35,0,-31
-42.1005,-20.715,61,35,0,-26
-42.10028,-20.715,61,35,0,-26
-42.10005,-20.715,62,35,0,-27
-42.09983,-20.715,63,35,0,-28
-42.09938,-20.715,63,35,0,-28
-42.09915,-20.715,63,35,0,-28
-42.09893,-20.715,65,35,0,-30
-42.0987,-20.715,65,35,0,-30
-42.09825,-20.715,65,35,0,-30
-42.09803,-20.715,65,34,0,-31
-42.0978,-20.715,66,35,0,-31
-42.09758,-20.715,66,35,0,-31
-42.09713,-20.715,66,35,0,-31
-42.09691,-20.715,67,35,0,-32
-42.09668,-20.715,67,35,0,-32
-42.09646,-20.715,68,35,0,-33
-42.09601,-20.715,68,35,0,-33
-42.09578,-20.715,68,35,0,-33
-42.09556,-20.715,68,35,0,-33
-42.09533,-20.715,68,35,0,-33
-42.09511,-20.715,68,35,11,-33
-42.09466,-20.715,68,34,11,-34
-42.09443,-20.715,68,34,11,-34
-42.09421,-20.715,68,33,11,-35
-42.09398,-20.715,68,31,11,-37
-42.09354,-20.715,68,29,5,-39
-42.09331,-20.715,69,29,5,-40
-42.09309,-20.715,68,31,5,-37
-42.09286,-20.715,68,31,5,-37
-42.09241,-20.715,68,35,0,-33
-42.09219,-20.715,68,35,0,-33
-42.09196,-20.715,68,35,0,-33
-42.09174,-20.715,68,35,0,-33
-42.09129,-20.715,68,36,0,-32
-42.09106,-20.715,67,35,0,-32
-42.09084,-20.715,68,35,0,-33
-42.09061,-20.715,66,35,0,-31
-42.09039,-20.715,52,35,0,-17
-42.08994,-20.715,51,35,0,-16
-42.08972,-20.715,52,34,0,-18
-42.08949,-20.715,52,33,0,-19
-42.08927,-20.715,52,33,0,-19
-42.08882,-20.715,52,32,0,-20
-42.08859,-20.715,53,32,0,-21
-42.08837,-20.715,54,36,0,-18
-42.08814,-20.715,54,37,0,-17
-42.08769,-20.715,55,38,0,-17
-42.08747,-20.715,55,38,0,-17
-42.08724,-20.715,55,38,0,-17
-42.08702,-20.715,56,37,0,-19
-42.08657,-20.715,56,37,0,-19
-42.08634,-20.715,57,37,0,-20
-42.08612,-20.715,57,37,0,-20
-42.08589,-20.715,57,37,0,-20
-42.08545,-20.715,58,37,0,-21
-42.08522,-20.715,59,37,0,-22
-42.085,-20.715,60,37,0,-23
-42.08477,-20.715,60,37,0,-23
-42.08455,-20.715,61,37,0,-24
-42.0841,-20.715,62,37,0,-25
-42.08387,-20.715,63,37,0,-26
-42.08365,-20.715,64,38,0,-26
-42.08342,-20.715,66,38,0,-28
-42.08297,-20.715,65,38,0,-27
-42.08275,-20.715,58,38,0,-20
-42.08252,-20.715,57,38,0,-19
-42.0823,-20.715,56,38,0,-18
-42.08185,-20.715,56,38,0,-18
-42.08163,-20.715,56,38,0,-18
-42.0814,-20.715,56,38,0,-18
-42.08118,-20.715,58,38,0,-20
-42.08073,-20.715,58,38,0,-20
-42.0805,-20.715,54,38,0,-16
-42.08028,-20.715,53,38,0,-15
-42.08005,-20.715,53,38,0,-15
-42.07983,-20.715,54,38,0,-16
-42.07938,-20.715,54,37,0,-17
-42.07915,-20.715,50,37,0,-13
-42.07893,-20.715,48,37,0,-11
-42.0787,-20.715,47,38,0,-9
-42.07825,-20.715,48,38,0,-10
-42.07803,-20.715,49,37,0,-12
-42.07781,-20.715,50,38,0,-12
-42.07758,-20.715,52,37,0,-15
-42.07713,-20.715,53,36,5,-17
-42.07691,-20.715,53,32,5,-21
-42.07668,-20.715,54,33,5,-21
-42.07646,-20.715,55,33,5,-22
-42.07601,-20.715,55,33,5,-22
-42.07578,-20.715,55,33,5,-22
-42.07556,-20.715,56,33,5,-23
-42.07533,-20.715,55,33,5,-22
-42.07511,-20.715,55,34,5,-21
-42.07466,-20.715,56,36,5,-20
-42.07443,-20.715,56,36,5,-20
-42.07421,-20.715,59,36,5,-23
-42.07399,-20.715,55,37,5,-18
-42.07354,-20.715,53,39,5,-14
-42.07331,-20.715,52,41,5,-11
-42.07309,-20.715,50,41,5,-9
-42.07286,-20.715,46,41,0,-5
-42.07241,-20.715,42,41,0,-1
-42.07219,-20.715,38,41,0,3
-42.07196,-20.715,30,41,0,11
-42.07174,-20.715,39,41,0,2
-42.07129,-20.715,41,41,0,0
-42.07106,-20.715,41,41,0,0
-42.07084,-20.715,38,40,0,2
-42.07061,-20.715,38,40,0,2
-42.07039,-20.715,40,40,0,0
-42.06994,-20.715,40,41,0,1
-42.06972,-20.715,34,41,0,7
-42.06949,-20.715,36,40,0,4
-42.06927,-20.715,44,41,0,-3
-42.06882,-20.715,46,39,5,-7
-42.06859,-20.715,43,37,5,-6
-42.06837,-20.715,39,36,5,-3
-42.06814,-20.715,37,34,5,-3
-42.06769,-20.715,39,31,5,-8
-42.06747,-20.715,39,32,5,-7
-42.06724,-20.715,40,36,5,-4
-42.06702,-20.715,42,36,5,-6
-42.06657,-20.715,42,37,5,-5
-42.06634,-20.715,44,37,5,-7
-42.06612,-20.715,42,38,5,-4
-42.0659,-20.715,46,39,5,-7
-42.06545,-20.715,45,39,5,-6
-42.06522,-20.715,44,39,5,-5
-42.065,-20.715,43,38,5,-5
-42.06477,-20.715,39,38,5,-1
-42.06455,-20.715,40,38,5,-2
-42.0641,-20.715,42,39,5,-3
-42.06387,-20.715,43,39,5,-4
-42.06365,-20.715,43,39,5,-4
-42.06342,-20.715,43,39,5,-4
-42.06297,-20.715,44,39,5,-5
-42.06275,-20.715,47,39,5,-8
-42.06252,-20.715,49,39,5,-10
-42.0623,-20.715,49,39,5,-10
-42.06185,-20.715,50,39,5,-11
-42.06163,-20.715,50,40,5,-10
-42.0614,-20.715,51,40,5,-11
-42.06118,-20.715,45,40,5,-5
-42.06073,-20.715,40,40,5,0
-42.0605,-20.715,26,39,5,13
-42.06028,-20.715,35,39,5,4
-42.06005,-20.715,35,39,5,4
-42.05983,-20.715,26,39,5,13
-42.05938,-20.715,36,40,5,4
-42.05915,-20.715,30,40,5,10
-42.05893,-20.715,37,40,5,3
-42.0587,-20.715,38,41,5,3
-42.05826,-20.715,27,49,5,22
-42.05803,-20.715,35,50,5,15
-42.05781,-20.715,35,51,5,16
-42.05758,-20.715,27,51,5,24
-42.05713,-20.715,36,53,5,17
-42.05691,-20.715,32,63,0,31
-42.05668,-20.715,33,57,0,24
-42.05646,-20.715,36,63,0,27
-42.05601,-20.715,35,76,0,41
-42.05578,-20.715,41,76,0,35
-42.05556,-20.715,43,75,0,32
-42.05533,-20.715,38,60,0,22
-42.05511,-20.715,43,61,0,18
-42.05466,-20.715,44,71,0,27
-42.05443,-20.715,41,71,0,30
-42.05421,-20.715,37,68,0,31
-42.05399,-20.715,39,70,0,31
-42.05354,-20.715,34,69,0,35
-42.05331,-20.715,26,69,0,43
-42.05309,-20.715,20,69,0,49
-42.05286,-20.715,25,69,0,44
-42.05241,-20.715,25,66,0,41
-42.05219,-20.715,16,66,0,50
-42.05196,-20.715,25,62,0,37
-42.05174,-20.715,19,60,0,41
-42.05129,-20.715,20,52,0,32
-42.05106,-20.715,24,52,5,28
-42.05084,-20.715,20,52,5,32
-42.05061,-20.715,23,52,5,29
-42.05039,-20.715,28,53,5,25
-42.04994,-20.715,31,53,5,22
-42.04972,-20.715,36,53,5,17
-42.04949,-20.715,38,53,5,15
-42.04927,-20.715,39,53,5,14
-42.04882,-20.715,40,54,5,14
-42.04859,-20.715,39,54,5,15
-42.04837,-20.715,35,54,5,19
-42.04814,-20.715,35,54,5,19
-42.04769,-20.715,35,54,5,19
-42.04747,-20.715,31,55,5,24
-42.04724,-20.715,27,54,5,27
-42.04702,-20.715,25,54,5,29
-42.04657,-20.715,25,54,5,29
-42.04635,-20.715,27,54,5,27
-42.04612,-20.715,25,54,5,29
-42.0459,-20.715,25,54,5,29
-42.04545,-20.715,25,54,5,29
-42.04522,-20.715,24,56,5,32
-42.045,-20.715,24,56,5,32
-42.04477,-20.715,24,57,5,33
-42.04455,-20.715,23,57,5,34
-42.0441,-20.715,23,61,5,38
-42.04387,-20.715,23,61,5,38
-42.04365,-20.715,22,62,5,40
-42.04342,-20.715,22,61,5,39
-42.04297,-20.715,22,63,5,41
-42.04275,-20.715,21,62,5,41
-42.04253,-20.715,21,62,5,41
-42.0423,-20.715,21,59,5,38
-42.04185,-20.715,20,50,5,30
-42.04163,-20.715,20,50,5,30
-42.0414,-20.715,20,51,0,31
-42.04118,-20.715,20,73,0,53
-42.04073,-20.715,20,58,0,38
-42.0405,-20.715,20,58,0,38
-42.04028,-20.715,28,72,0,44
-42.04005,-20.715,22,57,0,35
-42.03983,-20.715,21,54,0,33
-42.03938,-20.715,27,50,2,23
-42.03915,-20.715,28,50,2,22
-42.03893,-20.715,30,48,2,18
-42.0387,-20.715,32,50,2,18
-42.03826,-20.715,34,51,2,17
-42.03803,-20.715,35,50,11,15
-42.03781,-20.715,34,49,11,15
-42.03758,-20.715,35,44,2,9
-42.03713,-20.715,34,45,11,11
-42.03691,-20.715,36,45,2,9
-42.03668,-20.715,36,45,6,9
-42.03646,-20.715,37,51,11,14
-42.03601,-20.715,37,51,11,14
-42.03578,-20.715,37,50,0,13
-42.03556,-20.715,37,45,0,8
-42.03533,-20.715,39,42,0,3
-42.03511,-20.715,37,42,0,5
-42.03466,-20.715,33,41,0,8
-42.03444,-20.715,34,40,0,6
-42.03421,-20.715,34,40,0,6
-42.03399,-20.715,33,41,0,8
-42.03354,-20.715,33,42,0,9
-42.03331,-20.715,31,42,0,11
-42.03309,-20.715,26,42,0,16
-42.03286,-20.715,24,42,0,18
-42.03241,-20.715,24,44,0,20
-42.03219,-20.715,24,44,0,20
-42.03196,-20.715,24,48,0,24
-42.03174,-20.715,30,44,0,14
-42.03129,-20.715,38,45,0,7
-42.03106,-20.715,41,46,0,5
-42.03084,-20.715,40,44,5,4
-42.03062,-20.715,39,44,5,5
-42.03017,-20.715,32,49,5,17
-42.02994,-20.715,32,49,5,17
-42.02972,-20.715,33,50,5,17
-42.02949,-20.715,34,51,5,17
-42.02927,-20.715,34,51,5,17
-42.02882,-20.715,35,47,5,12
-42.02859,-20.715,35,47,5,12
-42.02837,-20.715,35,51,5,16
-42.02814,-20.715,39,50,5,11
-42.02769,-20.715,37,51,5,14
-42.02747,-20.715,38,51,5,13
-42.02724,-20.715,36,50,5,14
-42.02702,-20.715,37,50,5,13
-42.02657,-20.715,42,48,5,6
-42.02635,-20.715,38,50,5,12
-42.02612,-20.715,37,49,5,12
-42.0259,-20.715,37,48,5,11
-42.02545,-20.715,38,47,5,9
-42.02522,-20.715,36,46,5,10
-42.025,-20.715,36,35,5,-1
-42.02477,-20.715,35,35,5,0
-42.02455,-20.715,35,35,5,0
-42.0241,-20.715,34,36,5,2
-42.02387,-20.715,34,37,5,3
-42.02365,-20.715,33,37,5,4
-42.02342,-20.715,33,30,5,-3
-42.02297,-20.715,32,35,5,3
-42.02275,-20.715,32,38,5,6
-42.02253,-20.715,32,39,5,7
-42.0223,-20.715,32,39,5,7
-42.02185,-20.715,32,35,5,3
-42.02163,-20.715,37,36,5,-1
-42.0214,-20.715,40,35,5,-5
-42.02118,-20.715,43,34,5,-9
-42.02073,-20.715,45,37,5,-8
-42.0205,-20.715,46,38,5,-8
-42.02028,-20.715,47,34,5,-13
-42.02005,-20.715,48,37,5,-11
-42.01983,-20.715,48,39,5,-9
-42.01938,-20.715,48,41,5,-7
-42.01915,-20.715,49,42,5,-7
-42.01893,-20.715,48,43,5,-5
-42.01871,-20.715,48,43,5,-5
-42.01826,-20.715,49,42,5,-7
-42.01803,-20.715,50,42,5,-8
-42.01781,-20.715,51,42,5,-9
-42.01758,-20.715,52,48,5,-4
-42.01713,-20.715,54,50,5,-4
-42.01691,-20.715,50,51,5,1
-42.01668,-20.715,50,52,5,2
-42.01646,-20.715,50,49,5,-1
-42.01601,-20.715,49,48,5,-1
-42.01578,-20.715,49,49,0,0
-42.01556,-20.715,49,50,0,1
-42.01533,-20.715,48,45,0,-3
-42.01511,-20.715,48,49,0,1
-42.01466,-20.715,49,51,0,2
-42.01444,-20.715,49,51,0,2
-42.01421,-20.715,49,50,0,1
-42.01399,-20.715,48,49,0,1
-42.01354,-20.715,48,48,0,0
-42.01331,-20.715,48,49,5,1
-42.01309,-20.715,48,44,5,-4
-42.01286,-20.715,48,42,5,-6
-42.01241,-20.715,48,42,5,-6
-42.01219,-20.715,48,42,5,-6
-42.01196,-20.715,48,42,5,-6
-42.01174,-20.715,48,42,5,-6
-42.01129,-20.715,48,42,5,-6
-42.01106,-20.715,47,42,5,-5
-42.01084,-20.715,47,42,5,-5
-42.01062,-20.715,46,42,5,-4
-42.01017,-20.715,46,46,5,0
-42.00994,-20.715,46,46,5,0
-42.00972,-20.715,45,45,5,0
-42.00949,-20.715,52,53,5,1
-42.00927,-20.715,55,45,5,-10
-42.00882,-20.715,55,44,5,-11
-42.00859,-20.715,55,42,5,-13
-42.00837,-20.715,58,41,5,-17
-42.00814,-20.715,58,41,5,-17
-42.00769,-20.715,58,44,0,-14
-42.00747,-20.715,58,42,0,-16
-42.00724,-20.715,58,42,0,-16
-42.00702,-20.715,58,42,0,-16
-42.00657,-20.715,58,42,5,-16
-42.00635,-20.715,57,41,5,-16
-42.00612,-20.715,57,41,5,-16
-42.0059,-20.715,57,41,5,-16
-42.00545,-20.715,57,39,5,-18
-42.00522,-20.715,57,37,5,-20
-42.005,-20.715,57,37,5,-20
-42.00477,-20.715,57,37,5,-20
-42.00455,-20.715,56,37,5,-19
-42.0041,-20.715,56,37,5,-19
-42.00387,-20.715,57,37,5,-20
-42.00365,-20.715,57,37,5,-20
-42.00342,-20.715,57,38,5,-19
-42.00298,-20.715,57,45,5,-12
-42.00275,-20.715,57,47,5,-10
-42.00253,-20.715,57,48,5,-9
-42.0023,-20.715,57,47,5,-10
-42.00185,-20.715,57,42,5,-15
-42.00163,-20.715,57,40,5,-17
-42.0014,-20.715,57,45,5,-12
-42.00118,-20.715,57,43,5,-14
-42.00073,-20.715,57,42,5,-15
-42.0005,-20.715,57,45,5,-12
-42.00028,-20.715,57,49,5,-8
-42.00005,-20.715,57,51,5,-6
-41.99983,-20.715,57,43,5,-14
-41.99938,-20.715,57,41,5,-16
-41.99916,-20.715,56,40,5,-16
-41.99893,-20.715,56,39,5,-17
-41.99871,-20.715,56,39,5,-17
-41.99826,-20.715,56,38,5,-18
-41.99803,-20.715,56,38,5,-18
-41.99781,-20.715,56,38,5,-18
-41.99758,-20.715,56,38,5,-18
-41.99713,-20.715,56,41,5,-15
-41.99691,-20.715,56,38,5,-18
-41.99668,-20.715,56,37,5,-19
-41.99646,-20.715,56,36,5,-20
-41.99601,-20.715,56,39,5,-17
-41.99578,-20.715,56,35,5,-21
-41.99556,-20.715,55,35,5,-20
-41.99533,-20.715,55,34,5,-21
-41.99511,-20.715,55,34,5,-21
-41.99466,-20.715,55,33,5,-22
-41.99444,-20.715,55,33,5,-22
-41.99421,-20.715,55,32,5,-23
-41.99399,-20.715,55,32,5,-23
-41.99354,-20.715,55,34,5,-21
-41.99331,-20.715,57,35,0,-22
-41.99309,-20.715,60,36,0,-24
-41.99286,-20.715,65,36,0,-29
-41.99241,-20.715,63,38,0,-25
-41.99219,-20.715,63,38,0,-25
-41.99196,-20.715,62,38,0,-24
-41.99174,-20.715,62,38,0,-24
-41.99129,-20.715,61,39,0,-22
-41.99107,-20.715,60,40,0,-20
-41.99084,-20.715,60,38,0,-22
-41.99062,-20.715,60,38,0,-22
-41.99017,-20.715,60,39,0,-21
-41.98994,-20.715,61,39,0,-22
-41.98972,-20.715,60,39,0,-21
-41.98949,-20.715,59,38,0,-21
-41.98927,-20.715,60,39,0,-21
-41.98882,-20.715,59,38,0,-21
-41.98859,-20.715,59,39,0,-20
-41.98837,-20.715,59,39,0,-20
-41.98814,-20.715,58,39,0,-19
-41.98769,-20.715,59,39,0,-20
-41.98747,-20.715,58,40,0,-18
-41.98725,-20.715,58,40,0,-18
-41.98702,-20.715,57,40,0,-17
-41.98657,-20.715,56,40,0,-16
-41.98635,-20.715,56,41,0,-15
-41.98612,-20.715,54,41,0,-13
-41.9859,-20.715,54,41,0,-13
-41.98545,-20.715,54,41,0,-13
-41.98522,-20.715,54,41,0,-13
-41.985,-20.715,54,41,0,-13
-41.98477,-20.715,54,41,0,-13
-41.98455,-20.715,57,41,0,-16
-41.9841,-20.715,56,41,0,-15
-41.98387,-20.715,54,41,0,-13
-41.98365,-20.715,54,41,0,-13
-41.98343,-20.715,54,41,0,-13
-41.98298,-20.715,54,41,0,-13
-41.98275,-20.715,54,41,0,-13
-41.98253,-20.715,54,41,0,-13
-41.9823,-20.715,53,41,0,-12
-41.98185,-20.715,53,41,5,-12
-41.98163,-20.715,53,34,5,-19
-41.9814,-20.715,61,32,5,-29
-41.98118,-20.715,63,34,5,-29
-41.98073,-20.715,65,37,0,-28
-41.9805,-20.715,63,38,11,-25
-41.98028,-20.715,62,39,11,-23
-41.98005,-20.715,59,41,0,-18
-41.97983,-20.715,57,41,0,-16
-41.97938,-20.715,55,41,0,-14
-41.97916,-20.715,55,41,0,-14
-41.97893,-20.715,55,41,0,-14
-41.97871,-20.715,54,41,0,-13
-41.97826,-20.715,53,41,0,-12
-41.97803,-20.715,53,41,0,-12
-41.97781,-20.715,53,41,0,-12
-41.97758,-20.715,53,41,0,-12
-41.97713,-20.715,53,41,0,-12
-41.97691,-20.715,53,41,0,-12
-41.97668,-20.715,53,41,0,-12
-41.97646,-20.715,53,41,0,-12
-41.97601,-20.715,53,41,0,-12
-41.97578,-20.715,53,41,0,-12
-41.97556,-20.715,53,40,0,-13
-41.97534,-20.715,53,38,0,-15
-41.97511,-20.715,53,38,0,-15
-41.97466,-20.715,53,40,0,-13
-41.97444,-20.715,60,41,0,-19
-41.97421,-20.715,56,41,0,-15
-41.97399,-20.715,53,41,0,-12
-41.97354,-20.715,53,41,0,-12
-41.97331,-20.715,53,41,0,-12
-41.97309,-20.715,53,41,0,-12
-41.97286,-20.715,53,41,0,-12
-41.97241,-20.715,52,41,0,-11
-41.97219,-20.715,52,41,0,-11
-41.97196,-20.715,52,41,0,-11
-41.97174,-20.715,52,41,0,-11
-41.97129,-20.715,52,41,0,-11
-41.97107,-20.715,52,41,0,-11
-41.97084,-20.715,52,41,0,-11
-41.97062,-20.715,52,41,0,-11
-41.97017,-20.715,52,42,0,-10
-41.96994,-20.715,52,42,0,-10
-41.96972,-20.715,52,42,0,-10
-41.96949,-20.715,52,42,0,-10
-41.96927,-20.715,51,42,0,-9
-42.1005,-20.71479,65,36,0,-29
-42.0978,-20.71479,65,36,0,-29
-42.09511,-20.71479,68,35,0,-33
-42.09219,-20.71479,67,35,11,-32
-42.08949,-20.71479,52,34,0,-18
-42.08657,-20.71479,56,37,0,-19
-42.08387,-20.71479,62,38,0,-24
-42.08118,-20.71479,57,38,0,-19
-42.07825,-20.71479,49,37,0,-12
-42.07556,-20.71479,56,33,5,-23
-42.07286,-20.71479,52,41,0,-11
-42.06994,-20.71479,40,41,0,1
-42.06724,-20.71479,39,36,5,-3
-42.06455,-20.71479,41,38,5,-3
-42.06163,-20.71479,50,40,5,-10
-42.05893,-20.71479,37,48,5,11
-42.05601,-20.71479,37,76,0,39
-42.05331,-20.71479,26,69,0,43
-42.05061,-20.71479,27,52,5,25
-42.04769,-20.71479,36,54,5,18
-42.045,-20.71479,25,56,5,31
-42.0423,-20.71479,21,59,5,38
-42.03938,-20.71479,31,50,2,19
-42.03668,-20.71479,36,44,2,8
-42.03399,-20.71479,35,41,0,6
-42.03106,-20.71479,40,46,0,6
-42.02837,-20.71479,35,51,5,16
-42.02545,-20.71479,44,47,5,3
-42.02275,-20.71479,33,35,5,2
-42.02005,-20.71479,47,39,5,-8
-42.01713,-20.71479,51,45,5,-6
-42.01444,-20.71479,48,48,0,0
-42.01174,-20.71479,48,42,5,-6
-42.00882,-20.71479,54,43,5,-11
-42.00612,-20.71479,57,37,5,-20
-42.00342,-20.71479,56,38,5,-18
-42.0005,-20.71479,57,46,5,-11
-41.99781,-20.71479,56,38,5,-18
-41.99511,-20.71479,55,34,5,-21
-41.99219,-20.71479,63,36,0,-27
-41.98949,-20.71479,59,39,0,-20
-41.98657,-20.71479,57,40,0,-17
-41.98387,-20.71479,59,41,0,-18
-41.98118,-20.71479,59,39,5,-20
-41.97826,-20.71479,53,41,0,-12
-41.97556,-20.71479,53,41,0,-12
-41.97286,-20.71479,53,41,0,-12
-41.96994,-20.71479,52,42,0,-10
-42.1005,-20.71437,62,36,0,-26
-42.0978,-20.71437,65,36,0,-29
-42.09511,-20.71437,67,36,0,-31
-42.09219,-20.71437,67,35,0,-32
-42.08949,-20.71437,52,35,0,-17
-42.08657,-20.71437,56,36,0,-20
-42.08387,-20.71437,62,36,0,-26
-42.08118,-20.71437,55,38,0,-17
-42.07825,-20.71437,50,36,0,-14
-42.07556,-20.71437,57,33,5,-24
-42.07286,-20.71437,54,41,0,-13
-42.06994,-20.71437,40,40,0,0
-42.06724,-20.71437,38,36,5,-2
-42.06455,-20.71437,39,38,5,-1
-42.06163,-20.71437,49,41,5,-8
-42.05893,-20.71437,33,48,5,15
-42.05601,-20.71437,42,58,0,16
-42.05331,-20.71437,26,75,0,49
-42.05061,-20.71437,27,52,5,25
-42.04769,-20.71437,37,55,5,18
-42.045,-20.71437,7,57,5,50
-42.0423,-20.71437,6,49,5,43
-42.03938,-20.71437,34,53,0,19
-42.03668,-20.71437,36,44,6,8
-42.03399,-20.71437,39,42,0,3
-42.03106,-20.71437,39,46,0,7
-42.02837,-20.71437,35,51,5,16
-42.02545,-20.71437,37,47,5,10
-42.02275,-20.71437,39,37,5,-2
-42.02005,-20.71437,48,38,5,-10
-42.01713,-20.71437,51,40,5,-11
-42.01444,-20.71437,48,48,5,0
-42.01174,-20.71437,48,43,5,-5
-42.00882,-20.71437,52,42,5,-10
-42.00612,-20.71437,57,36,5,-21
-42.00342,-20.71437,56,37,5,-19
-42.0005,-20.71437,56,51,5,-5
-41.99781,-20.71437,56,38,5,-18
-41.99511,-20.71437,55,37,5,-18
-41.99219,-20.71437,62,35,0,-27
-41.98949,-20.71437,59,36,0,-23
-41.98657,-20.71437,57,40,0,-17
-41.98387,-20.71437,60,42,0,-18
-41.98118,-20.71437,57,41,0,-16
-41.97826,-20.71437,53,40,11,-13
-41.97556,-20.71437,53,40,0,-13
-41.97286,-20.71437,53,41,0,-12
-41.96994,-20.71437,52,41,0,-11
-42.1005,-20.71416,64,36,0,-28
-42.0978,-20.71416,64,36,0,-28
-42.09511,-20.71416,67,36,0,-31
-42.09219,-20.71416,68,35,0,-33
-42.08949,-20.71416,52,36,11,-16
-42.08657,-20.71416,55,36,0,-19
-42.08387,-20.71416,62,35,0,-27
-42.08118,-20.71416,53,37,0,-16
-42.07825,-20.71416,49,36,5,-13
-42.07556,-20.71416,56,33,5,-23
-42.07286,-20.71416,54,41,0,-13
-42.06994,-20.71416,41,40,0,-1
-42.06724,-20.71416,38,37,5,-1
-42.06455,-20.71416,38,38,5,0
-42.06163,-20.71416,48,40,5,-8
-42.05893,-20.71416,25,48,5,23
-42.05601,-20.71416,46,60,0,14
-42.05331,-20.71416,26,75,0,49
-42.05061,-20.71416,26,52,5,26
-42.04769,-20.71416,40,55,5,15
-42.045,-20.71416,7,56,5,49
-42.0423,-20.71416,22,47,5,25
-42.03938,-20.71416,40,53,0,13
-42.03668,-20.71416,36,44,6,8
-42.03399,-20.71416,39,42,0,3
-42.03106,-20.71416,39,48,0,9
-42.02837,-20.71416,35,50,5,15
-42.02545,-20.71416,37,47,5,10
-42.02275,-20.71416,46,39,5,-7
-42.02005,-20.71416,52,39,0,-13
-42.01713,-20.71416,50,39,5,-11
-42.01444,-20.71416,47,47,5,0
-42.01174,-20.71416,48,43,5,-5
-42.00882,-20.71416,50,42,5,-8
-42.00612,-20.71416,56,36,5,-20
-42.00342,-20.71416,56,42,5,-14
-42.0005,-20.71416,56,46,5,-10
-41.99781,-20.71416,56,37,5,-19
-41.99511,-20.71416,55,37,5,-18
-41.99219,-20.71416,64,33,0,-31
-41.98949,-20.71416,59,35,0,-24
-41.98657,-20.71416,57,39,0,-18
-41.98387,-20.71416,60,42,0,-18
-41.98118,-20.71416,53,41,0,-12
-41.97826,-20.71416,52,40,0,-12
-41.97556,-20.71416,60,40,0,-20
-41.97286,-20.71416,53,41,0,-12
-41.96994,-20.71416,52,41,0,-11
-42.1005,-20.71394,64,36,0,-28
-42.0978,-20.71394,64,36,0,-28
-42.09511,-20.71394,66,36,0,-30
-42.09219,-20.71394,69,35,0,-34
-42.08949,-20.71394,52,36,0,-16
-42.08657,-20.71394,55,36,0,-19
-42.08387,-20.71394,62,36,0,-26
-42.08118,-20.71394,52,37,0,-15
-42.07825,-20.71394,50,33,5,-17
-42.07556,-20.71394,57,34,5,-23
-42.07286,-20.71394,57,41,0,-16
-42.06994,-20.71394,41,40,0,-1
-42.06724,-20.71394,39,37,5,-2
-42.06455,-20.71394,39,38,5,-1
-42.06163,-20.71394,46,45,5,-1
-42.05893,-20.71394,24,48,5,24
-42.05601,-20.71394,46,60,0,14
-42.05331,-20.71394,29,75,0,46
-42.05061,-20.71394,30,52,5,22
-42.04769,-20.71394,41,55,5,14
-42.045,-20.71394,26,55,5,29
-42.0423,-20.71394,30,47,0,17
-42.03938,-20.71394,40,53,0,13
-42.03668,-20.71394,35,44,2,9
-42.03399,-20.71394,38,42,0,4
-42.03106,-20.71394,38,50,0,12
-42.02837,-20.71394,34,51,5,17
-42.02545,-20.71394,37,49,5,12
-42.02275,-20.71394,47,44,0,-3
-42.02005,-20.71394,57,39,0,-18
-42.01713,-20.71394,50,36,5,-14
-42.01444,-20.71394,47,47,5,0
-42.01174,-20.71394,48,50,5,2
-42.00882,-20.71394,52,42,5,-10
-42.00612,-20.71394,55,36,5,-19
-42.00342,-20.71394,56,41,5,-15
-42.0005,-20.71394,56,50,5,-6
-41.99781,-20.71394,56,37,5,-19
-41.99511,-20.71394,55,36,5,-19
-41.99219,-20.71394,61,30,0,-31
-41.98949,-20.71394,59,34,0,-25
-41.98657,-20.71394,57,39,0,-18
-41.98387,-20.71394,59,42,0,-17
-41.98118,-20.71394,53,42,0,-11
-41.97826,-20.71394,62,40,0,-22
-41.97556,-20.71394,60,40,0,-20
-41.97286,-20.71394,53,41,5,-12
-41.96994,-20.71394,52,41,0,-11
-42.1005,-20.71352,64,36,0,-28
-42.0978,-20.71352,63,36,5,-27
-42.09511,-20.71352,66,36,0,-30
-42.09219,-20.71352,72,35,0,-37
-42.08949,-20.71352,52,36,0,-16
-42.08657,-20.71352,55,36,0,-19
-42.08387,-20.71352,62,36,0,-26
-42.08118,-20.71352,51,37,5,-14
-42.07825,-20.71352,52,31,5,-21
-42.07556,-20.71352,57,34,5,-23
-42.07286,-20.71352,59,41,0,-18
-42.06994,-20.71352,38,38,0,0
-42.06724,-20.71352,43,40,5,-3
-42.06455,-20.71352,39,38,5,-1
-42.06163,-20.71352,46,46,5,0
-42.05893,-20.71352,24,47,5,23
-42.05601,-20.71352,48,59,0,11
-42.05331,-20.71352,30,70,0,40
-42.05061,-20.71352,30,53,5,23
-42.04769,-20.71352,41,56,5,15
-42.045,-20.71352,26,58,5,32
-42.0423,-20.71352,30,48,0,18
-42.03938,-20.71352,39,52,0,13
-42.03668,-20.71352,35,44,2,9
-42.03399,-20.71352,38,38,11,0
-42.03106,-20.71352,38,47,5,9
-42.02837,-20.71352,35,52,5,17
-42.02545,-20.71352,37,50,5,13
-42.02275,-20.71352,48,46,0,-2
-42.02005,-20.71352,55,39,0,-16
-42.01713,-20.71352,50,35,5,-15
-42.01444,-20.71352,46,45,5,-1
-42.01174,-20.71352,48,44,5,-4
-42.00882,-20.71352,49,40,5,-9
-42.00612,-20.71352,54,35,5,-19
-42.00342,-20.71352,56,44,5,-12
-42.0005,-20.71352,56,48,5,-8
-41.99781,-20.71352,56,37,5,-19
-41.99511,-20.71352,56,32,5,-24
-41.99219,-20.71352,60,36,0,-24
-41.98949,-20.71352,57,28,0,-29
-41.98657,-20.71352,57,30,0,-27
-41.98387,-20.71352,55,44,0,-11
-41.98118,-20.71352,53,35,0,-18
-41.97826,-20.71352,64,39,0,-25
-41.97556,-20.71352,63,37,5,-26
-41.97286,-20.71352,53,34,5,-19
-41.96994,-20.71352,53,41,0,-12
-42.1005,-20.71331,64,36,5,-28
-42.0978,-20.71331,63,37,5,-26
-42.09511,-20.71331,66,36,0,-30
-42.09219,-20.71331,66,35,0,-31
-42.08949,-20.71331,52,36,0,-16
-42.08657,-20.71331,55,36,0,-19
-42.08387,-20.71331,64,36,0,-28
-42.08118,-20.71331,55,32,5,-23
-42.07825,-20.71331,54,31,5,-23
-42.07556,-20.71331,58,33,5,-25
-42.07286,-20.71331,60,41,0,-19
-42.06994,-20.71331,36,37,5,1
-42.06724,-20.71331,38,37,5,-1
-42.06455,-20.71331,41,38,5,-3
-42.06163,-20.71331,45,45,5,0
-42.05893,-20.71331,24,47,5,23
-42.05601,-20.71331,46,60,0,14
-42.05331,-20.71331,31,56,0,25
-42.05061,-20.71331,31,53,5,22
-42.04769,-20.71331,40,56,5,16
-42.045,-20.71331,24,56,5,32
-42.0423,-20.71331,32,46,0,14
-42.03938,-20.71331,39,52,0,13
-42.03668,-20.71331,38,45,11,7
-42.03399,-20.71331,37,38,5,1
-42.03106,-20.71331,38,47,5,9
-42.02837,-20.71331,35,52,5,17
-42.02545,-20.71331,37,52,5,15
-42.02275,-20.71331,51,46,0,-5
-42.02005,-20.71331,54,39,0,-15
-42.01713,-20.71331,49,35,5,-14
-42.01444,-20.71331,46,45,5,-1
-42.01174,-20.71331,48,44,5,-4
-42.00882,-20.71331,46,40,5,-6
-42.00612,-20.71331,55,35,5,-20
-42.00342,-20.71331,56,45,5,-11
-42.0005,-20.71331,56,45,5,-11
-41.99781,-20.71331,55,39,5,-16
-41.99511,-20.71331,56,36,5,-20
-41.99219,-20.71331,60,38,0,-22
-41.98949,-20.71331,56,23,0,-33
-41.98657,-20.71331,57,30,0,-27
-41.98387,-20.71331,55,44,0,-11
-41.98118,-20.71331,53,35,0,-18
-41.97826,-20.71331,64,39,0,-25
-41.97556,-20.71331,63,36,5,-27
-41.97286,-20.71331,53,38,5,-15
-41.96994,-20.71331,53,41,0,-12
-42.1005,-20.7131,65,35,5,-30
-42.0978,-20.7131,62,37,5,-25
-42.09511,-20.7131,66,37,0,-29
-42.09219,-20.7131,63,36,0,-27
-42.08949,-20.7131,55,34,0,-21
-42.08657,-20.7131,55,36,0,-19
-42.08387,-20.7131,66,36,0,-30
-42.08118,-20.7131,60,32,5,-28
-42.07825,-20.7131,54,31,5,-23
-42.07556,-20.7131,59,33,5,-26
-42.07286,-20.7131,60,41,0,-19
-42.06994,-20.7131,36,36,5,0
-42.06724,-20.7131,43,38,5,-5
-42.06455,-20.7131,44,38,5,-6
-42.06163,-20.7131,45,45,5,0
-42.05893,-20.7131,25,47,5,22
-42.05601,-20.7131,45,71,0,26
-42.05331,-20.7131,30,52,5,22
-42.05061,-20.7131,30,52,5,22
-42.04769,-20.7131,40,56,5,16
-42.045,-20.7131,33,58,5,25
-42.0423,-20.7131,33,45,5,12
-42.03938,-20.7131,39,53,0,14
-42.03668,-20.7131,42,45,2,3
-42.03399,-20.7131,38,38,6,0
-42.03106,-20.7131,39,46,5,7
-42.02837,-20.7131,33,52,5,19
-42.02545,-20.7131,39,51,5,12
-42.02275,-20.7131,49,47,0,-2
-42.02005,-20.7131,54,39,0,-15
-42.01713,-20.7131,48,35,5,-13
-42.01444,-20.7131,46,46,5,0
-42.01174,-20.7131,50,43,5,-7
-42.00882,-20.7131,47,41,5,-6
-42.00612,-20.7131,53,37,5,-16
-42.00342,-20.7131,56,43,5,-13
-42.0005,-20.7131,56,45,5,-11
-41.99781,-20.7131,56,39,0,-17
-41.99511,-20.7131,56,37,0,-19
-41.99219,-20.7131,58,40,0,-18
-41.98949,-20.7131,56,25,0,-31
-41.98657,-20.7131,57,30,0,-27
-41.98387,-20.7131,56,44,0,-12
-41.98118,-20.7131,54,35,0,-19
-41.97826,-20.7131,66,38,0,-28
-41.97556,-20.7131,63,40,5,-23
-41.97286,-20.7131,56,41,5,-15
-41.96994,-20.7131,53,41,0,-12
-42.1005,-20.71268,64,32,5,-32
-42.0978,-20.71268,62,37,5,-25
-42.09511,-20.71268,66,37,0,-29
-42.09219,-20.71268,57,36,0,-21
-42.08949,-20.71268,57,34,0,-23
-42.08657,-20.71268,55,35,0,-20
-42.08387,-20.71268,66,31,5,-35
-42.08118,-20.71268,59,36,5,-23
-42.07825,-20.71268,55,34,5,-21
-42.07556,-20.71268,59,33,5,-26
-42.07286,-20.71268,60,41,0,-19
-42.06994,-20.71268,45,38,5,-7
-42.06724,-20.71268,39,39,5,0
-42.06455,-20.71268,45,40,5,-5
-42.06163,-20.71268,46,47,5,1
-42.05893,-20.71268,35,46,5,11
-42.05601,-20.71268,44,74,0,30
-42.05331,-20.71268,34,52,5,18
-42.05061,-20.71268,30,54,5,24
-42.04769,-20.71268,37,61,5,24
-42.045,-20.71268,38,55,5,17
-42.0423,-20.71268,27,45,5,18
-42.03938,-20.71268,38,51,0,13
-42.03668,-20.71268,42,44,2,2
-42.03399,-20.71268,38,40,2,2
-42.03106,-20.71268,38,47,11,9
-42.02837,-20.71268,31,54,5,23
-42.02545,-20.71268,37,51,5,14
-42.02275,-20.71268,47,48,0,1
-42.02005,-20.71268,51,40,5,-11
-42.01713,-20.71268,48,35,5,-13
-42.01444,-20.71268,45,45,5,0
-42.01174,-20.71268,51,43,5,-8
-42.00882,-20.71268,47,41,0,-6
-42.00612,-20.71268,52,36,5,-16
-42.00342,-20.71268,55,43,5,-12
-42.0005,-20.71268,56,47,5,-9
-41.99781,-20.71268,55,39,0,-16
-41.99511,-20.71268,56,37,0,-19
-41.99219,-20.71268,56,41,0,-15
-41.98949,-20.71268,55,32,0,-23
-41.98657,-20.71268,56,29,0,-27
-41.98387,-20.71268,56,44,0,-12
-41.98118,-20.71268,55,35,0,-20
-41.97826,-20.71268,64,38,0,-26
-41.97556,-20.71268,63,41,0,-22
-41.97286,-20.71268,58,41,0,-17
-41.96994,-20.71268,52,41,0,-11
-42.1005,-20.71246,65,30,5,-35
-42.0978,-20.71246,61,37,0,-24
-42.09511,-20.71246,66,37,0,-29
-42.09219,-20.71246,52,37,0,-15
-42.08949,-20.71246,55,35,0,-20
-42.08657,-20.71246,57,36,11,-21
-42.08387,-20.71246,66,29,5,-37
-42.08118,-20.71246,58,37,0,-21
-42.07825,-20.71246,55,35,0,-20
-42.07556,-20.71246,60,33,5,-27
-42.07286,-20.71246,62,41,0,-21
-42.06994,-20.71246,50,37,5,-13
-42.06724,-20.71246,34,38,5,4
-42.06455,-20.71246,45,45,5,0
-42.06163,-20.71246,45,45,5,0
-42.05893,-20.71246,39,47,5,8
-42.05601,-20.71246,44,75,0,31
-42.05331,-20.71246,34,51,5,17
-42.05061,-20.71246,30,56,5,26
-42.04769,-20.71246,36,61,5,25
-42.045,-20.71246,39,54,5,15
-42.0423,-20.71246,27,46,5,19
-42.03938,-20.71246,37,51,0,14
-42.03668,-20.71246,42,44,2,2
-42.03399,-20.71246,38,42,5,4
-42.03106,-20.71246,38,50,5,12
-42.02837,-20.71246,29,53,5,24
-42.02545,-20.71246,38,50,5,12
-42.02275,-20.71246,44,47,0,3
-42.02005,-20.71246,54,40,5,-14
-42.01713,-20.71246,48,35,5,-13
-42.01444,-20.71246,45,45,5,0
-42.01174,-20.71246,50,45,5,-5
-42.00882,-20.71246,48,41,0,-7
-42.00612,-20.71246,54,35,5,-19
-42.00342,-20.71246,54,44,5,-10
-42.0005,-20.71246,56,47,5,-9
-41.99781,-20.71246,57,39,0,-18
-41.99511,-20.71246,56,37,0,-19
-41.99219,-20.71246,56,41,0,-15
-41.98949,-20.71246,55,32,0,-23
-41.98657,-20.71246,58,28,0,-30
-41.98387,-20.71246,56,42,0,-14
-41.98118,-20.71246,55,34,0,-21
-41.97826,-20.71246,62,38,0,-24
-41.97556,-20.71246,63,41,0,-22
-41.97286,-20.71246,58,41,0,-17
-41.96994,-20.71246,52,41,5,-11
-42.10297,-20.71225,61,36,5,-25
-42.10275,-20.71225,61,36,5,-25
-42.10252,-20.71225,62,36,5,-26
-42.1023,-20.71225,62,35,5,-27
-42.10185,-20.71225,63,32,5,-31
-42.10163,-20.71225,64,32,5,-32
-42.1014,-20.71225,64,30,5,-34
-42.10118,-20.71225,64,30,5,-34
-42.10073,-20.71225,65,29,5,-36
-42.1005,-20.71225,65,28,5,-37
-42.10028,-20.71225,65,30,5,-35
-42.10005,-20.71225,65,33,5,-32
-42.09983,-20.71225,66,30,5,-36
-42.09938,-20.71225,66,36,5,-30
-42.09915,-20.71225,66,36,5,-30
-42.09893,-20.71225,60,37,5,-23
-42.0987,-20.71225,59,37,0,-22
-42.09825,-20.71225,60,37,0,-23
-42.09803,-20.71225,61,37,0,-24
-42.0978,-20.71225,61,37,0,-24
-42.09758,-20.71225,62,37,0,-25
-42.09713,-20.71225,62,37,0,-25
-42.09691,-20.71225,63,37,0,-26
-42.09668,-20.71225,63,37,0,-26
-42.09646,-20.71225,64,37,0,-27
-42.09601,-20.71225,65,37,0,-28
-42.09578,-20.71225,65,37,0,-28
-42.09556,-20.71225,65,37,0,-28
-42.09533,-20.71225,65,37,0,-28
-42.09511,-20.71225,65,37,0,-28
-42.09466,-20.71225,66,37,0,-29
-42.09443,-20.71225,66,37,0,-29
-42.09421,-20.71225,68,37,0,-31
-42.09398,-20.71225,69,37,0,-32
-42.09354,-20.71225,63,37,0,-26
-42.09331,-20.71225,66,37,0,-29
-42.09309,-20.71225,68,37,0,-31
-42.09286,-20.71225,58,37,0,-21
-42.09241,-20.71225,51,37,0,-14
-42.09219,-20.71225,51,37,0,-14
-42.09196,-20.71225,52,37,0,-15
-42.09174,-20.71225,52,37,0,-15
-42.09129,-20.71225,52,37,0,-15
-42.09106,-20.71225,53,37,0,-16
-42.09084,-20.71225,53,37,0,-16
-42.09061,-20.71225,53,37,0,-16
-42.09039,-20.71225,53,37,0,-16
-42.08994,-20.71225,53,36,0,-17
-42.08972,-20.71225,54,36,0,-18
-42.08949,-20.71225,56,36,0,-20
-42.08927,-20.71225,53,36,0,-17
-42.08882,-20.71225,54,35,0,-19
-42.08859,-20.71225,55,35,0,-20
-42.08837,-20.71225,56,36,0,-20
-42.08814,-20.71225,57,36,0,-21
-42.08769,-20.71225,57,36,0,-21
-42.08747,-20.71225,58,36,0,-22
-42.08724,-20.71225,58,35,0,-23
-42.08702,-20.71225,59,36,0,-23
-42.08657,-20.71225,59,36,0,-23
-42.08634,-20.71225,59,36,0,-23
-42.08612,-20.71225,60,36,0,-24
-42.08589,-20.71225,60,36,0,-24
-42.08545,-20.71225,61,36,11,-25
-42.08522,-20.71225,62,36,11,-26
-42.085,-20.71225,62,36,11,-26
-42.08477,-20.71225,63,36,0,-27
-42.08455,-20.71225,63,36,0,-27
-42.0841,-20.71225,65,29,5,-36
-42.08387,-20.71225,66,29,5,-37
-42.08365,-20.71225,67,29,5,-38
-42.08342,-20.71225,68,30,5,-38
-42.08297,-20.71225,69,33,5,-36
-42.08275,-20.71225,68,33,5,-35
-42.08252,-20.71225,69,35,5,-34
-42.0823,-20.71225,69,35,5,-34
-42.08185,-20.71225,68,34,5,-34
-42.08163,-20.71225,67,34,5,-33
-42.0814,-20.71225,64,37,5,-27
-42.08118,-20.71225,62,37,0,-25
-42.08073,-20.71225,59,37,0,-22
-42.0805,-20.71225,54,37,0,-17
-42.08028,-20.71225,54,37,0,-17
-42.08005,-20.71225,55,37,0,-18
-42.07983,-20.71225,55,37,0,-18
-42.07938,-20.71225,55,36,0,-19
-42.07915,-20.71225,56,36,0,-20
-42.07893,-20.71225,57,36,0,-21
-42.0787,-20.71225,57,36,0,-21
-42.07825,-20.71225,57,36,0,-21
-42.07803,-20.71225,57,35,0,-22
-42.07781,-20.71225,57,34,5,-23
-42.07758,-20.71225,57,34,5,-23
-42.07713,-20.71225,58,33,5,-25
-42.07691,-20.71225,58,33,5,-25
-42.07668,-20.71225,59,32,5,-27
-42.07646,-20.71225,59,33,5,-26
-42.07601,-20.71225,59,33,5,-26
-42.07578,-20.71225,59,33,5,-26
-42.07556,-20.71225,60,33,5,-27
-42.07533,-20.71225,60,34,5,-26
-42.07511,-20.71225,59,34,5,-25
-42.07466,-20.71225,59,36,5,-23
-42.07443,-20.71225,59,36,5,-23
-42.07421,-20.71225,60,36,5,-24
-42.07399,-20.71225,61,39,5,-22
-42.07354,-20.71225,61,41,5,-20
-42.07331,-20.71225,61,41,5,-20
-42.07309,-20.71225,63,41,0,-22
-42.07286,-20.71225,63,41,0,-22
-42.07241,-20.71225,62,40,0,-22
-42.07219,-20.71225,58,40,0,-18
-42.07196,-20.71225,55,40,0,-15
-42.07174,-20.71225,55,40,0,-15
-42.07129,-20.71225,51,40,0,-11
-42.07106,-20.71225,51,40,0,-11
-42.07084,-20.71225,52,40,5,-12
-42.07061,-20.71225,53,37,5,-16
-42.07039,-20.71225,55,37,5,-18
-42.06994,-20.71225,54,37,5,-17
-42.06972,-20.71225,53,37,5,-16
-42.06949,-20.71225,50,37,5,-13
-42.06927,-20.71225,39,37,5,-2
-42.06882,-20.71225,29,36,5,7
-42.06859,-20.71225,39,37,5,-2
-42.06837,-20.71225,39,37,5,-2
-42.06814,-20.71225,37,37,5,0
-42.06769,-20.71225,40,38,5,-2
-42.06747,-20.71225,39,38,5,-1
-42.06724,-20.71225,38,38,5,0
-42.06702,-20.71225,40,40,5,0
-42.06657,-20.71225,40,39,5,-1
-42.06634,-20.71225,40,39,5,-1
-42.06612,-20.71225,41,38,5,-3
-42.0659,-20.71225,42,38,5,-4
-42.06545,-20.71225,43,38,5,-5
-42.06522,-20.71225,44,44,5,0
-42.065,-20.71225,45,44,5,-1
-42.06477,-20.71225,45,45,5,0
-42.06455,-20.71225,45,45,5,0
-42.0641,-20.71225,46,45,5,-1
-42.06387,-20.71225,46,45,5,-1
-42.06365,-20.71225,47,45,5,-2
-42.06342,-20.71225,47,45,5,-2
-42.06297,-20.71225,46,45,5,-1
-42.06275,-20.71225,45,44,5,-1
-42.06252,-20.71225,45,44,5,-1
-42.0623,-20.71225,45,45,5,0
-42.06185,-20.71225,45,45,5,0
-42.06163,-20.71225,45,45,5,0
-42.0614,-20.71225,45,45,5,0
-42.06118,-20.71225,46,46,5,0
-42.06073,-20.71225,47,47,5,0
-42.0605,-20.71225,48,48,5,0
-42.06028,-20.71225,48,48,5,0
-42.06005,-20.71225,46,51,0,5
-42.05983,-20.71225,46,51,0,5
-42.05938,-20.71225,45,47,5,2
-42.05915,-20.71225,43,47,5,4
-42.05893,-20.71225,42,47,5,5
-42.0587,-20.71225,42,46,5,4
-42.05826,-20.71225,43,46,0,3
-42.05803,-20.71225,44,47,0,3
-42.05781,-20.71225,45,49,0,4
-42.05758,-20.71225,45,52,0,7
-42.05713,-20.71225,46,56,0,10
-42.05691,-20.71225,46,61,0,15
-42.05668,-20.71225,46,75,0,29
-42.05646,-20.71225,45,75,0,30
-42.05601,-20.71225,48,75,0,27
-42.05578,-20.71225,42,75,0,33
-42.05556,-20.71225,38,75,0,37
-42.05533,-20.71225,34,75,0,41
-42.05511,-20.71225,32,74,0,42
-42.05466,-20.71225,29,58,0,29
-42.05443,-20.71225,26,55,0,29
-42.05421,-20.71225,30,51,0,21
-42.05399,-20.71225,36,51,5,15
-42.05354,-20.71225,39,50,5,11
-42.05331,-20.71225,34,50,5,16
-42.05309,-20.71225,39,51,5,12
-42.05286,-20.71225,33,52,5,19
-42.05241,-20.71225,28,53,5,25
-42.05219,-20.71225,27,53,5,26
-42.05196,-20.71225,27,53,5,26
-42.05174,-20.71225,10,53,5,43
-42.05129,-20.71225,22,55,5,33
-42.05106,-20.71225,27,55,5,28
-42.05084,-20.71225,17,55,5,38
-42.05061,-20.71225,27,56,5,29
-42.05039,-20.71225,28,56,5,28
-42.04994,-20.71225,27,57,5,30
-42.04972,-20.71225,34,57,5,23
-42.04949,-20.71225,35,57,5,22
-42.04927,-20.71225,38,57,5,19
-42.04882,-20.71225,32,59,5,27
-42.04859,-20.71225,31,60,5,29
-42.04837,-20.71225,33,60,5,27
-42.04814,-20.71225,34,60,5,26
-42.04769,-20.71225,36,60,5,24
-42.04747,-20.71225,36,60,5,24
-42.04724,-20.71225,37,60,5,23
-42.04702,-20.71225,38,59,5,21
-42.04657,-20.71225,39,60,5,21
-42.04635,-20.71225,43,60,5,17
-42.04612,-20.71225,44,60,5,16
-42.0459,-20.71225,45,60,5,15
-42.04545,-20.71225,44,55,5,11
-42.04522,-20.71225,44,54,5,10
-42.045,-20.71225,43,54,5,11
-42.04477,-20.71225,40,52,5,12
-42.04455,-20.71225,38,51,5,13
-42.0441,-20.71225,38,51,5,13
-42.04387,-20.71225,38,52,5,14
-42.04365,-20.71225,36,51,5,15
-42.04342,-20.71225,37,45,5,8
-42.04297,-20.71225,36,45,5,9
-42.04275,-20.71225,37,45,5,8
-42.04253,-20.71225,35,45,5,10
-42.0423,-20.71225,33,45,5,12
-42.04185,-20.71225,23,45,5,22
-42.04163,-20.71225,27,45,0,18
-42.0414,-20.71225,29,51,0,22
-42.04118,-20.71225,29,51,0,22
-42.04073,-20.71225,29,51,0,22
-42.0405,-20.71225,32,51,0,19
-42.04028,-20.71225,40,52,0,12
-42.04005,-20.71225,37,49,0,12
-42.03983,-20.71225,36,50,0,14
-42.03938,-20.71225,36,50,0,14
-42.03915,-20.71225,35,48,0,13
-42.03893,-20.71225,35,46,0,11
-42.0387,-20.71225,36,46,2,10
-42.03826,-20.71225,35,46,2,11
-42.03803,-20.71225,35,46,2,11
-42.03781,-20.71225,36,44,2,8
-42.03758,-20.71225,37,42,2,5
-42.03713,-20.71225,38,42,2,4
-42.03691,-20.71225,40,42,2,2
-42.03668,-20.71225,42,45,2,3
-42.03646,-20.71225,39,45,2,6
-42.03601,-20.71225,39,45,5,6
-42.03578,-20.71225,39,48,11,9
-42.03556,-20.71225,39,50,5,11
-42.03533,-20.71225,40,45,11,5
-42.03511,-20.71225,40,45,2,5
-42.03466,-20.71225,39,45,2,6
-42.03444,-20.71225,38,42,5,4
-42.03421,-20.71225,39,43,11,4
-42.03399,-20.71225,39,42,5,3
-42.03354,-20.71225,38,42,6,4
-42.03331,-20.71225,38,42,2,4
-42.03309,-20.71225,39,42,2,3
-42.03286,-20.71225,42,42,0,0
-42.03241,-20.71225,48,48,5,0
-42.03219,-20.71225,49,49,5,0
-42.03196,-20.71225,44,45,11,1
-42.03174,-20.71225,41,49,11,8
-42.03129,-20.71225,39,49,5,10
-42.03106,-20.71225,38,47,5,9
-42.03084,-20.71225,38,49,5,11
-42.03062,-20.71225,36,49,5,13
-42.03017,-20.71225,35,50,5,15
-42.02994,-20.71225,34,49,5,15
-42.02972,-20.71225,33,49,5,16
-42.02949,-20.71225,30,49,5,19
-42.02927,-20.71225,25,49,5,24
-42.02882,-20.71225,25,54,5,29
-42.02859,-20.71225,25,53,5,28
-42.02837,-20.71225,28,54,5,26
-42.02814,-20.71225,29,53,5,24
-42.02769,-20.71225,30,54,5,24
-42.02747,-20.71225,32,52,5,20
-42.02724,-20.71225,33,51,5,18
-42.02702,-20.71225,34,51,5,17
-42.02657,-20.71225,35,50,5,15
-42.02635,-20.71225,36,50,5,14
-42.02612,-20.71225,36,49,5,13
-42.0259,-20.71225,37,49,5,12
-42.02545,-20.71225,37,49,5,12
-42.02522,-20.71225,37,48,5,11
-42.025,-20.71225,37,48,5,11
-42.02477,-20.71225,40,48,5,8
-42.02455,-20.71225,40,48,0,8
-42.0241,-20.71225,41,49,0,8
-42.02387,-20.71225,40,49,0,9
-42.02365,-20.71225,40,49,0,9
-42.02342,-20.71225,40,47,0,7
-42.02297,-20.71225,41,47,0,6
-42.02275,-20.71225,44,49,0,5
-42.02253,-20.71225,44,49,0,5
-42.0223,-20.71225,45,46,0,1
-42.02185,-20.71225,47,47,0,0
-42.02163,-20.71225,50,48,0,-2
-42.0214,-20.71225,52,49,0,-3
-42.02118,-20.71225,55,49,0,-6
-42.02073,-20.71225,64,46,5,-18
-42.0205,-20.71225,61,43,5,-18
-42.02028,-20.71225,58,41,5,-17
-42.02005,-20.71225,57,40,5,-17
-42.01983,-20.71225,53,39,5,-14
-42.01938,-20.71225,56,37,5,-19
-42.01915,-20.71225,52,39,5,-13
-42.01893,-20.71225,55,40,5,-15
-42.01871,-20.71225,54,39,5,-15
-42.01826,-20.71225,56,39,5,-17
-42.01803,-20.71225,54,38,5,-16
-42.01781,-20.71225,51,38,5,-13
-42.01758,-20.71225,49,38,5,-11
-42.01713,-20.71225,49,35,5,-14
-42.01691,-20.71225,47,28,5,-19
-42.01668,-20.71225,46,29,5,-17
-42.01646,-20.71225,46,32,5,-14
-42.01601,-20.71225,45,38,5,-7
-42.01578,-20.71225,45,38,5,-7
-42.01556,-20.71225,44,39,5,-5
-42.01533,-20.71225,44,42,5,-2
-42.01511,-20.71225,44,45,5,1
-42.01466,-20.71225,46,46,5,0
-42.01444,-20.71225,48,45,5,-3
-42.01421,-20.71225,51,45,5,-6
-42.01399,-20.71225,53,45,5,-8
-42.01354,-20.71225,54,44,5,-10
-42.01331,-20.71225,55,43,5,-12
-42.01309,-20.71225,55,43,5,-12
-42.01286,-20.71225,54,43,5,-11
-42.01241,-20.71225,53,45,5,-8
-42.01219,-20.71225,52,46,5,-6
-42.01196,-20.71225,51,45,5,-6
-42.01174,-20.71225,50,45,5,-5
-42.01129,-20.71225,51,43,5,-8
-42.01106,-20.71225,50,41,5,-9
-42.01084,-20.71225,50,41,5,-9
-42.01062,-20.71225,49,41,5,-8
-42.01017,-20.71225,53,42,5,-11
-42.00994,-20.71225,53,41,5,-12
-42.00972,-20.71225,48,41,5,-7
-42.00949,-20.71225,48,41,0,-7
-42.00927,-20.71225,48,41,0,-7
-42.00882,-20.71225,48,40,0,-8
-42.00859,-20.71225,47,40,0,-7
-42.00837,-20.71225,47,39,0,-8
-42.00814,-20.71225,52,39,0,-13
-42.00769,-20.71225,50,38,0,-12
-42.00747,-20.71225,47,37,0,-10
-42.00724,-20.71225,47,37,0,-10
-42.00702,-20.71225,48,36,0,-12
-42.00657,-20.71225,47,36,0,-11
-42.00635,-20.71225,54,35,0,-19
-42.00612,-20.71225,54,34,5,-20
-42.0059,-20.71225,54,34,5,-20
-42.00545,-20.71225,53,32,5,-21
-42.00522,-20.71225,54,31,5,-23
-42.005,-20.71225,59,29,5,-30
-42.00477,-20.71225,57,32,5,-25
-42.00455,-20.71225,55,36,5,-19
-42.0041,-20.71225,56,41,5,-15
-42.00387,-20.71225,54,42,5,-12
-42.00365,-20.71225,54,44,5,-10
-42.00342,-20.71225,57,45,5,-12
-42.00298,-20.71225,54,45,5,-9
-42.00275,-20.71225,54,40,5,-14
-42.00253,-20.71225,54,39,5,-15
-42.0023,-20.71225,54,39,5,-15
-42.00185,-20.71225,54,41,5,-13
-42.00163,-20.71225,55,49,5,-6
-42.0014,-20.71225,55,49,5,-6
-42.00118,-20.71225,61,51,5,-10
-42.00073,-20.71225,57,51,5,-6
-42.0005,-20.71225,56,42,5,-14
-42.00028,-20.71225,56,39,5,-17
-42.00005,-20.71225,56,38,5,-18
-41.99983,-20.71225,56,38,5,-18
-41.99938,-20.71225,56,39,5,-17
-41.99916,-20.71225,56,39,0,-17
-41.99893,-20.71225,56,40,0,-16
-41.99871,-20.71225,56,40,0,-16
-41.99826,-20.71225,55,39,0,-16
-41.99803,-20.71225,55,40,0,-15
-41.99781,-20.71225,57,39,0,-18
-41.99758,-20.71225,55,39,0,-16
-41.99713,-20.71225,55,38,0,-17
-41.99691,-20.71225,56,38,0,-18
-41.99668,-20.71225,56,38,0,-18
-41.99646,-20.71225,55,38,0,-17
-41.99601,-20.71225,55,38,0,-17
-41.99578,-20.71225,56,38,0,-18
-41.99556,-20.71225,56,37,0,-19
-41.99533,-20.71225,56,37,0,-19
-41.99511,-20.71225,56,37,0,-19
-41.99466,-20.71225,56,37,0,-19
-41.99444,-20.71225,56,37,0,-19
-41.99421,-20.71225,56,36,0,-20
-41.99399,-20.71225,56,36,0,-20
-41.99354,-20.71225,56,37,0,-19
-41.99331,-20.71225,56,37,0,-19
-41.99309,-20.71225,56,37,0,-19
-41.99286,-20.71225,56,37,0,-19
-41.99241,-20.71225,56,40,0,-16
-41.99219,-20.71225,56,41,0,-15
-41.99196,-20.71225,56,42,0,-14
-41.99174,-20.71225,56,42,0,-14
-41.99129,-20.71225,56,42,0,-14
-41.99107,-20.71225,56,42,0,-14
-41.99084,-20.71225,55,40,0,-15
-41.99062,-20.71225,55,36,0,-19
-41.99017,-20.71225,55,35,0,-20
-41.98994,-20.71225,55,35,0,-20
-41.98972,-20.71225,55,33,0,-22
-41.98949,-20.71225,55,32,0,-23
-41.98927,-20.71225,61,31,0,-30
-41.98882,-20.71225,65,29,0,-36
-41.98859,-20.71225,63,28,0,-35
-41.98837,-20.71225,62,25,0,-37
-41.98814,-20.71225,61,22,0,-39
-41.98769,-20.71225,61,20,0,-41
-41.98747,-20.71225,62,22,0,-40
-41.98725,-20.71225,61,24,0,-37
-41.98702,-20.71225,60,27,0,-33
-41.98657,-20.71225,59,28,0,-31
-41.98635,-20.71225,58,28,0,-30
-41.98612,-20.71225,58,28,0,-30
-41.9859,-20.71225,56,28,0,-28
-41.98545,-20.71225,56,29,0,-27
-41.98522,-20.71225,56,29,0,-27
-41.985,-20.71225,56,29,0,-27
-41.98477,-20.71225,59,32,0,-27
-41.98455,-20.71225,59,38,0,-21
-41.9841,-20.71225,56,41,0,-15
-41.98387,-20.71225,56,41,0,-15
-41.98365,-20.71225,56,41,0,-15
-41.98343,-20.71225,56,42,0,-14
-41.98298,-20.71225,56,43,0,-13
-41.98275,-20.71225,56,43,0,-13
-41.98253,-20.71225,56,43,0,-13
-41.9823,-20.71225,58,42,0,-16
-41.98185,-20.71225,59,37,0,-22
-41.98163,-20.71225,56,34,0,-22
-41.9814,-20.71225,55,34,0,-21
-41.98118,-20.71225,55,34,0,-21
-41.98073,-20.71225,55,37,0,-18
-41.9805,-20.71225,55,37,0,-18
-41.98028,-20.71225,55,37,0,-18
-41.98005,-20.71225,55,37,0,-18
-41.97983,-20.71225,54,38,0,-16
-41.97938,-20.71225,54,38,0,-16
-41.97916,-20.71225,65,38,0,-27
-41.97893,-20.71225,64,39,0,-25
-41.97871,-20.71225,64,39,0,-25
-41.97826,-20.71225,64,39,0,-25
-41.97803,-20.71225,64,40,0,-24
-41.97781,-20.71225,65,40,0,-25
-41.97758,-20.71225,65,40,0,-25
-41.97713,-20.71225,65,39,0,-26
-41.97691,-20.71225,65,39,0,-26
-41.97668,-20.71225,65,40,0,-25
-41.97646,-20.71225,64,40,0,-24
-41.97601,-20.71225,63,41,11,-22
-41.97578,-20.71225,63,41,0,-22
-41.97556,-20.71225,62,41,0,-21
-41.97534,-20.71225,62,41,0,-21
-41.97511,-20.71225,62,41,0,-21
-41.97466,-20.71225,61,41,0,-20
-41.97444,-20.71225,61,41,0,-20
-41.97421,-20.71225,60,41,0,-19
-41.97399,-20.71225,60,41,0,-19
-41.97354,-20.71225,59,41,0,-18
-41.97331,-20.71225,59,41,0,-18
-41.97309,-20.71225,58,41,0,-17
-41.97286,-20.71225,58,41,0,-17
-41.97241,-20.71225,58,41,0,-17
-41.97219,-20.71225,57,41,0,-16
-41.97196,-20.71225,56,41,0,-15
-41.97174,-20.71225,56,41,0,-15
-41.97129,-20.71225,56,41,0,-15
-41.97107,-20.71225,55,41,0,-14
-41.97084,-20.71225,53,42,0,-11
-41.97062,-20.71225,53,41,5,-12
-41.97017,-20.71225,52,32,5,-20
-41.96994,-20.71225,52,32,5,-20
-41.96972,-20.71225,52,35,5,-17
-41.96949,-20.71225,52,42,0,-10
-41.96927,-20.71225,52,42,0,-10
-42.1005,-20.71204,65,31,5,-34
-42.0978,-20.71204,61,37,0,-24
-42.09511,-20.71204,65,37,0,-28
-42.09219,-20.71204,52,37,0,-15
-42.08949,-20.71204,55,37,0,-18
-42.08657,-20.71204,60,36,0,-24
-42.08387,-20.71204,64,29,5,-35
-42.08118,-20.71204,64,37,0,-27
-42.07825,-20.71204,57,35,0,-22
-42.07556,-20.71204,60,34,5,-26
-42.07286,-20.71204,63,40,0,-23
-42.06994,-20.71204,55,37,5,-18
-42.06724,-20.71204,38,38,5,0
-42.06455,-20.71204,44,45,5,1
-42.06163,-20.71204,45,45,5,0
-42.05893,-20.71204,43,46,5,3
-42.05601,-20.71204,47,75,0,28
-42.05331,-20.71204,40,50,5,10
-42.05061,-20.71204,27,56,5,29
-42.04769,-20.71204,36,61,5,25
-42.045,-20.71204,43,52,5,9
-42.0423,-20.71204,27,45,5,18
-42.03938,-20.71204,37,48,0,11
-42.03668,-20.71204,41,44,2,3
-42.03399,-20.71204,39,43,5,4
-42.03106,-20.71204,38,47,5,9
-42.02837,-20.71204,25,53,5,28
-42.02545,-20.71204,37,48,5,11
-42.02275,-20.71204,41,47,0,6
-42.02005,-20.71204,61,40,5,-21
-42.01713,-20.71204,48,34,5,-14
-42.01444,-20.71204,49,47,5,-2
-42.01174,-20.71204,52,45,5,-7
-42.00882,-20.71204,48,41,0,-7
-42.00612,-20.71204,55,34,5,-21
-42.00342,-20.71204,59,44,5,-15
-42.0005,-20.71204,56,40,5,-16
-41.99781,-20.71204,56,40,0,-16
-41.99511,-20.71204,56,37,0,-19
-41.99219,-20.71204,56,40,0,-16
-41.98949,-20.71204,55,32,0,-23
-41.98657,-20.71204,59,28,0,-31
-41.98387,-20.71204,56,29,0,-27
-41.98118,-20.71204,56,35,0,-21
-41.97826,-20.71204,64,40,0,-24
-41.97556,-20.71204,61,41,0,-20
-41.97286,-20.71204,58,41,0,-17
-41.96994,-20.71204,52,31,5,-21
-42.1005,-20.71162,65,34,5,-31
-42.0978,-20.71162,61,37,0,-24
-42.09511,-20.71162,65,37,5,-28
-42.09219,-20.71162,51,37,0,-14
-42.08949,-20.71162,56,37,0,-19
-42.08657,-20.71162,60,36,0,-24
-42.08387,-20.71162,62,33,0,-29
-42.08118,-20.71162,64,37,0,-27
-42.07825,-20.71162,57,36,0,-21
-42.07556,-20.71162,60,34,5,-26
-42.07286,-20.71162,63,40,0,-23
-42.06994,-20.71162,55,37,5,-18
-42.06724,-20.71162,37,37,5,0
-42.06455,-20.71162,44,44,5,0
-42.06163,-20.71162,46,46,5,0
-42.05893,-20.71162,44,49,0,5
-42.05601,-20.71162,46,75,0,29
-42.05331,-20.71162,40,51,5,11
-42.05061,-20.71162,28,57,5,29
-42.04769,-20.71162,38,59,5,21
-42.045,-20.71162,43,53,5,10
-42.0423,-20.71162,24,44,5,20
-42.03938,-20.71162,41,47,0,6
-42.03668,-20.71162,40,45,5,5
-42.03399,-20.71162,38,43,11,5
-42.03106,-20.71162,38,46,5,8
-42.02837,-20.71162,24,53,5,29
-42.02545,-20.71162,37,47,5,10
-42.02275,-20.71162,40,47,0,7
-42.02005,-20.71162,59,40,5,-19
-42.01713,-20.71162,48,34,5,-14
-42.01444,-20.71162,48,47,5,-1
-42.01174,-20.71162,51,47,5,-4
-42.00882,-20.71162,48,39,0,-9
-42.00612,-20.71162,54,33,5,-21
-42.00342,-20.71162,59,43,5,-16
-42.0005,-20.71162,57,40,5,-17
-41.99781,-20.71162,56,39,0,-17
-41.99511,-20.71162,55,37,0,-18
-41.99219,-20.71162,55,39,0,-16
-41.98949,-20.71162,55,34,0,-21
-41.98657,-20.71162,60,26,0,-34
-41.98387,-20.71162,56,28,0,-28
-41.98118,-20.71162,56,38,0,-18
-41.97826,-20.71162,63,41,0,-22
-41.97556,-20.71162,61,42,0,-19
-41.97286,-20.71162,56,41,0,-15
-41.96994,-20.71162,52,33,5,-19
-42.1005,-20.71141,67,30,5,-37
-42.0978,-20.71141,61,37,0,-24
-42.09511,-20.71141,65,32,5,-33
-42.09219,-20.71141,51,37,0,-14
-42.08949,-20.71141,55,37,0,-18
-42.08657,-20.71141,59,36,0,-23
-42.08387,-20.71141,61,34,0,-27
-42.08118,-20.71141,62,37,0,-25
-42.07825,-20.71141,57,36,0,-21
-42.07556,-20.71141,60,33,5,-27
-42.07286,-20.71141,61,40,0,-21
-42.06994,-20.71141,54,36,5,-18
-42.06724,-20.71141,38,38,5,0
-42.06455,-20.71141,44,44,5,0
-42.06163,-20.71141,44,46,5,2
-42.05893,-20.71141,45,51,0,6
-42.05601,-20.71141,43,57,0,14
-42.05331,-20.71141,37,49,5,12
-42.05061,-20.71141,28,56,5,28
-42.04769,-20.71141,39,58,5,19
-42.045,-20.71141,43,52,5,9
-42.0423,-20.71141,22,44,5,22
-42.03938,-20.71141,40,46,5,6
-42.03668,-20.71141,40,46,5,6
-42.03399,-20.71141,38,45,11,7
-42.03106,-20.71141,37,46,5,9
-42.02837,-20.71141,24,50,5,26
-42.02545,-20.71141,36,47,5,11
-42.02275,-20.71141,39,47,0,8
-42.02005,-20.71141,60,45,5,-15
-42.01713,-20.71141,48,35,5,-13
-42.01444,-20.71141,48,44,5,-4
-42.01174,-20.71141,51,46,5,-5
-42.00882,-20.71141,48,38,0,-10
-42.00612,-20.71141,53,31,5,-22
-42.00342,-20.71141,57,43,5,-14
-42.0005,-20.71141,58,40,5,-18
-41.99781,-20.71141,55,39,0,-16
-41.99511,-20.71141,55,37,0,-18
-41.99219,-20.71141,55,39,0,-16
-41.98949,-20.71141,55,34,0,-21
-41.98657,-20.71141,60,25,0,-35
-41.98387,-20.71141,56,31,0,-25
-41.98118,-20.71141,56,37,0,-19
-41.97826,-20.71141,63,41,0,-22
-41.97556,-20.71141,60,42,0,-18
-41.97286,-20.71141,55,42,0,-13
-41.96994,-20.71141,52,33,5,-19
-42.1005,-20.7112,67,35,5,-32
-42.0978,-20.7112,61,37,0,-24
-42.09511,-20.7112,65,31,5,-34
-42.09219,-20.7112,52,37,0,-15
-42.08949,-20.7112,55,37,0,-18
-42.08657,-20.7112,56,36,0,-20
-42.08387,-20.7112,59,35,11,-24
-42.08118,-20.7112,65,37,0,-28
-42.07825,-20.7112,58,36,0,-22
-42.07556,-20.7112,60,33,5,-27
-42.07286,-20.7112,61,40,0,-21
-42.06994,-20.7112,54,36,5,-18
-42.06724,-20.7112,37,37,5,0
-42.06455,-20.7112,43,43,5,0
-42.06163,-20.7112,41,46,5,5
-42.05893,-20.7112,45,52,0,7
-42.05601,-20.7112,37,50,0,13
-42.05331,-20.7112,35,49,5,14
-42.05061,-20.7112,28,54,5,26
-42.04769,-20.7112,46,59,5,13
-42.045,-20.7112,42,52,5,10
-42.0423,-20.7112,11,44,5,33
-42.03938,-20.7112,45,46,5,1
-42.03668,-20.7112,39,46,5,7
-42.03399,-20.7112,38,46,11,8
-42.03106,-20.7112,36,46,5,10
-42.02837,-20.7112,23,51,5,28
-42.02545,-20.7112,35,47,0,12
-42.02275,-20.7112,39,47,0,8
-42.02005,-20.7112,53,45,0,-8
-42.01713,-20.7112,52,36,5,-16
-42.01444,-20.7112,51,44,5,-7
-42.01174,-20.7112,51,43,5,-8
-42.00882,-20.7112,48,38,0,-10
-42.00612,-20.7112,56,33,5,-23
-42.00342,-20.7112,58,43,5,-15
-42.0005,-20.7112,58,43,5,-15
-41.99781,-20.7112,55,38,0,-17
-41.99511,-20.7112,55,36,0,-19
-41.99219,-20.7112,55,39,0,-16
-41.98949,-20.7112,55,34,0,-21
-41.98657,-20.7112,61,32,0,-29
-41.98387,-20.7112,56,32,0,-24
-41.98118,-20.7112,56,36,0,-20
-41.97826,-20.7112,62,40,0,-22
-41.97556,-20.7112,58,42,5,-16
-41.97286,-20.7112,55,42,0,-13
-41.96994,-20.7112,52,33,5,-19
-42.1005,-20.71077,67,37,5,-30
-42.0978,-20.71077,62,37,5,-25
-42.09511,-20.71077,65,31,5,-34
-42.09219,-20.71077,52,36,5,-16
-42.08949,-20.71077,55,38,0,-17
-42.08657,-20.71077,55,36,0,-19
-42.08387,-20.71077,58,36,0,-22
-42.08118,-20.71077,67,37,0,-30
-42.07825,-20.71077,57,36,0,-21
-42.07556,-20.71077,60,33,5,-27
-42.07286,-20.71077,62,40,0,-22
-42.06994,-20.71077,56,35,5,-21
-42.06724,-20.71077,38,41,5,3
-42.06455,-20.71077,40,42,5,2
-42.06163,-20.71077,38,47,5,9
-42.05893,-20.71077,45,50,0,5
-42.05601,-20.71077,39,48,5,9
-42.05331,-20.71077,37,51,5,14
-42.05061,-20.71077,31,55,5,24
-42.04769,-20.71077,47,53,5,6
-42.045,-20.71077,41,50,5,9
-42.0423,-20.71077,27,45,5,18
-42.03938,-20.71077,44,46,5,2
-42.03668,-20.71077,39,47,5,8
-42.03399,-20.71077,38,50,0,12
-42.03106,-20.71077,33,45,5,12
-42.02837,-20.71077,22,46,5,24
-42.02545,-20.71077,34,49,0,15
-42.02275,-20.71077,38,48,0,10
-42.02005,-20.71077,50,45,0,-5
-42.01713,-20.71077,50,38,5,-12
-42.01444,-20.71077,53,40,5,-13
-42.01174,-20.71077,50,46,5,-4
-42.00882,-20.71077,48,40,0,-8
-42.00612,-20.71077,54,32,5,-22
-42.00342,-20.71077,59,36,5,-23
-42.0005,-20.71077,58,43,5,-15
-41.99781,-20.71077,55,40,0,-15
-41.99511,-20.71077,55,35,0,-20
-41.99219,-20.71077,54,38,0,-16
-41.98949,-20.71077,54,35,0,-19
-41.98657,-20.71077,61,39,0,-22
-41.98387,-20.71077,57,33,0,-24
-41.98118,-20.71077,56,28,0,-28
-41.97826,-20.71077,61,40,0,-21
-41.97556,-20.71077,55,34,5,-21
-41.97286,-20.71077,55,44,0,-11
-41.96994,-20.71077,52,34,5,-18
-42.1005,-20.71056,68,37,5,-31
-42.0978,-20.71056,62,34,5,-28
-42.09511,-20.71056,67,29,5,-38
-42.09219,-20.71056,52,32,5,-20
-42.08949,-20.71056,54,38,5,-16
-42.08657,-20.71056,55,37,0,-18
-42.08387,-20.71056,59,36,0,-23
-42.08118,-20.71056,65,37,0,-28
-42.07825,-20.71056,57,36,0,-21
-42.07556,-20.71056,60,32,5,-28
-42.07286,-20.71056,61,40,0,-21
-42.06994,-20.71056,61,37,5,-24
-42.06724,-20.71056,39,42,5,3
-42.06455,-20.71056,36,42,5,6
-42.06163,-20.71056,40,46,5,6
-42.05893,-20.71056,44,50,0,6
-42.05601,-20.71056,41,48,5,7
-42.05331,-20.71056,39,51,5,12
-42.05061,-20.71056,33,55,5,22
-42.04769,-20.71056,43,52,5,9
-42.045,-20.71056,38,50,5,12
-42.0423,-20.71056,31,44,5,13
-42.03938,-20.71056,43,46,5,3
-42.03668,-20.71056,38,47,5,9
-42.03399,-20.71056,37,47,0,10
-42.03106,-20.71056,30,46,5,16
-42.02837,-20.71056,22,46,5,24
-42.02545,-20.71056,34,48,0,14
-42.02275,-20.71056,38,48,0,10
-42.02005,-20.71056,46,46,0,0
-42.01713,-20.71056,48,38,5,-10
-42.01444,-20.71056,48,40,5,-8
-42.01174,-20.71056,50,47,5,-3
-42.00882,-20.71056,48,40,0,-8
-42.00612,-20.71056,53,33,5,-20
-42.00342,-20.71056,58,36,5,-22
-42.0005,-20.71056,58,41,5,-17
-41.99781,-20.71056,54,40,0,-14
-41.99511,-20.71056,55,36,0,-19
-41.99219,-20.71056,55,38,0,-17
-41.98949,-20.71056,54,35,0,-19
-41.98657,-20.71056,61,40,0,-21
-41.98387,-20.71056,58,34,0,-24
-41.98118,-20.71056,56,29,11,-27
-41.97826,-20.71056,59,38,0,-21
-41.97556,-20.71056,56,30,5,-26
-41.97286,-20.71056,55,44,0,-11
-41.96994,-20.71056,53,34,5,-19
-42.1005,-20.71035,69,37,5,-32
-42.0978,-20.71035,63,33,5,-30
-42.09511,-20.71035,67,29,5,-38
-42.09219,-20.71035,52,31,5,-21
-42.08949,-20.71035,54,38,5,-16
-42.08657,-20.71035,55,37,0,-18
-42.08387,-20.71035,58,36,0,-22
-42.08118,-20.71035,66,37,0,-29
-42.07825,-20.71035,57,36,0,-21
-42.07556,-20.71035,60,33,5,-27
-42.07286,-20.71035,61,40,0,-21
-42.06994,-20.71035,63,38,0,-25
-42.06724,-20.71035,44,43,5,-1
-42.06455,-20.71035,30,42,5,12
-42.06163,-20.71035,41,46,5,5
-42.05893,-20.71035,41,50,0,9
-42.05601,-20.71035,38,47,5,9
-42.05331,-20.71035,40,52,5,12
-42.05061,-20.71035,33,55,5,22
-42.04769,-20.71035,44,49,5,5
-42.045,-20.71035,34,47,5,13
-42.0423,-20.71035,34,44,5,10
-42.03938,-20.71035,43,46,5,3
-42.03668,-20.71035,38,47,5,9
-42.03399,-20.71035,38,46,0,8
-42.03106,-20.71035,28,45,5,17
-42.02837,-20.71035,22,46,5,24
-42.02545,-20.71035,32,48,0,16
-42.02275,-20.71035,37,46,0,9
-42.02005,-20.71035,50,47,0,-3
-42.01713,-20.71035,49,37,5,-12
-42.01444,-20.71035,51,41,5,-10
-42.01174,-20.71035,50,48,0,-2
-42.00882,-20.71035,48,41,0,-7
-42.00612,-20.71035,54,33,5,-21
-42.00342,-20.71035,58,35,5,-23
-42.0005,-20.71035,57,42,5,-15
-41.99781,-20.71035,53,40,0,-13
-41.99511,-20.71035,54,36,0,-18
-41.99219,-20.71035,54,38,0,-16
-41.98949,-20.71035,54,35,0,-19
-41.98657,-20.71035,61,40,0,-21
-41.98387,-20.71035,58,33,0,-25
-41.98118,-20.71035,56,38,0,-18
-41.97826,-20.71035,56,37,0,-19
-41.97556,-20.71035,55,30,5,-25
-41.97286,-20.71035,55,44,0,-11
-41.96994,-20.71035,54,37,5,-17
-42.1005,-20.70993,69,37,0,-32
-42.0978,-20.70993,63,34,5,-29
-42.09511,-20.70993,68,37,0,-31
-42.09219,-20.70993,60,32,5,-28
-42.08949,-20.70993,54,38,5,-16
-42.08657,-20.70993,55,36,0,-19
-42.08387,-20.70993,58,36,0,-22
-42.08118,-20.70993,63,36,0,-27
-42.07825,-20.70993,57,36,0,-21
-42.07556,-20.70993,60,33,5,-27
-42.07286,-20.70993,61,39,0,-22
-42.06994,-20.70993,63,42,0,-21
-42.06724,-20.70993,55,43,5,-12
-42.06455,-20.70993,25,41,5,16
-42.06163,-20.70993,41,44,5,3
-42.05893,-20.70993,47,51,0,4
-42.05601,-20.70993,31,46,5,15
-42.05331,-20.70993,40,56,5,16
-42.05061,-20.70993,35,54,5,19
-42.04769,-20.70993,45,48,5,3
-42.045,-20.70993,29,47,0,18
-42.0423,-20.70993,37,43,5,6
-42.03938,-20.70993,42,47,5,5
-42.03668,-20.70993,38,46,5,8
-42.03399,-20.70993,38,46,0,8
-42.03106,-20.70993,28,45,5,17
-42.02837,-20.70993,30,44,5,14
-42.02545,-20.70993,31,48,0,17
-42.02275,-20.70993,37,44,5,7
-42.02005,-20.70993,49,46,0,-3
-42.01713,-20.70993,49,40,11,-9
-42.01444,-20.70993,51,42,5,-9
-42.01174,-20.70993,51,47,0,-4
-42.00882,-20.70993,48,42,0,-6
-42.00612,-20.70993,52,34,5,-18
-42.00342,-20.70993,58,35,5,-23
-42.0005,-20.70993,56,38,5,-18
-41.99781,-20.70993,53,39,0,-14
-41.99511,-20.70993,54,36,0,-18
-41.99219,-20.70993,55,37,0,-18
-41.98949,-20.70993,53,35,0,-18
-41.98657,-20.70993,61,40,0,-21
-41.98387,-20.70993,58,34,0,-24
-41.98118,-20.70993,56,39,0,-17
-41.97826,-20.70993,57,39,11,-18
-41.97556,-20.70993,56,31,5,-25
-41.97286,-20.70993,55,44,0,-11
-41.96994,-20.70993,53,39,5,-14
-42.1005,-20.70972,68,37,0,-31
-42.0978,-20.70972,65,34,5,-31
-42.09511,-20.70972,67,38,0,-29
-42.09219,-20.70972,64,32,5,-32
-42.08949,-20.70972,54,38,5,-16
-42.08657,-20.70972,56,37,0,-19
-42.08387,-20.70972,58,36,0,-22
-42.08118,-20.70972,62,35,0,-27
-42.07825,-20.70972,58,35,0,-23
-42.07556,-20.70972,60,33,5,-27
-42.07286,-20.70972,61,40,0,-21
-42.06994,-20.70972,62,43,0,-19
-42.06724,-20.70972,57,42,5,-15
-42.06455,-20.70972,25,41,5,16
-42.06163,-20.70972,45,45,5,0
-42.05893,-20.70972,39,51,0,12
-42.05601,-20.70972,25,45,5,20
-42.05331,-20.70972,41,55,5,14
-42.05061,-20.70972,37,52,5,15
-42.04769,-20.70972,44,48,5,4
-42.045,-20.70972,29,48,0,19
-42.0423,-20.70972,42,42,5,0
-42.03938,-20.70972,42,46,5,4
-42.03668,-20.70972,37,46,5,9
-42.03399,-20.70972,37,47,0,10
-42.03106,-20.70972,28,44,11,16
-42.02837,-20.70972,33,44,0,11
-42.02545,-20.70972,29,48,0,19
-42.02275,-20.70972,36,45,5,9
-42.02005,-20.70972,51,47,0,-4
-42.01713,-20.70972,50,40,5,-10
-42.01444,-20.70972,51,44,5,-7
-42.01174,-20.70972,52,47,0,-5
-42.00882,-20.70972,48,42,0,-6
-42.00612,-20.70972,52,34,5,-18
-42.00342,-20.70972,57,36,5,-21
-42.0005,-20.70972,56,37,5,-19
-41.99781,-20.70972,52,39,0,-13
-41.99511,-20.70972,53,36,0,-17
-41.99219,-20.70972,55,37,0,-18
-41.98949,-20.70972,53,35,0,-18
-41.98657,-20.70972,64,40,0,-24
-41.98387,-20.70972,58,36,0,-22
-41.98118,-20.70972,56,40,0,-16
-41.97826,-20.70972,56,39,0,-17
-41.97556,-20.70972,56,30,5,-26
-41.97286,-20.70972,55,44,0,-11
-41.96994,-20.70972,53,38,5,-15
-42.10297,-20.7095,60,30,5,-30
-42.10275,-20.7095,63,32,5,-31
-42.10252,-20.7095,63,34,5,-29
-42.1023,-20.7095,64,34,5,-30
-42.10185,-20.7095,65,34,5,-31
-42.10163,-20.7095,65,34,5,-31
-42.1014,-20.7095,68,34,5,-34
-42.10118,-20.7095,68,33,5,-35
-42.10073,-20.7095,65,37,5,-28
-42.1005,-20.7095,66,37,0,-29
-42.10028,-20.7095,62,37,0,-25
-42.10005,-20.7095,61,37,0,-24
-42.09983,-20.7095,62,37,0,-25
-42.09938,-20.7095,62,33,5,-29
-42.09915,-20.7095,62,33,5,-29
-42.09893,-20.7095,63,30,5,-33
-42.0987,-20.7095,63,32,5,-31
-42.09825,-20.7095,64,32,5,-32
-42.09803,-20.7095,65,33,5,-32
-42.0978,-20.7095,65,35,5,-30
-42.09758,-20.7095,65,34,5,-31
-42.09713,-20.7095,66,33,5,-33
-42.09691,-20.7095,66,28,5,-38
-42.09668,-20.7095,67,29,5,-38
-42.09646,-20.7095,67,29,5,-38
-42.09601,-20.7095,68,31,5,-37
-42.09578,-20.7095,67,33,5,-34
-42.09556,-20.7095,67,37,5,-30
-42.09533,-20.7095,68,38,0,-30
-42.09511,-20.7095,67,38,0,-29
-42.09466,-20.7095,66,37,0,-29
-42.09443,-20.7095,68,37,5,-31
-42.09421,-20.7095,66,31,5,-35
-42.09398,-20.7095,65,32,5,-33
-42.09354,-20.7095,65,35,5,-30
-42.09331,-20.7095,64,37,5,-27
-42.09309,-20.7095,65,37,5,-28
-42.09286,-20.7095,63,36,5,-27
-42.09241,-20.7095,62,35,5,-27
-42.09219,-20.7095,63,33,5,-30
-42.09196,-20.7095,62,30,5,-32
-42.09174,-20.7095,56,29,5,-27
-42.09129,-20.7095,52,29,5,-23
-42.09106,-20.7095,52,29,5,-23
-42.09084,-20.7095,53,30,5,-23
-42.09061,-20.7095,53,30,5,-23
-42.09039,-20.7095,53,30,5,-23
-42.08994,-20.7095,54,30,5,-24
-42.08972,-20.7095,54,36,5,-18
-42.08949,-20.7095,54,38,5,-16
-42.08927,-20.7095,55,38,0,-17
-42.08882,-20.7095,55,38,0,-17
-42.08859,-20.7095,55,38,0,-17
-42.08837,-20.7095,56,38,0,-18
-42.08814,-20.7095,56,38,0,-18
-42.08769,-20.7095,56,37,0,-19
-42.08747,-20.7095,56,37,0,-19
-42.08724,-20.7095,56,37,0,-19
-42.08702,-20.7095,56,37,0,-19
-42.08657,-20.7095,56,37,5,-19
-42.08634,-20.7095,57,36,5,-21
-42.08612,-20.7095,57,36,5,-21
-42.08589,-20.7095,57,36,5,-21
-42.08545,-20.7095,57,37,0,-20
-42.08522,-20.7095,57,37,0,-20
-42.085,-20.7095,57,37,0,-20
-42.08477,-20.7095,58,37,0,-21
-42.08455,-20.7095,58,37,0,-21
-42.0841,-20.7095,58,36,0,-22
-42.08387,-20.7095,58,36,0,-22
-42.08365,-20.7095,58,36,0,-22
-42.08342,-20.7095,59,36,0,-23
-42.08297,-20.7095,59,36,0,-23
-42.08275,-20.7095,59,36,0,-23
-42.08252,-20.7095,59,36,0,-23
-42.0823,-20.7095,59,36,0,-23
-42.08185,-20.7095,60,36,0,-24
-42.08163,-20.7095,60,36,11,-24
-42.0814,-20.7095,60,35,5,-25
-42.08118,-20.7095,61,32,5,-29
-42.08073,-20.7095,62,33,5,-29
-42.0805,-20.7095,65,33,5,-32
-42.08028,-20.7095,66,34,5,-32
-42.08005,-20.7095,62,36,5,-26
-42.07983,-20.7095,60,37,0,-23
-42.07938,-20.7095,62,37,0,-25
-42.07915,-20.7095,61,37,0,-24
-42.07893,-20.7095,61,36,0,-25
-42.0787,-20.7095,62,36,0,-26
-42.07825,-20.7095,57,36,0,-21
-42.07803,-20.7095,57,35,0,-22
-42.07781,-20.7095,57,35,0,-22
-42.07758,-20.7095,57,35,0,-22
-42.07713,-20.7095,58,32,5,-26
-42.07691,-20.7095,58,32,5,-26
-42.07668,-20.7095,58,33,5,-25
-42.07646,-20.7095,59,33,5,-26
-42.07601,-20.7095,59,33,5,-26
-42.07578,-20.7095,59,33,5,-26
-42.07556,-20.7095,60,33,5,-27
-42.07533,-20.7095,60,33,5,-27
-42.07511,-20.7095,60,33,5,-27
-42.07466,-20.7095,60,35,5,-25
-42.07443,-20.7095,60,38,5,-22
-42.07421,-20.7095,60,38,0,-22
-42.07399,-20.7095,60,40,0,-20
-42.07354,-20.7095,61,40,0,-21
-42.07331,-20.7095,61,40,0,-21
-42.07309,-20.7095,61,40,0,-21
-42.07286,-20.7095,61,40,0,-21
-42.07241,-20.7095,61,39,0,-22
-42.07219,-20.7095,61,39,0,-22
-42.07196,-20.7095,61,37,5,-24
-42.07174,-20.7095,61,36,5,-25
-42.07129,-20.7095,61,36,5,-25
-42.07106,-20.7095,61,41,5,-20
-42.07084,-20.7095,61,40,5,-21
-42.07061,-20.7095,61,41,5,-20
-42.07039,-20.7095,61,42,5,-19
-42.06994,-20.7095,61,43,0,-18
-42.06972,-20.7095,61,43,0,-18
-42.06949,-20.7095,60,43,0,-17
-42.06927,-20.7095,61,43,0,-18
-42.06882,-20.7095,61,41,5,-20
-42.06859,-20.7095,60,40,5,-20
-42.06837,-20.7095,61,40,5,-21
-42.06814,-20.7095,61,41,5,-20
-42.06769,-20.7095,62,41,5,-21
-42.06747,-20.7095,61,42,5,-19
-42.06724,-20.7095,60,42,5,-18
-42.06702,-20.7095,57,43,5,-14
-42.06657,-20.7095,56,45,5,-11
-42.06634,-20.7095,40,43,5,3
-42.06612,-20.7095,40,42,5,2
-42.0659,-20.7095,38,42,5,4
-42.06545,-20.7095,29,41,5,12
-42.06522,-20.7095,29,40,5,11
-42.065,-20.7095,24,40,5,16
-42.06477,-20.7095,29,38,5,9
-42.06455,-20.7095,24,39,5,15
-42.0641,-20.7095,24,40,5,16
-42.06387,-20.7095,29,40,5,11
-42.06365,-20.7095,30,41,5,11
-42.06342,-20.7095,38,41,5,3
-42.06297,-20.7095,39,41,5,2
-42.06275,-20.7095,38,42,5,4
-42.06252,-20.7095,41,42,5,1
-42.0623,-20.7095,41,43,5,2
-42.06185,-20.7095,41,42,5,1
-42.06163,-20.7095,41,42,5,1
-42.0614,-20.7095,41,43,5,2
-42.06118,-20.7095,41,43,5,2
-42.06073,-20.7095,44,45,5,1
-42.0605,-20.7095,39,46,5,7
-42.06028,-20.7095,44,46,5,2
-42.06005,-20.7095,46,46,5,0
-42.05983,-20.7095,47,48,5,1
-42.05938,-20.7095,42,50,0,8
-42.05915,-20.7095,34,50,0,16
-42.05893,-20.7095,35,51,0,16
-42.0587,-20.7095,34,51,0,17
-42.05826,-20.7095,22,51,0,29
-42.05803,-20.7095,29,50,0,21
-42.05781,-20.7095,29,49,0,20
-42.05758,-20.7095,22,46,0,24
-42.05713,-20.7095,29,45,5,16
-42.05691,-20.7095,16,45,5,29
-42.05668,-20.7095,19,45,5,26
-42.05646,-20.7095,28,45,5,17
-42.05601,-20.7095,25,45,5,20
-42.05578,-20.7095,30,45,5,15
-42.05556,-20.7095,33,45,5,12
-42.05533,-20.7095,35,47,5,12
-42.05511,-20.7095,36,48,5,12
-42.05466,-20.7095,37,48,5,11
-42.05443,-20.7095,41,49,5,8
-42.05421,-20.7095,38,52,5,14
-42.05399,-20.7095,43,54,5,11
-42.05354,-20.7095,43,54,5,11
-42.05331,-20.7095,38,55,5,17
-42.05309,-20.7095,37,56,5,19
-42.05286,-20.7095,37,58,5,21
-42.05241,-20.7095,37,57,5,20
-42.05219,-20.7095,36,58,5,22
-42.05196,-20.7095,37,56,5,19
-42.05174,-20.7095,35,56,5,21
-42.05129,-20.7095,36,56,5,20
-42.05106,-20.7095,38,54,5,16
-42.05084,-20.7095,38,52,5,14
-42.05061,-20.7095,43,50,5,7
-42.05039,-20.7095,46,50,5,4
-42.04994,-20.7095,44,50,0,6
-42.04972,-20.7095,48,47,5,-1
-42.04949,-20.7095,48,48,5,0
-42.04927,-20.7095,45,47,5,2
-42.04882,-20.7095,47,48,5,1
-42.04859,-20.7095,43,46,5,3
-42.04837,-20.7095,44,46,5,2
-42.04814,-20.7095,45,47,5,2
-42.04769,-20.7095,45,47,5,2
-42.04747,-20.7095,45,48,5,3
-42.04724,-20.7095,45,48,0,3
-42.04702,-20.7095,44,51,0,7
-42.04657,-20.7095,44,49,0,5
-42.04635,-20.7095,42,51,0,9
-42.04612,-20.7095,41,50,0,9
-42.0459,-20.7095,40,49,0,9
-42.04545,-20.7095,37,48,0,11
-42.04522,-20.7095,32,49,0,17
-42.045,-20.7095,25,44,0,19
-42.04477,-20.7095,25,44,0,19
-42.04455,-20.7095,25,43,0,18
-42.0441,-20.7095,25,43,0,18
-42.04387,-20.7095,25,43,0,18
-42.04365,-20.7095,32,42,0,10
-42.04342,-20.7095,25,42,0,17
-42.04297,-20.7095,32,44,0,12
-42.04275,-20.7095,38,42,0,4
-42.04253,-20.7095,39,41,5,2
-42.0423,-20.7095,43,43,5,0
-42.04185,-20.7095,44,44,5,0
-42.04163,-20.7095,43,43,5,0
-42.0414,-20.7095,44,44,5,0
-42.04118,-20.7095,44,44,5,0
-42.04073,-20.7095,42,45,5,3
-42.0405,-20.7095,42,46,5,4
-42.04028,-20.7095,42,46,5,4
-42.04005,-20.7095,42,46,5,4
-42.03983,-20.7095,42,45,5,3
-42.03938,-20.7095,41,46,5,5
-42.03915,-20.7095,41,46,5,5
-42.03893,-20.7095,41,46,5,5
-42.0387,-20.7095,40,45,5,5
-42.03826,-20.7095,39,47,5,8
-42.03803,-20.7095,39,47,5,8
-42.03781,-20.7095,38,47,5,9
-42.03758,-20.7095,38,47,5,9
-42.03713,-20.7095,37,46,5,9
-42.03691,-20.7095,37,46,5,9
-42.03668,-20.7095,37,45,5,8
-42.03646,-20.7095,37,45,5,8
-42.03601,-20.7095,38,45,0,7
-42.03578,-20.7095,38,48,0,10
-42.03556,-20.7095,38,48,0,10
-42.03533,-20.7095,39,47,0,8
-42.03511,-20.7095,39,47,0,8
-42.03466,-20.7095,40,45,0,5
-42.03444,-20.7095,39,45,0,6
-42.03421,-20.7095,38,45,11,7
-42.03399,-20.7095,37,46,11,9
-42.03354,-20.7095,35,47,6,12
-42.03331,-20.7095,36,47,0,11
-42.03309,-20.7095,34,50,0,16
-42.03286,-20.7095,34,51,11,17
-42.03241,-20.7095,32,44,11,12
-42.03219,-20.7095,30,44,5,14
-42.03196,-20.7095,27,44,5,17
-42.03174,-20.7095,27,44,5,17
-42.03129,-20.7095,27,44,5,17
-42.03106,-20.7095,27,44,11,17
-42.03084,-20.7095,27,47,5,20
-42.03062,-20.7095,27,46,5,19
-42.03017,-20.7095,26,46,5,20
-42.02994,-20.7095,26,46,5,20
-42.02972,-20.7095,25,46,5,21
-42.02949,-20.7095,21,45,5,24
-42.02927,-20.7095,20,43,5,23
-42.02882,-20.7095,20,45,0,25
-42.02859,-20.7095,21,47,0,26
-42.02837,-20.7095,33,46,0,13
-42.02814,-20.7095,34,46,0,12
-42.02769,-20.7095,37,47,0,10
-42.02747,-20.7095,41,47,0,6
-42.02724,-20.7095,37,50,0,13
-42.02702,-20.7095,36,50,0,14
-42.02657,-20.7095,32,50,0,18
-42.02635,-20.7095,29,50,0,21
-42.02612,-20.7095,29,50,0,21
-42.0259,-20.7095,25,50,0,25
-42.02545,-20.7095,25,49,0,24
-42.02522,-20.7095,23,49,0,26
-42.025,-20.7095,25,49,0,24
-42.02477,-20.7095,26,49,0,23
-42.02455,-20.7095,27,49,0,22
-42.0241,-20.7095,29,49,0,20
-42.02387,-20.7095,31,49,0,18
-42.02365,-20.7095,32,46,0,14
-42.02342,-20.7095,33,45,0,12
-42.02297,-20.7095,33,44,5,11
-42.02275,-20.7095,35,44,5,9
-42.02253,-20.7095,35,46,5,11
-42.0223,-20.7095,36,46,5,10
-42.02185,-20.7095,37,45,5,8
-42.02163,-20.7095,37,45,5,8
-42.0214,-20.7095,37,45,0,8
-42.02118,-20.7095,38,46,0,8
-42.02073,-20.7095,38,48,0,10
-42.0205,-20.7095,39,49,0,10
-42.02028,-20.7095,39,46,0,7
-42.02005,-20.7095,40,45,0,5
-42.01983,-20.7095,52,46,0,-6
-42.01938,-20.7095,45,42,0,-3
-42.01915,-20.7095,45,44,0,-1
-42.01893,-20.7095,46,44,0,-2
-42.01871,-20.7095,49,46,0,-3
-42.01826,-20.7095,49,41,5,-8
-42.01803,-20.7095,50,39,5,-11
-42.01781,-20.7095,49,45,5,-4
-42.01758,-20.7095,48,42,11,-6
-42.01713,-20.7095,49,42,5,-7
-42.01691,-20.7095,49,39,5,-10
-42.01668,-20.7095,48,41,5,-7
-42.01646,-20.7095,48,41,5,-7
-42.01601,-20.7095,46,40,5,-6
-42.01578,-20.7095,46,40,5,-6
-42.01556,-20.7095,45,40,5,-5
-42.01533,-20.7095,44,41,5,-3
-42.01511,-20.7095,44,41,5,-3
-42.01466,-20.7095,44,44,5,0
-42.01444,-20.7095,50,44,5,-6
-42.01421,-20.7095,51,44,5,-7
-42.01399,-20.7095,52,42,5,-10
-42.01354,-20.7095,53,41,5,-12
-42.01331,-20.7095,57,41,5,-16
-42.01309,-20.7095,56,41,5,-15
-42.01286,-20.7095,53,41,5,-12
-42.01241,-20.7095,54,45,0,-9
-42.01219,-20.7095,56,45,0,-11
-42.01196,-20.7095,53,44,0,-9
-42.01174,-20.7095,52,44,0,-8
-42.01129,-20.7095,51,48,0,-3
-42.01106,-20.7095,50,48,0,-2
-42.01084,-20.7095,50,48,0,-2
-42.01062,-20.7095,50,48,0,-2
-42.01017,-20.7095,49,49,0,0
-42.00994,-20.7095,48,49,0,1
-42.00972,-20.7095,48,45,0,-3
-42.00949,-20.7095,47,45,0,-2
-42.00927,-20.7095,47,44,0,-3
-42.00882,-20.7095,48,42,0,-6
-42.00859,-20.7095,48,42,0,-6
-42.00837,-20.7095,48,41,0,-7
-42.00814,-20.7095,51,41,0,-10
-42.00769,-20.7095,53,40,0,-13
-42.00747,-20.7095,52,39,0,-13
-42.00724,-20.7095,52,38,0,-14
-42.00702,-20.7095,52,38,0,-14
-42.00657,-20.7095,52,26,0,-26
-42.00635,-20.7095,52,34,0,-18
-42.00612,-20.7095,51,34,5,-17
-42.0059,-20.7095,51,34,5,-17
-42.00545,-20.7095,49,32,5,-17
-42.00522,-20.7095,49,32,5,-17
-42.005,-20.7095,49,32,5,-17
-42.00477,-20.7095,49,31,5,-18
-42.00455,-20.7095,51,25,5,-26
-42.0041,-20.7095,56,32,5,-24
-42.00387,-20.7095,56,33,5,-23
-42.00365,-20.7095,55,35,5,-20
-42.00342,-20.7095,57,35,5,-22
-42.00298,-20.7095,55,36,5,-19
-42.00275,-20.7095,57,38,5,-19
-42.00253,-20.7095,56,38,5,-18
-42.0023,-20.7095,56,39,5,-17
-42.00185,-20.7095,56,43,5,-13
-42.00163,-20.7095,56,43,5,-13
-42.0014,-20.7095,56,43,5,-13
-42.00118,-20.7095,56,41,5,-15
-42.00073,-20.7095,56,39,5,-17
-42.0005,-20.7095,56,39,5,-17
-42.00028,-20.7095,56,37,5,-19
-42.00005,-20.7095,55,37,5,-18
-41.99983,-20.7095,55,40,5,-15
-41.99938,-20.7095,54,40,5,-14
-41.99916,-20.7095,54,39,5,-15
-41.99893,-20.7095,53,39,5,-14
-41.99871,-20.7095,53,40,5,-13
-41.99826,-20.7095,53,40,5,-13
-41.99803,-20.7095,52,39,0,-13
-41.99781,-20.7095,52,39,0,-13
-41.99758,-20.7095,52,39,0,-13
-41.99713,-20.7095,52,39,0,-13
-41.99691,-20.7095,52,39,0,-13
-41.99668,-20.7095,51,38,0,-13
-41.99646,-20.7095,52,37,0,-15
-41.99601,-20.7095,52,37,0,-15
-41.99578,-20.7095,52,37,0,-15
-41.99556,-20.7095,52,37,0,-15
-41.99533,-20.7095,52,36,0,-16
-41.99511,-20.7095,55,36,0,-19
-41.99466,-20.7095,55,35,0,-20
-41.99444,-20.7095,62,34,0,-28
-41.99421,-20.7095,63,34,0,-29
-41.99399,-20.7095,59,34,0,-25
-41.99354,-20.7095,63,33,0,-30
-41.99331,-20.7095,59,32,0,-27
-41.99309,-20.7095,58,33,0,-25
-41.99286,-20.7095,58,33,0,-25
-41.99241,-20.7095,56,36,0,-20
-41.99219,-20.7095,54,37,0,-17
-41.99196,-20.7095,54,37,0,-17
-41.99174,-20.7095,54,37,0,-17
-41.99129,-20.7095,54,37,0,-17
-41.99107,-20.7095,53,37,0,-16
-41.99084,-20.7095,53,36,0,-17
-41.99062,-20.7095,53,36,0,-17
-41.99017,-20.7095,53,35,0,-18
-41.98994,-20.7095,53,35,0,-18
-41.98972,-20.7095,53,35,0,-18
-41.98949,-20.7095,53,35,0,-18
-41.98927,-20.7095,53,35,0,-18
-41.98882,-20.7095,59,34,0,-25
-41.98859,-20.7095,58,36,0,-22
-41.98837,-20.7095,65,36,0,-29
-41.98814,-20.7095,60,36,0,-24
-41.98769,-20.7095,62,37,0,-25
-41.98747,-20.7095,65,38,0,-27
-41.98725,-20.7095,63,40,0,-23
-41.98702,-20.7095,64,40,0,-24
-41.98657,-20.7095,65,41,0,-24
-41.98635,-20.7095,62,42,0,-20
-41.98612,-20.7095,61,42,0,-19
-41.9859,-20.7095,60,42,0,-18
-41.98545,-20.7095,60,43,0,-17
-41.98522,-20.7095,59,43,0,-16
-41.985,-20.7095,59,43,0,-16
-41.98477,-20.7095,59,43,0,-16
-41.98455,-20.7095,59,38,0,-21
-41.9841,-20.7095,59,38,0,-21
-41.98387,-20.7095,62,35,0,-27
-41.98365,-20.7095,58,34,0,-24
-41.98343,-20.7095,58,34,0,-24
-41.98298,-20.7095,58,34,0,-24
-41.98275,-20.7095,58,34,0,-24
-41.98253,-20.7095,58,33,0,-25
-41.9823,-20.7095,57,33,11,-24
-41.98185,-20.7095,57,39,0,-18
-41.98163,-20.7095,56,39,0,-17
-41.9814,-20.7095,56,40,0,-16
-41.98118,-20.7095,56,41,0,-15
-41.98073,-20.7095,56,40,0,-16
-41.9805,-20.7095,56,40,0,-16
-41.98028,-20.7095,56,41,0,-15
-41.98005,-20.7095,56,41,0,-15
-41.97983,-20.7095,56,41,0,-15
-41.97938,-20.7095,56,32,5,-24
-41.97916,-20.7095,56,30,5,-26
-41.97893,-20.7095,56,29,5,-27
-41.97871,-20.7095,56,29,5,-27
-41.97826,-20.7095,56,34,5,-22
-41.97803,-20.7095,56,39,5,-17
-41.97781,-20.7095,56,40,0,-16
-41.97758,-20.7095,56,40,0,-16
-41.97713,-20.7095,56,40,0,-16
-41.97691,-20.7095,56,41,0,-15
-41.97668,-20.7095,56,41,0,-15
-41.97646,-20.7095,56,41,5,-15
-41.97601,-20.7095,56,35,5,-21
-41.97578,-20.7095,56,35,5,-21
-41.97556,-20.7095,56,35,5,-21
-41.97534,-20.7095,56,35,5,-21
-41.97511,-20.7095,60,35,5,-25
-41.97466,-20.7095,61,38,0,-23
-41.97444,-20.7095,56,43,0,-13
-41.97421,-20.7095,56,43,0,-13
-41.97399,-20.7095,56,43,0,-13
-41.97354,-20.7095,56,44,0,-12
-41.97331,-20.7095,56,44,0,-12
-41.97309,-20.7095,56,44,0,-12
-41.97286,-20.7095,56,44,0,-12
-41.97241,-20.7095,55,44,0,-11
-41.97219,-20.7095,55,44,0,-11
-41.97196,-20.7095,55,44,0,-11
-41.97174,-20.7095,55,44,0,-11
-41.97129,-20.7095,55,44,0,-11
-41.97107,-20.7095,55,45,0,-10
-41.97084,-20.7095,55,45,0,-10
-41.97062,-20.7095,54,45,0,-9
-41.97017,-20.7095,54,43,5,-11
-41.96994,-20.7095,53,45,5,-8
-41.96972,-20.7095,53,36,5,-17
-41.96949,-20.7095,53,36,5,-17
-41.96927,-20.7095,53,36,5,-17
-42.1005,-20.70908,66,37,5,-29
-42.0978,-20.70908,65,35,5,-30
-42.09511,-20.70908,67,38,0,-29
-42.09219,-20.70908,65,32,5,-33
-42.08949,-20.70908,55,38,5,-17
-42.08657,-20.70908,57,37,5,-20
-42.08387,-20.70908,58,36,0,-22
-42.08118,-20.70908,60,34,5,-26
-42.07825,-20.70908,57,36,0,-21
-42.07556,-20.70908,60,37,5,-23
-42.07286,-20.70908,60,40,0,-20
-42.06994,-20.70908,61,42,0,-19
-42.06724,-20.70908,61,42,5,-19
-42.06455,-20.70908,23,39,5,16
-42.06163,-20.70908,41,42,5,1
-42.05893,-20.70908,33,49,0,16
-42.05601,-20.70908,23,45,5,22
-42.05331,-20.70908,38,51,5,13
-42.05061,-20.70908,47,50,0,3
-42.04769,-20.70908,46,46,5,0
-42.045,-20.70908,21,44,0,23
-42.0423,-20.70908,43,43,5,0
-42.03938,-20.70908,41,44,5,3
-42.03668,-20.70908,37,44,5,7
-42.03399,-20.70908,37,45,11,8
-42.03106,-20.70908,27,43,5,16
-42.02837,-20.70908,32,46,0,14
-42.02545,-20.70908,21,49,0,28
-42.02275,-20.70908,32,48,5,16
-42.02005,-20.70908,46,49,0,3
-42.01713,-20.70908,48,39,5,-9
-42.01444,-20.70908,44,43,5,-1
-42.01174,-20.70908,52,44,0,-8
-42.00882,-20.70908,49,44,0,-5
-42.00612,-20.70908,51,36,5,-15
-42.00342,-20.70908,56,35,5,-21
-42.0005,-20.70908,56,36,5,-20
-41.99781,-20.70908,52,45,0,-7
-41.99511,-20.70908,55,37,0,-18
-41.99219,-20.70908,54,35,0,-19
-41.98949,-20.70908,52,36,0,-16
-41.98657,-20.70908,64,42,0,-22
-41.98387,-20.70908,63,35,0,-28
-41.98118,-20.70908,56,41,0,-15
-41.97826,-20.70908,56,29,5,-27
-41.97556,-20.70908,56,40,5,-16
-41.97286,-20.70908,56,44,5,-12
-41.96994,-20.70908,54,46,5,-8
-42.1005,-20.70887,68,36,5,-32
-42.0978,-20.70887,65,34,5,-31
-42.09511,-20.70887,67,38,0,-29
-42.09219,-20.70887,65,32,5,-33
-42.08949,-20.70887,55,38,0,-17
-42.08657,-20.70887,56,33,5,-23
-42.08387,-20.70887,58,36,0,-22
-42.08118,-20.70887,59,33,5,-26
-42.07825,-20.70887,58,36,0,-22
-42.07556,-20.70887,59,40,5,-19
-42.07286,-20.70887,60,40,0,-20
-42.06994,-20.70887,60,42,0,-18
-42.06724,-20.70887,61,42,5,-19
-42.06455,-20.70887,26,38,5,12
-42.06163,-20.70887,40,42,5,2
-42.05893,-20.70887,24,49,0,25
-42.05601,-20.70887,23,45,5,22
-42.05331,-20.70887,37,51,5,14
-42.05061,-20.70887,44,48,0,4
-42.04769,-20.70887,45,45,5,0
-42.045,-20.70887,27,45,0,18
-42.0423,-20.70887,42,42,0,0
-42.03938,-20.70887,40,44,5,4
-42.03668,-20.70887,39,44,0,5
-42.03399,-20.70887,36,46,11,10
-42.03106,-20.70887,27,43,5,16
-42.02837,-20.70887,27,46,0,19
-42.02545,-20.70887,16,50,0,34
-42.02275,-20.70887,31,49,5,18
-42.02005,-20.70887,48,49,0,1
-42.01713,-20.70887,49,42,5,-7
-42.01444,-20.70887,43,42,5,-1
-42.01174,-20.70887,53,43,0,-10
-42.00882,-20.70887,52,43,0,-9
-42.00612,-20.70887,51,36,5,-15
-42.00342,-20.70887,55,34,5,-21
-42.0005,-20.70887,56,36,5,-20
-41.99781,-20.70887,52,39,5,-13
-41.99511,-20.70887,59,38,0,-21
-41.99219,-20.70887,54,34,0,-20
-41.98949,-20.70887,52,36,0,-16
-41.98657,-20.70887,64,42,0,-22
-41.98387,-20.70887,59,35,0,-24
-41.98118,-20.70887,56,41,0,-15
-41.97826,-20.70887,55,30,5,-25
-41.97556,-20.70887,56,39,5,-17
-41.97286,-20.70887,56,35,5,-21
-41.96994,-20.70887,54,46,0,-8
-42.1005,-20.70866,63,35,5,-28
-42.0978,-20.70866,65,34,5,-31
-42.09511,-20.70866,67,38,0,-29
-42.09219,-20.70866,64,32,5,-32
-42.08949,-20.70866,56,38,0,-18
-42.08657,-20.70866,56,32,5,-24
-42.08387,-20.70866,58,36,0,-22
-42.08118,-20.70866,60,34,5,-26
-42.07825,-20.70866,58,37,0,-21
-42.07556,-20.70866,60,40,5,-20
-42.07286,-20.70866,60,44,0,-16
-42.06994,-20.70866,59,42,0,-17
-42.06724,-20.70866,61,42,5,-19
-42.06455,-20.70866,42,40,5,-2
-42.06163,-20.70866,45,44,5,-1
-42.05893,-20.70866,20,49,0,29
-42.05601,-20.70866,31,44,5,13
-42.05331,-20.70866,38,51,0,13
-42.05061,-20.70866,44,48,0,4
-42.04769,-20.70866,45,47,0,2
-42.045,-20.70866,29,45,0,16
-42.0423,-20.70866,46,46,0,0
-42.03938,-20.70866,40,42,5,2
-42.03668,-20.70866,37,44,0,7
-42.03399,-20.70866,36,45,11,9
-42.03106,-20.70866,26,43,5,17
-42.02837,-20.70866,33,45,0,12
-42.02545,-20.70866,21,50,0,29
-42.02275,-20.70866,31,47,5,16
-42.02005,-20.70866,51,49,0,-2
-42.01713,-20.70866,48,42,5,-6
-42.01444,-20.70866,43,40,5,-3
-42.01174,-20.70866,56,42,0,-14
-42.00882,-20.70866,51,43,0,-8
-42.00612,-20.70866,49,38,5,-11
-42.00342,-20.70866,58,34,5,-24
-42.0005,-20.70866,55,37,5,-18
-41.99781,-20.70866,52,40,5,-12
-41.99511,-20.70866,59,37,5,-22
-41.99219,-20.70866,54,33,0,-21
-41.98949,-20.70866,52,38,0,-14
-41.98657,-20.70866,65,42,0,-23
-41.98387,-20.70866,63,35,0,-28
-41.98118,-20.70866,56,41,0,-15
-41.97826,-20.70866,55,30,5,-25
-41.97556,-20.70866,56,44,5,-12
-41.97286,-20.70866,56,34,5,-22
-41.96994,-20.70866,54,47,0,-7
-42.1005,-20.70824,61,37,5,-24
-42.0978,-20.70824,65,37,5,-28
-42.09511,-20.70824,67,38,5,-29
-42.09219,-20.70824,64,33,5,-31
-42.08949,-20.70824,56,38,0,-18
-42.08657,-20.70824,56,31,5,-25
-42.08387,-20.70824,58,37,0,-21
-42.08118,-20.70824,59,34,11,-25
-42.07825,-20.70824,58,38,0,-20
-42.07556,-20.70824,60,40,0,-20
-42.07286,-20.70824,60,44,0,-16
-42.06994,-20.70824,59,42,0,-17
-42.06724,-20.70824,61,42,5,-19
-42.06455,-20.70824,49,40,5,-9
-42.06163,-20.70824,36,42,5,6
-42.05893,-20.70824,15,48,0,33
-42.05601,-20.70824,23,43,5,20
-42.05331,-20.70824,41,53,0,12
-42.05061,-20.70824,49,49,0,0
-42.04769,-20.70824,44,47,0,3
-42.045,-20.70824,33,46,0,13
-42.0423,-20.70824,46,46,0,0
-42.03938,-20.70824,39,41,5,2
-42.03668,-20.70824,37,45,0,8
-42.03399,-20.70824,36,43,0,7
-42.03106,-20.70824,26,42,5,16
-42.02837,-20.70824,34,45,5,11
-42.02545,-20.70824,21,50,0,29
-42.02275,-20.70824,30,47,5,17
-42.02005,-20.70824,53,49,0,-4
-42.01713,-20.70824,46,46,5,0
-42.01444,-20.70824,43,43,0,0
-42.01174,-20.70824,56,41,0,-15
-42.00882,-20.70824,49,40,0,-9
-42.00612,-20.70824,49,36,5,-13
-42.00342,-20.70824,59,34,5,-25
-42.0005,-20.70824,54,35,5,-19
-41.99781,-20.70824,51,44,5,-7
-41.99511,-20.70824,51,36,5,-15
-41.99219,-20.70824,55,33,0,-22
-41.98949,-20.70824,52,39,0,-13
-41.98657,-20.70824,65,42,0,-23
-41.98387,-20.70824,60,35,0,-25
-41.98118,-20.70824,57,40,0,-17
-41.97826,-20.70824,55,31,5,-24
-41.97556,-20.70824,59,44,5,-15
-41.97286,-20.70824,56,34,5,-22
-41.96994,-20.70824,54,47,5,-7
-42.1005,-20.70802,64,37,5,-27
-42.0978,-20.70802,64,35,5,-29
-42.09511,-20.70802,67,33,5,-34
-42.09219,-20.70802,66,32,5,-34
-42.08949,-20.70802,56,38,0,-18
-42.08657,-20.70802,56,31,5,-25
-42.08387,-20.70802,58,37,0,-21
-42.08118,-20.70802,59,34,5,-25
-42.07825,-20.70802,58,38,0,-20
-42.07556,-20.70802,60,40,0,-20
-42.07286,-20.70802,59,44,0,-15
-42.06994,-20.70802,59,41,0,-18
-42.06724,-20.70802,60,42,5,-18
-42.06455,-20.70802,51,39,5,-12
-42.06163,-20.70802,30,42,5,12
-42.05893,-20.70802,12,48,0,36
-42.05601,-20.70802,21,43,5,22
-42.05331,-20.70802,44,48,0,4
-42.05061,-20.70802,50,51,0,1
-42.04769,-20.70802,46,47,0,1
-42.045,-20.70802,38,46,0,8
-42.0423,-20.70802,43,44,0,1
-42.03938,-20.70802,39,41,5,2
-42.03668,-20.70802,36,46,0,10
-42.03399,-20.70802,35,43,0,8
-42.03106,-20.70802,25,42,0,17
-42.02837,-20.70802,32,45,5,13
-42.02545,-20.70802,15,50,0,35
-42.02275,-20.70802,38,46,5,8
-42.02005,-20.70802,51,49,5,-2
-42.01713,-20.70802,46,46,5,0
-42.01444,-20.70802,47,43,0,-4
-42.01174,-20.70802,55,41,0,-14
-42.00882,-20.70802,53,41,0,-12
-42.00612,-20.70802,49,36,5,-13
-42.00342,-20.70802,59,35,5,-24
-42.0005,-20.70802,54,34,5,-20
-41.99781,-20.70802,51,46,5,-5
-41.99511,-20.70802,50,35,5,-15
-41.99219,-20.70802,52,34,0,-18
-41.98949,-20.70802,52,41,0,-11
-41.98657,-20.70802,64,42,0,-22
-41.98387,-20.70802,59,35,0,-24
-41.98118,-20.70802,56,38,0,-18
-41.97826,-20.70802,55,31,5,-24
-41.97556,-20.70802,62,44,5,-18
-41.97286,-20.70802,56,36,5,-20
-41.96994,-20.70802,54,47,5,-7
-42.1005,-20.70781,64,38,5,-26
-42.0978,-20.70781,64,35,5,-29
-42.09511,-20.70781,66,38,5,-28
-42.09219,-20.70781,67,33,5,-34
-42.08949,-20.70781,56,38,0,-18
-42.08657,-20.70781,56,32,5,-24
-42.08387,-20.70781,58,37,0,-21
-42.08118,-20.70781,58,34,11,-24
-42.07825,-20.70781,58,38,0,-20
-42.07556,-20.70781,60,40,0,-20
-42.07286,-20.70781,59,44,0,-15
-42.06994,-20.70781,60,41,0,-19
-42.06724,-20.70781,60,42,5,-18
-42.06455,-20.70781,58,38,5,-20
-42.06163,-20.70781,30,43,0,13
-42.05893,-20.70781,12,48,0,36
-42.05601,-20.70781,20,43,5,23
-42.05331,-20.70781,49,49,0,0
-42.05061,-20.70781,51,51,0,0
-42.04769,-20.70781,51,48,0,-3
-42.045,-20.70781,43,47,0,4
-42.0423,-20.70781,46,46,0,0
-42.03938,-20.70781,39,42,0,3
-42.03668,-20.70781,36,45,0,9
-42.03399,-20.70781,35,42,0,7
-42.03106,-20.70781,25,46,0,21
-42.02837,-20.70781,32,45,5,13
-42.02545,-20.70781,33,50,0,17
-42.02275,-20.70781,43,45,5,2
-42.02005,-20.70781,52,45,5,-7
-42.01713,-20.70781,45,45,5,0
-42.01444,-20.70781,54,43,0,-11
-42.01174,-20.70781,54,41,0,-13
-42.00882,-20.70781,49,41,0,-8
-42.00612,-20.70781,48,35,5,-13
-42.00342,-20.70781,59,32,5,-27
-42.0005,-20.70781,54,34,5,-20
-41.99781,-20.70781,51,46,5,-5
-41.99511,-20.70781,50,35,5,-15
-41.99219,-20.70781,51,34,0,-17
-41.98949,-20.70781,51,42,5,-9
-41.98657,-20.70781,65,42,0,-23
-41.98387,-20.70781,58,35,0,-23
-41.98118,-20.70781,55,38,0,-17
-41.97826,-20.70781,59,31,5,-28
-41.97556,-20.70781,62,45,5,-17
-41.97286,-20.70781,56,36,5,-20
-41.96994,-20.70781,54,48,5,-6
-42.1005,-20.7076,64,38,5,-26
-42.0978,-20.7076,64,38,5,-26
-42.09511,-20.7076,66,38,5,-28
-42.09219,-20.7076,67,35,5,-32
-42.08949,-20.7076,56,38,0,-18
-42.08657,-20.7076,56,31,5,-25
-42.08387,-20.7076,58,37,0,-21
-42.08118,-20.7076,58,35,5,-23
-42.07825,-20.7076,58,39,0,-19
-42.07556,-20.7076,60,40,0,-20
-42.07286,-20.7076,59,44,0,-15
-42.06994,-20.7076,59,40,0,-19
-42.06724,-20.7076,60,43,5,-17
-42.06455,-20.7076,62,38,5,-24
-42.06163,-20.7076,36,45,0,9
-42.05893,-20.7076,13,48,0,35
-42.05601,-20.7076,14,43,5,29
-42.05331,-20.7076,50,49,0,-1
-42.05061,-20.7076,52,50,0,-2
-42.04769,-20.7076,51,48,0,-3
-42.045,-20.7076,44,47,0,3
-42.0423,-20.7076,44,47,0,3
-42.03938,-20.7076,39,44,11,5
-42.03668,-20.7076,37,44,0,7
-42.03399,-20.7076,35,40,0,5
-42.03106,-20.7076,23,46,0,23
-42.02837,-20.7076,20,43,5,23
-42.02545,-20.7076,41,50,0,9
-42.02275,-20.7076,45,45,5,0
-42.02005,-20.7076,53,45,11,-8
-42.01713,-20.7076,44,44,5,0
-42.01444,-20.7076,53,43,0,-10
-42.01174,-20.7076,57,40,0,-17
-42.00882,-20.7076,50,41,0,-9
-42.00612,-20.7076,48,35,5,-13
-42.00342,-20.7076,59,32,0,-27
-42.0005,-20.7076,54,34,5,-20
-41.99781,-20.7076,52,47,5,-5
-41.99511,-20.7076,50,35,5,-15
-41.99219,-20.7076,52,34,0,-18
-41.98949,-20.7076,51,42,5,-9
-41.98657,-20.7076,64,40,0,-24
-41.98387,-20.7076,58,34,0,-24
-41.98118,-20.7076,55,38,0,-17
-41.97826,-20.7076,64,31,5,-33
-41.97556,-20.7076,62,45,0,-17
-41.97286,-20.7076,56,42,5,-14
-41.96994,-20.7076,54,47,5,-7
-42.1005,-20.70718,65,38,5,-27
-42.0978,-20.70718,65,38,5,-27
-42.09511,-20.70718,67,38,0,-29
-42.09219,-20.70718,67,32,5,-35
-42.08949,-20.70718,57,38,0,-19
-42.08657,-20.70718,56,32,5,-24
-42.08387,-20.70718,57,37,5,-20
-42.08118,-20.70718,58,35,5,-23
-42.07825,-20.70718,59,39,0,-20
-42.07556,-20.70718,60,44,0,-16
-42.07286,-20.70718,60,43,0,-17
-42.06994,-20.70718,59,41,0,-18
-42.06724,-20.70718,60,41,5,-19
-42.06455,-20.70718,62,40,5,-22
-42.06163,-20.70718,48,48,0,0
-42.05893,-20.70718,13,48,0,35
-42.05601,-20.70718,24,43,5,19
-42.05331,-20.70718,51,48,0,-3
-42.05061,-20.70718,53,48,0,-5
-42.04769,-20.70718,51,47,0,-4
-42.045,-20.70718,45,45,0,0
-42.0423,-20.70718,43,47,0,4
-42.03938,-20.70718,37,43,0,6
-42.03668,-20.70718,37,44,11,7
-42.03399,-20.70718,35,35,5,0
-42.03106,-20.70718,21,45,0,24
-42.02837,-20.70718,19,43,0,24
-42.02545,-20.70718,44,50,0,6
-42.02275,-20.70718,46,46,5,0
-42.02005,-20.70718,51,48,11,-3
-42.01713,-20.70718,43,42,5,-1
-42.01444,-20.70718,53,41,0,-12
-42.01174,-20.70718,53,40,0,-13
-42.00882,-20.70718,50,39,0,-11
-42.00612,-20.70718,48,33,5,-15
-42.00342,-20.70718,59,33,5,-26
-42.0005,-20.70718,55,34,5,-21
-41.99781,-20.70718,57,45,5,-12
-41.99511,-20.70718,50,35,5,-15
-41.99219,-20.70718,53,35,0,-18
-41.98949,-20.70718,51,44,5,-7
-41.98657,-20.70718,61,43,0,-18
-41.98387,-20.70718,56,35,0,-21
-41.98118,-20.70718,54,34,0,-20
-41.97826,-20.70718,63,42,0,-21
-41.97556,-20.70718,61,45,0,-16
-41.97286,-20.70718,56,42,5,-14
-41.96994,-20.70718,54,46,5,-8
-42.1005,-20.70697,64,38,5,-26
-42.0978,-20.70697,65,35,5,-30
-42.09511,-20.70697,67,38,0,-29
-42.09219,-20.70697,68,33,5,-35
-42.08949,-20.70697,59,38,0,-21
-42.08657,-20.70697,56,31,5,-25
-42.08387,-20.70697,57,35,5,-22
-42.08118,-20.70697,58,36,5,-22
-42.07825,-20.70697,59,39,11,-20
-42.07556,-20.70697,59,44,0,-15
-42.07286,-20.70697,60,43,0,-17
-42.06994,-20.70697,60,41,0,-19
-42.06724,-20.70697,61,40,5,-21
-42.06455,-20.70697,61,40,5,-21
-42.06163,-20.70697,54,49,0,-5
-42.05893,-20.70697,13,47,0,34
-42.05601,-20.70697,34,43,5,9
-42.05331,-20.70697,49,49,0,0
-42.05061,-20.70697,53,47,0,-6
-42.04769,-20.70697,54,48,0,-6
-42.045,-20.70697,47,48,0,1
-42.0423,-20.70697,42,46,11,4
-42.03938,-20.70697,37,44,0,7
-42.03668,-20.70697,37,45,0,8
-42.03399,-20.70697,35,34,5,-1
-42.03106,-20.70697,17,45,0,28
-42.02837,-20.70697,20,44,0,24
-42.02545,-20.70697,47,50,0,3
-42.02275,-20.70697,47,46,5,-1
-42.02005,-20.70697,51,49,11,-2
-42.01713,-20.70697,43,42,5,-1
-42.01444,-20.70697,53,41,0,-12
-42.01174,-20.70697,57,40,0,-17
-42.00882,-20.70697,50,39,0,-11
-42.00612,-20.70697,48,34,5,-14
-42.00342,-20.70697,58,33,5,-25
-42.0005,-20.70697,55,34,5,-21
-41.99781,-20.70697,61,45,5,-16
-41.99511,-20.70697,50,35,5,-15
-41.99219,-20.70697,55,34,0,-21
-41.98949,-20.70697,61,39,5,-22
-41.98657,-20.70697,61,43,0,-18
-41.98387,-20.70697,55,35,0,-20
-41.98118,-20.70697,54,35,0,-19
-41.97826,-20.70697,64,42,0,-22
-41.97556,-20.70697,60,45,0,-15
-41.97286,-20.70697,56,31,5,-25
-41.96994,-20.70697,54,46,5,-8
-42.10297,-20.70676,61,28,5,-33
-42.10275,-20.70676,62,28,5,-34
-42.10252,-20.70676,62,28,5,-34
-42.1023,-20.70676,63,29,5,-34
-42.10185,-20.70676,63,29,5,-34
-42.10163,-20.70676,63,30,5,-33
-42.1014,-20.70676,63,31,5,-32
-42.10118,-20.70676,64,31,5,-33
-42.10073,-20.70676,65,32,5,-33
-42.1005,-20.70676,65,34,5,-31
-42.10028,-20.70676,65,36,5,-29
-42.10005,-20.70676,66,38,5,-28
-42.09983,-20.70676,66,38,5,-28
-42.09938,-20.70676,65,38,5,-27
-42.09915,-20.70676,64,38,5,-26
-42.09893,-20.70676,64,38,5,-26
-42.0987,-20.70676,64,38,5,-26
-42.09825,-20.70676,64,38,5,-26
-42.09803,-20.70676,65,35,5,-30
-42.0978,-20.70676,65,33,5,-32
-42.09758,-20.70676,65,33,5,-32
-42.09713,-20.70676,67,36,5,-31
-42.09691,-20.70676,67,37,5,-30
-42.09668,-20.70676,67,38,5,-29
-42.09646,-20.70676,66,38,5,-28
-42.09601,-20.70676,66,38,0,-28
-42.09578,-20.70676,66,38,0,-28
-42.09556,-20.70676,66,38,0,-28
-42.09533,-20.70676,67,38,0,-29
-42.09511,-20.70676,67,37,0,-30
-42.09466,-20.70676,67,37,0,-30
-42.09443,-20.70676,67,37,0,-30
-42.09421,-20.70676,67,37,0,-30
-42.09398,-20.70676,68,37,0,-31
-42.09354,-20.70676,68,37,0,-31
-42.09331,-20.70676,68,37,0,-31
-42.09309,-20.70676,68,37,0,-31
-42.09286,-20.70676,68,36,0,-32
-42.09241,-20.70676,68,35,0,-33
-42.09219,-20.70676,68,34,5,-34
-42.09196,-20.70676,68,30,5,-38
-42.09174,-20.70676,68,29,5,-39
-42.09129,-20.70676,68,29,5,-39
-42.09106,-20.70676,68,29,5,-39
-42.09084,-20.70676,68,29,5,-39
-42.09061,-20.70676,67,30,5,-37
-42.09039,-20.70676,65,30,5,-35
-42.08994,-20.70676,64,38,5,-26
-42.08972,-20.70676,63,38,0,-25
-42.08949,-20.70676,63,38,0,-25
-42.08927,-20.70676,65,38,0,-27
-42.08882,-20.70676,58,32,5,-26
-42.08859,-20.70676,57,32,5,-25
-42.08837,-20.70676,55,32,5,-23
-42.08814,-20.70676,55,32,5,-23
-42.08769,-20.70676,55,31,5,-24
-42.08747,-20.70676,55,32,5,-23
-42.08724,-20.70676,55,31,5,-24
-42.08702,-20.70676,56,31,5,-25
-42.08657,-20.70676,56,31,5,-25
-42.08634,-20.70676,56,35,5,-21
-42.08612,-20.70676,56,36,5,-20
-42.08589,-20.70676,56,38,5,-18
-42.08545,-20.70676,56,38,0,-18
-42.08522,-20.70676,56,38,0,-18
-42.085,-20.70676,56,37,5,-19
-42.08477,-20.70676,56,33,5,-23
-42.08455,-20.70676,56,32,5,-24
-42.0841,-20.70676,57,33,5,-24
-42.08387,-20.70676,57,38,5,-19
-42.08365,-20.70676,57,38,11,-19
-42.08342,-20.70676,57,38,5,-19
-42.08297,-20.70676,57,38,5,-19
-42.08275,-20.70676,58,38,5,-20
-42.08252,-20.70676,58,38,5,-20
-42.0823,-20.70676,58,38,5,-20
-42.08185,-20.70676,58,38,5,-20
-42.08163,-20.70676,58,38,5,-20
-42.0814,-20.70676,58,36,5,-22
-42.08118,-20.70676,58,35,5,-23
-42.08073,-20.70676,58,37,5,-21
-42.0805,-20.70676,58,37,5,-21
-42.08028,-20.70676,59,37,5,-22
-42.08005,-20.70676,59,38,5,-21
-42.07983,-20.70676,59,38,5,-21
-42.07938,-20.70676,59,39,5,-20
-42.07915,-20.70676,59,39,11,-20
-42.07893,-20.70676,59,39,11,-20
-42.0787,-20.70676,59,39,11,-20
-42.07825,-20.70676,59,38,5,-21
-42.07803,-20.70676,59,38,5,-21
-42.07781,-20.70676,59,37,5,-22
-42.07758,-20.70676,59,37,0,-22
-42.07713,-20.70676,59,36,11,-23
-42.07691,-20.70676,59,39,0,-20
-42.07668,-20.70676,59,44,0,-15
-42.07646,-20.70676,59,44,0,-15
-42.07601,-20.70676,59,44,0,-15
-42.07578,-20.70676,59,44,0,-15
-42.07556,-20.70676,59,44,0,-15
-42.07533,-20.70676,59,44,0,-15
-42.07511,-20.70676,59,44,0,-15
-42.07466,-20.70676,59,43,0,-16
-42.07443,-20.70676,59,43,0,-16
-42.07421,-20.70676,59,43,0,-16
-42.07399,-20.70676,59,43,0,-16
-42.07354,-20.70676,59,43,0,-16
-42.07331,-20.70676,60,43,0,-17
-42.07309,-20.70676,59,43,0,-16
-42.07286,-20.70676,59,43,0,-16
-42.07241,-20.70676,59,43,0,-16
-42.07219,-20.70676,59,43,0,-16
-42.07196,-20.70676,59,43,0,-16
-42.07174,-20.70676,59,41,5,-18
-42.07129,-20.70676,59,40,5,-19
-42.07106,-20.70676,59,38,5,-21
-42.07084,-20.70676,59,40,5,-19
-42.07061,-20.70676,60,40,0,-20
-42.07039,-20.70676,59,40,0,-19
-42.06994,-20.70676,60,41,0,-19
-42.06972,-20.70676,59,41,0,-18
-42.06949,-20.70676,59,41,0,-18
-42.06927,-20.70676,59,41,0,-18
-42.06882,-20.70676,59,41,0,-18
-42.06859,-20.70676,59,40,5,-19
-42.06837,-20.70676,60,39,5,-21
-42.06814,-20.70676,60,39,5,-21
-42.06769,-20.70676,60,39,5,-21
-42.06747,-20.70676,61,40,5,-21
-42.06724,-20.70676,61,41,5,-20
-42.06702,-20.70676,61,43,5,-18
-42.06657,-20.70676,61,44,0,-17
-42.06634,-20.70676,61,44,0,-17
-42.06612,-20.70676,61,42,0,-19
-42.0659,-20.70676,61,41,0,-20
-42.06545,-20.70676,61,41,5,-20
-42.06522,-20.70676,61,38,5,-23
-42.065,-20.70676,61,39,5,-22
-42.06477,-20.70676,61,39,5,-22
-42.06455,-20.70676,61,40,5,-21
-42.0641,-20.70676,61,41,5,-20
-42.06387,-20.70676,63,43,5,-20
-42.06365,-20.70676,65,43,5,-22
-42.06342,-20.70676,61,46,0,-15
-42.06297,-20.70676,55,48,0,-7
-42.06275,-20.70676,62,48,0,-14
-42.06252,-20.70676,51,48,0,-3
-42.0623,-20.70676,53,48,0,-5
-42.06185,-20.70676,55,49,0,-6
-42.06163,-20.70676,57,49,0,-8
-42.0614,-20.70676,57,48,0,-9
-42.06118,-20.70676,54,48,0,-6
-42.06073,-20.70676,49,48,0,-1
-42.0605,-20.70676,46,47,0,1
-42.06028,-20.70676,44,47,0,3
-42.06005,-20.70676,41,45,0,4
-42.05983,-20.70676,36,45,0,9
-42.05938,-20.70676,33,45,0,12
-42.05915,-20.70676,26,46,0,20
-42.05893,-20.70676,28,48,0,20
-42.0587,-20.70676,31,47,0,16
-42.05826,-20.70676,13,47,0,34
-42.05803,-20.70676,31,47,0,16
-42.05781,-20.70676,31,47,0,16
-42.05758,-20.70676,29,46,0,17
-42.05713,-20.70676,35,45,0,10
-42.05691,-20.70676,35,44,5,9
-42.05668,-20.70676,37,44,5,7
-42.05646,-20.70676,37,44,5,7
-42.05601,-20.70676,31,43,5,12
-42.05578,-20.70676,31,42,5,11
-42.05556,-20.70676,37,41,5,4
-42.05533,-20.70676,33,40,5,7
-42.05511,-20.70676,39,40,5,1
-42.05466,-20.70676,42,42,5,0
-42.05443,-20.70676,44,43,5,-1
-42.05421,-20.70676,45,43,5,-2
-42.05399,-20.70676,46,43,5,-3
-42.05354,-20.70676,50,49,0,-1
-42.05331,-20.70676,53,49,0,-4
-42.05309,-20.70676,54,49,0,-5
-42.05286,-20.70676,55,48,0,-7
-42.05241,-20.70676,57,46,0,-11
-42.05219,-20.70676,56,46,0,-10
-42.05196,-20.70676,52,46,0,-6
-42.05174,-20.70676,52,47,0,-5
-42.05129,-20.70676,53,47,0,-6
-42.05106,-20.70676,52,47,0,-5
-42.05084,-20.70676,53,47,0,-6
-42.05061,-20.70676,54,47,0,-7
-42.05039,-20.70676,53,48,0,-5
-42.04994,-20.70676,50,50,0,0
-42.04972,-20.70676,54,50,0,-4
-42.04949,-20.70676,53,50,0,-3
-42.04927,-20.70676,54,50,0,-4
-42.04882,-20.70676,55,50,0,-5
-42.04859,-20.70676,55,50,0,-5
-42.04837,-20.70676,55,50,0,-5
-42.04814,-20.70676,55,49,0,-6
-42.04769,-20.70676,54,45,0,-9
-42.04747,-20.70676,59,44,0,-15
-42.04724,-20.70676,58,46,0,-12
-42.04702,-20.70676,58,48,0,-10
-42.04657,-20.70676,52,48,0,-4
-42.04635,-20.70676,53,48,0,-5
-42.04612,-20.70676,51,48,0,-3
-42.0459,-20.70676,49,43,0,-6
-42.04545,-20.70676,48,46,0,-2
-42.04522,-20.70676,47,46,0,-1
-42.045,-20.70676,45,45,0,0
-42.04477,-20.70676,46,46,0,0
-42.04455,-20.70676,45,46,0,1
-42.0441,-20.70676,45,48,0,3
-42.04387,-20.70676,46,46,0,0
-42.04365,-20.70676,41,47,0,6
-42.04342,-20.70676,47,48,0,1
-42.04297,-20.70676,45,49,0,4
-42.04275,-20.70676,47,48,0,1
-42.04253,-20.70676,48,48,0,0
-42.0423,-20.70676,41,45,11,4
-42.04185,-20.70676,42,43,0,1
-42.04163,-20.70676,45,45,0,0
-42.0414,-20.70676,46,46,0,0
-42.04118,-20.70676,49,46,0,-3
-42.04073,-20.70676,51,46,0,-5
-42.0405,-20.70676,50,46,0,-4
-42.04028,-20.70676,50,46,0,-4
-42.04005,-20.70676,47,45,0,-2
-42.03983,-20.70676,46,45,0,-1
-42.03938,-20.70676,41,44,0,3
-42.03915,-20.70676,41,44,0,3
-42.03893,-20.70676,42,44,0,2
-42.0387,-20.70676,42,44,0,2
-42.03826,-20.70676,47,45,0,-2
-42.03803,-20.70676,45,45,0,0
-42.03781,-20.70676,41,44,0,3
-42.03758,-20.70676,40,44,0,4
-42.03713,-20.70676,37,45,0,8
-42.03691,-20.70676,37,44,0,7
-42.03668,-20.70676,36,45,0,9
-42.03646,-20.70676,37,45,0,8
-42.03601,-20.70676,37,45,0,8
-42.03578,-20.70676,37,45,0,8
-42.03556,-20.70676,37,45,0,8
-42.03533,-20.70676,36,45,0,9
-42.03511,-20.70676,36,44,0,8
-42.03466,-20.70676,36,36,11,0
-42.03444,-20.70676,37,37,5,0
-42.03421,-20.70676,35,36,5,1
-42.03399,-20.70676,34,34,5,0
-42.03354,-20.70676,32,37,5,5
-42.03331,-20.70676,31,39,11,8
-42.03309,-20.70676,30,44,5,14
-42.03286,-20.70676,29,44,5,15
-42.03241,-20.70676,27,53,0,26
-42.03219,-20.70676,24,48,0,24
-42.03196,-20.70676,24,45,0,21
-42.03174,-20.70676,19,41,11,22
-42.03129,-20.70676,15,40,5,25
-42.03106,-20.70676,14,41,5,27
-42.03084,-20.70676,14,42,5,28
-42.03062,-20.70676,15,42,5,27
-42.03017,-20.70676,16,51,0,35
-42.02994,-20.70676,16,50,0,34
-42.02972,-20.70676,26,50,11,24
-42.02949,-20.70676,25,50,0,25
-42.02927,-20.70676,20,49,11,29
-42.02882,-20.70676,20,48,0,28
-42.02859,-20.70676,20,48,0,28
-42.02837,-20.70676,36,46,0,10
-42.02814,-20.70676,22,44,0,22
-42.02769,-20.70676,24,44,0,20
-42.02747,-20.70676,23,44,0,21
-42.02724,-20.70676,31,43,0,12
-42.02702,-20.70676,38,43,0,5
-42.02657,-20.70676,39,44,0,5
-42.02635,-20.70676,41,45,0,4
-42.02612,-20.70676,45,46,0,1
-42.0259,-20.70676,46,47,0,1
-42.02545,-20.70676,47,50,0,3
-42.02522,-20.70676,48,51,0,3
-42.025,-20.70676,48,51,0,3
-42.02477,-20.70676,48,51,0,3
-42.02455,-20.70676,47,47,0,0
-42.0241,-20.70676,47,47,5,0
-42.02387,-20.70676,48,47,5,-1
-42.02365,-20.70676,48,47,11,-1
-42.02342,-20.70676,47,47,5,0
-42.02297,-20.70676,48,48,0,0
-42.02275,-20.70676,49,49,0,0
-42.02253,-20.70676,50,49,5,-1
-42.0223,-20.70676,52,47,5,-5
-42.02185,-20.70676,50,50,5,0
-42.02163,-20.70676,51,50,5,-1
-42.0214,-20.70676,54,52,5,-2
-42.02118,-20.70676,52,51,5,-1
-42.02073,-20.70676,53,44,5,-9
-42.0205,-20.70676,51,44,5,-7
-42.02028,-20.70676,51,45,5,-6
-42.02005,-20.70676,50,48,5,-2
-42.01983,-20.70676,50,50,5,0
-42.01938,-20.70676,49,50,11,1
-42.01915,-20.70676,49,50,5,1
-42.01893,-20.70676,48,43,5,-5
-42.01871,-20.70676,47,43,5,-4
-42.01826,-20.70676,45,44,5,-1
-42.01803,-20.70676,44,44,5,0
-42.01781,-20.70676,43,43,5,0
-42.01758,-20.70676,43,43,5,0
-42.01713,-20.70676,42,42,0,0
-42.01691,-20.70676,42,43,0,1
-42.01668,-20.70676,43,43,0,0
-42.01646,-20.70676,43,43,0,0
-42.01601,-20.70676,43,43,0,0
-42.01578,-20.70676,54,43,0,-11
-42.01556,-20.70676,56,42,0,-14
-42.01533,-20.70676,54,42,0,-12
-42.01511,-20.70676,55,42,0,-13
-42.01466,-20.70676,55,42,0,-13
-42.01444,-20.70676,54,42,0,-12
-42.01421,-20.70676,52,41,0,-11
-42.01399,-20.70676,51,41,0,-10
-42.01354,-20.70676,52,41,0,-11
-42.01331,-20.70676,55,41,0,-14
-42.01309,-20.70676,56,41,0,-15
-42.01286,-20.70676,55,41,0,-14
-42.01241,-20.70676,59,40,0,-19
-42.01219,-20.70676,59,40,0,-19
-42.01196,-20.70676,58,40,0,-18
-42.01174,-20.70676,58,40,0,-18
-42.01129,-20.70676,58,40,0,-18
-42.01106,-20.70676,58,40,0,-18
-42.01084,-20.70676,58,40,0,-18
-42.01062,-20.70676,54,40,0,-14
-42.01017,-20.70676,53,40,0,-13
-42.00994,-20.70676,53,40,0,-13
-42.00972,-20.70676,52,40,0,-12
-42.00949,-20.70676,51,39,0,-12
-42.00927,-20.70676,50,39,0,-11
-42.00882,-20.70676,50,40,0,-10
-42.00859,-20.70676,50,40,0,-10
-42.00837,-20.70676,50,39,0,-11
-42.00814,-20.70676,49,39,0,-10
-42.00769,-20.70676,48,39,0,-9
-42.00747,-20.70676,48,39,0,-9
-42.00724,-20.70676,48,41,0,-7
-42.00702,-20.70676,48,41,5,-7
-42.00657,-20.70676,47,36,5,-11
-42.00635,-20.70676,47,36,5,-11
-42.00612,-20.70676,47,35,5,-12
-42.0059,-20.70676,47,35,5,-12
-42.00545,-20.70676,48,35,5,-13
-42.00522,-20.70676,48,34,5,-14
-42.005,-20.70676,57,34,5,-23
-42.00477,-20.70676,59,34,5,-25
-42.00455,-20.70676,60,33,5,-27
-42.0041,-20.70676,61,33,5,-28
-42.00387,-20.70676,60,33,5,-27
-42.00365,-20.70676,59,32,5,-27
-42.00342,-20.70676,58,33,5,-25
-42.00298,-20.70676,58,33,5,-25
-42.00275,-20.70676,57,33,5,-24
-42.00253,-20.70676,56,34,5,-22
-42.0023,-20.70676,56,33,5,-23
-42.00185,-20.70676,56,34,5,-22
-42.00163,-20.70676,55,34,5,-21
-42.0014,-20.70676,55,33,5,-22
-42.00118,-20.70676,55,34,5,-21
-42.00073,-20.70676,54,35,5,-19
-42.0005,-20.70676,54,35,5,-19
-42.00028,-20.70676,54,35,5,-19
-42.00005,-20.70676,53,36,5,-17
-41.99983,-20.70676,52,36,5,-16
-41.99938,-20.70676,51,42,5,-9
-41.99916,-20.70676,50,42,5,-8
-41.99893,-20.70676,56,42,5,-14
-41.99871,-20.70676,59,37,5,-22
-41.99826,-20.70676,61,44,5,-17
-41.99803,-20.70676,62,45,5,-17
-41.99781,-20.70676,62,45,5,-17
-41.99758,-20.70676,62,45,5,-17
-41.99713,-20.70676,60,37,5,-23
-41.99691,-20.70676,58,36,5,-22
-41.99668,-20.70676,56,37,5,-19
-41.99646,-20.70676,52,37,5,-15
-41.99601,-20.70676,50,36,5,-14
-41.99578,-20.70676,50,35,5,-15
-41.99556,-20.70676,50,35,5,-15
-41.99533,-20.70676,50,35,5,-15
-41.99511,-20.70676,50,35,5,-15
-41.99466,-20.70676,54,35,5,-19
-41.99444,-20.70676,60,34,5,-26
-41.99421,-20.70676,58,34,5,-24
-41.99399,-20.70676,57,35,5,-22
-41.99354,-20.70676,58,36,0,-22
-41.99331,-20.70676,58,36,0,-22
-41.99309,-20.70676,58,35,0,-23
-41.99286,-20.70676,59,35,0,-24
-41.99241,-20.70676,58,34,0,-24
-41.99219,-20.70676,55,34,0,-21
-41.99196,-20.70676,53,34,0,-19
-41.99174,-20.70676,52,34,0,-18
-41.99129,-20.70676,51,33,0,-18
-41.99107,-20.70676,51,35,0,-16
-41.99084,-20.70676,51,37,0,-14
-41.99062,-20.70676,57,37,5,-20
-41.99017,-20.70676,60,40,5,-20
-41.98994,-20.70676,61,40,5,-21
-41.98972,-20.70676,62,40,5,-22
-41.98949,-20.70676,64,36,5,-28
-41.98927,-20.70676,60,35,5,-25
-41.98882,-20.70676,62,45,0,-17
-41.98859,-20.70676,63,45,0,-18
-41.98837,-20.70676,63,45,0,-18
-41.98814,-20.70676,63,45,0,-18
-41.98769,-20.70676,63,45,0,-18
-41.98747,-20.70676,63,45,0,-18
-41.98725,-20.70676,63,45,0,-18
-41.98702,-20.70676,61,44,0,-17
-41.98657,-20.70676,59,42,0,-17
-41.98635,-20.70676,58,41,0,-17
-41.98612,-20.70676,56,37,0,-19
-41.9859,-20.70676,54,36,0,-18
-41.98545,-20.70676,54,36,0,-18
-41.98522,-20.70676,54,36,0,-18
-41.985,-20.70676,53,35,0,-18
-41.98477,-20.70676,53,34,0,-19
-41.98455,-20.70676,58,35,0,-23
-41.9841,-20.70676,53,34,0,-19
-41.98387,-20.70676,60,35,0,-25
-41.98365,-20.70676,64,34,0,-30
-41.98343,-20.70676,57,35,0,-22
-41.98298,-20.70676,57,34,0,-23
-41.98275,-20.70676,55,35,0,-20
-41.98253,-20.70676,54,34,0,-20
-41.9823,-20.70676,54,34,0,-20
-41.98185,-20.70676,54,35,11,-19
-41.98163,-20.70676,54,35,11,-19
-41.9814,-20.70676,63,35,11,-28
-41.98118,-20.70676,54,35,0,-19
-41.98073,-20.70676,54,37,0,-17
-41.9805,-20.70676,54,38,0,-16
-41.98028,-20.70676,65,39,0,-26
-41.98005,-20.70676,68,39,0,-29
-41.97983,-20.70676,67,40,0,-27
-41.97938,-20.70676,67,41,0,-26
-41.97916,-20.70676,67,41,0,-26
-41.97893,-20.70676,67,41,0,-26
-41.97871,-20.70676,65,41,0,-24
-41.97826,-20.70676,65,42,0,-23
-41.97803,-20.70676,64,42,0,-22
-41.97781,-20.70676,64,42,0,-22
-41.97758,-20.70676,63,43,5,-20
-41.97713,-20.70676,63,43,5,-20
-41.97691,-20.70676,62,44,5,-18
-41.97668,-20.70676,62,44,5,-18
-41.97646,-20.70676,62,44,0,-18
-41.97601,-20.70676,60,45,0,-15
-41.97578,-20.70676,59,45,0,-14
-41.97556,-20.70676,57,45,0,-12
-41.97534,-20.70676,58,45,0,-13
-41.97511,-20.70676,56,45,0,-11
-41.97466,-20.70676,56,45,0,-11
-41.97444,-20.70676,58,45,0,-13
-41.97421,-20.70676,58,45,0,-13
-41.97399,-20.70676,56,45,0,-11
-41.97354,-20.70676,56,45,0,-11
-41.97331,-20.70676,56,45,5,-11
-41.97309,-20.70676,56,34,5,-22
-41.97286,-20.70676,56,37,5,-19
-41.97241,-20.70676,56,37,5,-19
-41.97219,-20.70676,56,32,5,-24
-41.97196,-20.70676,55,35,5,-20
-41.97174,-20.70676,55,39,5,-16
-41.97129,-20.70676,55,47,5,-8
-41.97107,-20.70676,55,47,5,-8
-41.97084,-20.70676,55,48,5,-7
-41.97062,-20.70676,54,47,5,-7
-41.97017,-20.70676,54,37,5,-17
-41.96994,-20.70676,54,48,5,-6
-41.96972,-20.70676,54,48,5,-6
-41.96949,-20.70676,53,48,5,-5
-41.96927,-20.70676,53,34,5,-19
-42.1005,-20.70633,64,34,5,-30
-42.0978,-20.70633,65,38,5,-27
-42.09511,-20.70633,67,37,0,-30
-42.09219,-20.70633,68,34,5,-34
-42.08949,-20.70633,65,38,0,-27
-42.08657,-20.70633,56,38,5,-18
-42.08387,-20.70633,56,36,5,-20
-42.08118,-20.70633,58,38,5,-20
-42.07825,-20.70633,59,34,5,-25
-42.07556,-20.70633,59,43,0,-16
-42.07286,-20.70633,59,43,0,-16
-42.06994,-20.70633,59,40,0,-19
-42.06724,-20.70633,61,40,0,-21
-42.06455,-20.70633,62,40,5,-22
-42.06163,-20.70633,57,47,0,-10
-42.05893,-20.70633,38,46,0,8
-42.05601,-20.70633,31,43,5,12
-42.05331,-20.70633,53,43,0,-10
-42.05061,-20.70633,53,47,0,-6
-42.04769,-20.70633,57,45,0,-12
-42.045,-20.70633,45,44,0,-1
-42.0423,-20.70633,40,44,0,4
-42.03938,-20.70633,46,45,0,-1
-42.03668,-20.70633,36,44,0,8
-42.03399,-20.70633,33,37,6,4
-42.03106,-20.70633,22,40,5,18
-42.02837,-20.70633,33,46,0,13
-42.02545,-20.70633,46,48,0,2
-42.02275,-20.70633,49,48,5,-1
-42.02005,-20.70633,50,46,5,-4
-42.01713,-20.70633,41,43,0,2
-42.01444,-20.70633,54,41,0,-13
-42.01174,-20.70633,57,40,5,-17
-42.00882,-20.70633,50,40,5,-10
-42.00612,-20.70633,47,36,5,-11
-42.00342,-20.70633,58,34,5,-24
-42.0005,-20.70633,53,35,5,-18
-41.99781,-20.70633,61,41,5,-20
-41.99511,-20.70633,53,35,5,-18
-41.99219,-20.70633,56,34,0,-22
-41.98949,-20.70633,62,36,5,-26
-41.98657,-20.70633,58,44,0,-14
-41.98387,-20.70633,60,35,0,-25
-41.98118,-20.70633,59,35,0,-24
-41.97826,-20.70633,64,41,0,-23
-41.97556,-20.70633,56,45,0,-11
-41.97286,-20.70633,55,34,5,-21
-41.96994,-20.70633,54,35,5,-19
-42.1005,-20.70612,63,31,5,-32
-42.0978,-20.70612,65,36,5,-29
-42.09511,-20.70612,67,37,0,-30
-42.09219,-20.70612,68,34,5,-34
-42.08949,-20.70612,65,38,5,-27
-42.08657,-20.70612,55,38,0,-17
-42.08387,-20.70612,56,31,5,-25
-42.08118,-20.70612,58,37,5,-21
-42.07825,-20.70612,59,38,5,-21
-42.07556,-20.70612,59,43,11,-16
-42.07286,-20.70612,59,42,0,-17
-42.06994,-20.70612,59,41,0,-18
-42.06724,-20.70612,61,43,0,-18
-42.06455,-20.70612,62,41,5,-21
-42.06163,-20.70612,59,46,0,-13
-42.05893,-20.70612,41,46,0,5
-42.05601,-20.70612,34,42,5,8
-42.05331,-20.70612,53,46,0,-7
-42.05061,-20.70612,54,47,0,-7
-42.04769,-20.70612,57,45,0,-12
-42.045,-20.70612,44,44,0,0
-42.0423,-20.70612,40,42,0,2
-42.03938,-20.70612,46,45,0,-1
-42.03668,-20.70612,36,44,11,8
-42.03399,-20.70612,31,40,11,9
-42.03106,-20.70612,22,40,5,18
-42.02837,-20.70612,36,44,0,8
-42.02545,-20.70612,47,48,0,1
-42.02275,-20.70612,50,45,5,-5
-42.02005,-20.70612,48,47,5,-1
-42.01713,-20.70612,40,44,0,4
-42.01444,-20.70612,51,41,0,-10
-42.01174,-20.70612,58,36,5,-22
-42.00882,-20.70612,50,36,5,-14
-42.00612,-20.70612,47,44,5,-3
-42.00342,-20.70612,57,34,5,-23
-42.0005,-20.70612,53,35,5,-18
-41.99781,-20.70612,61,39,5,-22
-41.99511,-20.70612,53,35,5,-18
-41.99219,-20.70612,56,34,0,-22
-41.98949,-20.70612,65,44,5,-21
-41.98657,-20.70612,54,41,0,-13
-41.98387,-20.70612,58,35,0,-23
-41.98118,-20.70612,63,35,0,-28
-41.97826,-20.70612,64,41,0,-23
-41.97556,-20.70612,56,44,0,-12
-41.97286,-20.70612,55,33,5,-22
-41.96994,-20.70612,54,36,5,-18
-42.1005,-20.70591,62,29,5,-33
-42.0978,-20.70591,65,33,5,-32
-42.09511,-20.70591,67,37,0,-30
-42.09219,-20.70591,67,30,5,-37
-42.08949,-20.70591,65,38,5,-27
-42.08657,-20.70591,55,38,0,-17
-42.08387,-20.70591,56,31,5,-25
-42.08118,-20.70591,58,38,5,-20
-42.07825,-20.70591,59,39,5,-20
-42.07556,-20.70591,59,43,5,-16
-42.07286,-20.70591,59,41,11,-18
-42.06994,-20.70591,59,41,0,-18
-42.06724,-20.70591,60,41,0,-19
-42.06455,-20.70591,61,43,0,-18
-42.06163,-20.70591,62,46,0,-16
-42.05893,-20.70591,47,47,0,0
-42.05601,-20.70591,27,41,5,14
-42.05331,-20.70591,55,47,0,-8
-42.05061,-20.70591,56,47,0,-9
-42.04769,-20.70591,60,47,0,-13
-42.045,-20.70591,46,46,11,0
-42.0423,-20.70591,40,41,0,1
-42.03938,-20.70591,44,45,0,1
-42.03668,-20.70591,36,43,5,7
-42.03399,-20.70591,31,41,5,10
-42.03106,-20.70591,24,40,5,16
-42.02837,-20.70591,39,47,11,8
-42.02545,-20.70591,48,48,0,0
-42.02275,-20.70591,50,46,5,-4
-42.02005,-20.70591,47,46,5,-1
-42.01713,-20.70591,41,44,0,3
-42.01444,-20.70591,48,41,0,-7
-42.01174,-20.70591,58,36,5,-22
-42.00882,-20.70591,51,37,5,-14
-42.00612,-20.70591,47,44,0,-3
-42.00342,-20.70591,56,34,5,-22
-42.0005,-20.70591,56,36,5,-20
-41.99781,-20.70591,60,39,5,-21
-41.99511,-20.70591,50,35,5,-15
-41.99219,-20.70591,56,34,0,-22
-41.98949,-20.70591,66,44,0,-22
-41.98657,-20.70591,54,39,0,-15
-41.98387,-20.70591,62,35,0,-27
-41.98118,-20.70591,63,33,0,-30
-41.97826,-20.70591,64,41,0,-23
-41.97556,-20.70591,57,44,0,-13
-41.97286,-20.70591,55,35,5,-20
-41.96994,-20.70591,54,37,5,-17
-42.1005,-20.70549,61,29,5,-32
-42.0978,-20.70549,65,38,5,-27
-42.09511,-20.70549,67,37,0,-30
-42.09219,-20.70549,67,30,5,-37
-42.08949,-20.70549,66,38,5,-28
-42.08657,-20.70549,55,38,0,-17
-42.08387,-20.70549,56,32,5,-24
-42.08118,-20.70549,58,36,5,-22
-42.07825,-20.70549,58,39,5,-19
-42.07556,-20.70549,59,43,6,-16
-42.07286,-20.70549,59,41,0,-18
-42.06994,-20.70549,60,39,0,-21
-42.06724,-20.70549,60,41,0,-19
-42.06455,-20.70549,61,43,0,-18
-42.06163,-20.70549,66,45,0,-21
-42.05893,-20.70549,53,46,0,-7
-42.05601,-20.70549,30,41,5,11
-42.05331,-20.70549,54,45,0,-9
-42.05061,-20.70549,56,47,0,-9
-42.04769,-20.70549,60,47,0,-13
-42.045,-20.70549,47,44,0,-3
-42.0423,-20.70549,40,40,0,0
-42.03938,-20.70549,51,46,0,-5
-42.03668,-20.70549,36,43,5,7
-42.03399,-20.70549,30,41,5,11
-42.03106,-20.70549,41,41,0,0
-42.02837,-20.70549,40,45,11,5
-42.02545,-20.70549,51,48,0,-3
-42.02275,-20.70549,50,47,5,-3
-42.02005,-20.70549,46,46,0,0
-42.01713,-20.70549,42,42,0,0
-42.01444,-20.70549,47,40,0,-7
-42.01174,-20.70549,58,36,5,-22
-42.00882,-20.70549,52,43,5,-9
-42.00612,-20.70549,51,43,5,-8
-42.00342,-20.70549,56,35,5,-21
-42.0005,-20.70549,58,37,5,-21
-41.99781,-20.70549,59,35,5,-24
-41.99511,-20.70549,50,36,5,-14
-41.99219,-20.70549,57,34,0,-23
-41.98949,-20.70549,65,44,0,-21
-41.98657,-20.70549,51,37,0,-14
-41.98387,-20.70549,65,35,0,-30
-41.98118,-20.70549,65,32,0,-33
-41.97826,-20.70549,65,40,0,-25
-41.97556,-20.70549,58,44,0,-14
-41.97286,-20.70549,55,36,5,-19
-41.96994,-20.70549,54,37,5,-17
-42.1005,-20.70528,62,29,5,-33
-42.0978,-20.70528,65,38,5,-27
-42.09511,-20.70528,67,37,0,-30
-42.09219,-20.70528,68,30,5,-38
-42.08949,-20.70528,66,36,5,-30
-42.08657,-20.70528,55,38,0,-17
-42.08387,-20.70528,56,33,5,-23
-42.08118,-20.70528,58,36,5,-22
-42.07825,-20.70528,58,38,5,-20
-42.07556,-20.70528,59,43,6,-16
-42.07286,-20.70528,59,41,5,-18
-42.06994,-20.70528,60,37,11,-23
-42.06724,-20.70528,60,37,0,-23
-42.06455,-20.70528,61,43,0,-18
-42.06163,-20.70528,64,45,0,-19
-42.05893,-20.70528,54,46,0,-8
-42.05601,-20.70528,33,41,5,8
-42.05331,-20.70528,52,46,0,-6
-42.05061,-20.70528,56,46,11,-10
-42.04769,-20.70528,58,47,11,-11
-42.045,-20.70528,50,43,0,-7
-42.0423,-20.70528,40,40,0,0
-42.03938,-20.70528,50,46,0,-4
-42.03668,-20.70528,36,42,5,6
-42.03399,-20.70528,29,40,5,11
-42.03106,-20.70528,45,46,0,1
-42.02837,-20.70528,44,47,5,3
-42.02545,-20.70528,50,44,0,-6
-42.02275,-20.70528,50,47,5,-3
-42.02005,-20.70528,46,52,0,6
-42.01713,-20.70528,40,42,0,2
-42.01444,-20.70528,43,41,0,-2
-42.01174,-20.70528,55,36,5,-19
-42.00882,-20.70528,53,44,0,-9
-42.00612,-20.70528,52,37,5,-15
-42.00342,-20.70528,55,36,5,-19
-42.0005,-20.70528,55,36,5,-19
-41.99781,-20.70528,58,35,5,-23
-41.99511,-20.70528,50,36,5,-14
-41.99219,-20.70528,58,34,0,-24
-41.98949,-20.70528,64,43,0,-21
-41.98657,-20.70528,54,36,0,-18
-41.98387,-20.70528,64,33,0,-31
-41.98118,-20.70528,66,31,0,-35
-41.97826,-20.70528,65,40,0,-25
-41.97556,-20.70528,59,44,0,-15
-41.97286,-20.70528,55,35,5,-20
-41.96994,-20.70528,54,34,5,-20
-42.1005,-20.70506,62,29,5,-33
-42.0978,-20.70506,65,38,5,-27
-42.09511,-20.70506,67,37,0,-30
-42.09219,-20.70506,67,30,5,-37
-42.08949,-20.70506,66,36,5,-30
-42.08657,-20.70506,60,38,0,-22
-42.08387,-20.70506,56,33,5,-23
-42.08118,-20.70506,57,37,5,-20
-42.07825,-20.70506,58,39,5,-19
-42.07556,-20.70506,59,43,6,-16
-42.07286,-20.70506,59,41,5,-18
-42.06994,-20.70506,60,40,0,-20
-42.06724,-20.70506,60,36,11,-24
-42.06455,-20.70506,60,43,0,-17
-42.06163,-20.70506,63,45,0,-18
-42.05893,-20.70506,55,45,0,-10
-42.05601,-20.70506,45,44,5,-1
-42.05331,-20.70506,56,46,0,-10
-42.05061,-20.70506,57,47,0,-10
-42.04769,-20.70506,58,46,0,-12
-42.045,-20.70506,53,44,0,-9
-42.0423,-20.70506,44,43,0,-1
-42.03938,-20.70506,47,46,0,-1
-42.03668,-20.70506,35,43,11,8
-42.03399,-20.70506,28,44,5,16
-42.03106,-20.70506,46,46,0,0
-42.02837,-20.70506,44,46,5,2
-42.02545,-20.70506,49,40,0,-9
-42.02275,-20.70506,50,47,5,-3
-42.02005,-20.70506,46,51,0,5
-42.01713,-20.70506,41,43,0,2
-42.01444,-20.70506,43,42,0,-1
-42.01174,-20.70506,53,40,5,-13
-42.00882,-20.70506,53,44,0,-9
-42.00612,-20.70506,56,38,5,-18
-42.00342,-20.70506,52,36,5,-16
-42.0005,-20.70506,54,39,5,-15
-41.99781,-20.70506,58,36,5,-22
-41.99511,-20.70506,50,35,5,-15
-41.99219,-20.70506,59,34,0,-25
-41.98949,-20.70506,64,41,0,-23
-41.98657,-20.70506,53,36,0,-17
-41.98387,-20.70506,64,32,0,-32
-41.98118,-20.70506,66,31,0,-35
-41.97826,-20.70506,65,40,0,-25
-41.97556,-20.70506,59,44,0,-15
-41.97286,-20.70506,55,36,5,-19
-41.96994,-20.70506,54,34,5,-20
-42.1005,-20.70464,62,31,5,-31
-42.0978,-20.70464,65,38,0,-27
-42.09511,-20.70464,67,37,5,-30
-42.09219,-20.70464,68,30,5,-38
-42.08949,-20.70464,65,32,5,-33
-42.08657,-20.70464,61,38,5,-23
-42.08387,-20.70464,56,34,5,-22
-42.08118,-20.70464,57,40,5,-17
-42.07825,-20.70464,58,43,5,-15
-42.07556,-20.70464,59,44,5,-15
-42.07286,-20.70464,59,42,6,-17
-42.06994,-20.70464,60,40,5,-20
-42.06724,-20.70464,60,39,0,-21
-42.06455,-20.70464,60,43,11,-17
-42.06163,-20.70464,63,45,11,-18
-42.05893,-20.70464,61,45,0,-16
-42.05601,-20.70464,54,45,0,-9
-42.05331,-20.70464,59,47,0,-12
-42.05061,-20.70464,58,47,0,-11
-42.04769,-20.70464,58,46,0,-12
-42.045,-20.70464,57,42,0,-15
-42.0423,-20.70464,49,43,0,-6
-42.03938,-20.70464,47,46,2,-1
-42.03668,-20.70464,35,42,5,7
-42.03399,-20.70464,26,42,5,16
-42.03106,-20.70464,46,46,0,0
-42.02837,-20.70464,45,44,5,-1
-42.02545,-20.70464,48,40,0,-8
-42.02275,-20.70464,50,49,5,-1
-42.02005,-20.70464,47,47,0,0
-42.01713,-20.70464,42,43,0,1
-42.01444,-20.70464,42,38,5,-4
-42.01174,-20.70464,53,44,5,-9
-42.00882,-20.70464,53,39,5,-14
-42.00612,-20.70464,57,38,5,-19
-42.00342,-20.70464,51,36,5,-15
-42.0005,-20.70464,52,42,5,-10
-41.99781,-20.70464,53,36,5,-17
-41.99511,-20.70464,51,35,5,-16
-41.99219,-20.70464,59,34,0,-25
-41.98949,-20.70464,64,36,0,-28
-41.98657,-20.70464,55,35,0,-20
-41.98387,-20.70464,65,31,0,-34
-41.98118,-20.70464,66,33,0,-33
-41.97826,-20.70464,65,41,0,-24
-41.97556,-20.70464,60,43,5,-17
-41.97286,-20.70464,54,39,5,-15
-41.96994,-20.70464,54,34,5,-20
-42.1005,-20.70443,62,38,0,-24
-42.0978,-20.70443,66,38,0,-28
-42.09511,-20.70443,67,37,5,-30
-42.09219,-20.70443,68,30,5,-38
-42.08949,-20.70443,65,31,5,-34
-42.08657,-20.70443,62,34,5,-28
-42.08387,-20.70443,56,33,5,-23
-42.08118,-20.70443,57,41,5,-16
-42.07825,-20.70443,58,40,5,-18
-42.07556,-20.70443,59,43,5,-16
-42.07286,-20.70443,60,42,5,-18
-42.06994,-20.70443,60,41,6,-19
-42.06724,-20.70443,60,41,0,-19
-42.06455,-20.70443,60,43,0,-17
-42.06163,-20.70443,63,45,0,-18
-42.05893,-20.70443,64,44,11,-20
-42.05601,-20.70443,53,45,0,-8
-42.05331,-20.70443,61,47,0,-14
-42.05061,-20.70443,58,47,0,-11
-42.04769,-20.70443,58,46,0,-12
-42.045,-20.70443,58,42,0,-16
-42.0423,-20.70443,50,43,0,-7
-42.03938,-20.70443,45,44,2,-1
-42.03668,-20.70443,35,41,5,6
-42.03399,-20.70443,24,42,5,18
-42.03106,-20.70443,46,46,0,0
-42.02837,-20.70443,46,46,5,0
-42.02545,-20.70443,48,39,0,-9
-42.02275,-20.70443,50,48,5,-2
-42.02005,-20.70443,46,46,0,0
-42.01713,-20.70443,43,43,0,0
-42.01444,-20.70443,42,38,5,-4
-42.01174,-20.70443,50,44,5,-6
-42.00882,-20.70443,53,40,5,-13
-42.00612,-20.70443,52,37,5,-15
-42.00342,-20.70443,51,39,5,-12
-42.0005,-20.70443,52,42,5,-10
-41.99781,-20.70443,52,36,5,-16
-41.99511,-20.70443,56,35,5,-21
-41.99219,-20.70443,60,35,0,-25
-41.98949,-20.70443,63,35,0,-28
-41.98657,-20.70443,56,35,0,-21
-41.98387,-20.70443,66,31,0,-35
-41.98118,-20.70443,65,33,0,-32
-41.97826,-20.70443,64,40,0,-24
-41.97556,-20.70443,60,31,5,-29
-41.97286,-20.70443,54,47,5,-7
-41.96994,-20.70443,54,33,5,-21
-42.1005,-20.70422,62,38,0,-24
-42.0978,-20.70422,66,38,0,-28
-42.09511,-20.70422,68,37,5,-31
-42.09219,-20.70422,68,30,5,-38
-42.08949,-20.70422,65,31,5,-34
-42.08657,-20.70422,64,32,5,-32
-42.08387,-20.70422,56,34,5,-22
-42.08118,-20.70422,57,44,5,-13
-42.07825,-20.70422,58,39,5,-19
-42.07556,-20.70422,59,44,11,-15
-42.07286,-20.70422,61,44,5,-17
-42.06994,-20.70422,60,41,5,-19
-42.06724,-20.70422,60,41,5,-19
-42.06455,-20.70422,60,42,0,-18
-42.06163,-20.70422,63,45,0,-18
-42.05893,-20.70422,65,44,5,-21
-42.05601,-20.70422,50,45,0,-5
-42.05331,-20.70422,59,47,0,-12
-42.05061,-20.70422,61,47,0,-14
-42.04769,-20.70422,58,45,0,-13
-42.045,-20.70422,57,41,5,-16
-42.0423,-20.70422,49,44,0,-5
-42.03938,-20.70422,44,42,2,-2
-42.03668,-20.70422,35,42,5,7
-42.03399,-20.70422,24,42,5,18
-42.03106,-20.70422,46,47,0,1
-42.02837,-20.70422,47,48,5,1
-42.02545,-20.70422,48,39,11,-9
-42.02275,-20.70422,49,50,5,1
-42.02005,-20.70422,45,44,0,-1
-42.01713,-20.70422,48,45,0,-3
-42.01444,-20.70422,43,37,5,-6
-42.01174,-20.70422,49,44,5,-5
-42.00882,-20.70422,53,46,5,-7
-42.00612,-20.70422,49,38,5,-11
-42.00342,-20.70422,56,37,5,-19
-42.0005,-20.70422,51,39,5,-12
-41.99781,-20.70422,51,39,5,-12
-41.99511,-20.70422,57,34,5,-23
-41.99219,-20.70422,60,35,0,-25
-41.98949,-20.70422,62,35,0,-27
-41.98657,-20.70422,57,35,0,-22
-41.98387,-20.70422,64,30,0,-34
-41.98118,-20.70422,65,34,0,-31
-41.97826,-20.70422,64,40,0,-24
-41.97556,-20.70422,59,31,5,-28
-41.97286,-20.70422,54,47,5,-7
-41.96994,-20.70422,53,33,5,-20
-42.10297,-20.7038,59,29,5,-30
-42.10275,-20.7038,60,29,5,-31
-42.10252,-20.7038,60,28,5,-32
-42.1023,-20.7038,60,28,5,-32
-42.10185,-20.7038,60,28,5,-32
-42.10163,-20.7038,60,28,5,-32
-42.1014,-20.7038,61,31,5,-30
-42.10118,-20.7038,61,38,0,-23
-42.10073,-20.7038,61,38,0,-23
-42.1005,-20.7038,61,38,0,-23
-42.10028,-20.7038,62,38,0,-24
-42.10005,-20.7038,63,36,0,-27
-42.09983,-20.7038,63,34,0,-29
-42.09938,-20.7038,64,33,0,-31
-42.09915,-20.7038,65,32,0,-33
-42.09893,-20.7038,66,35,0,-31
-42.0987,-20.7038,66,35,0,-31
-42.09825,-20.7038,66,38,0,-28
-42.09803,-20.7038,67,38,0,-29
-42.0978,-20.7038,67,38,0,-29
-42.09758,-20.7038,67,38,0,-29
-42.09713,-20.7038,66,38,0,-28
-42.09691,-20.7038,66,38,0,-28
-42.09668,-20.7038,66,38,0,-28
-42.09646,-20.7038,66,38,0,-28
-42.09601,-20.7038,66,38,0,-28
-42.09578,-20.7038,67,38,0,-29
-42.09556,-20.7038,67,38,0,-29
-42.09533,-20.7038,67,38,0,-29
-42.09511,-20.7038,67,37,0,-30
-42.09466,-20.7038,68,37,0,-31
-42.09443,-20.7038,68,37,5,-31
-42.09421,-20.7038,68,33,5,-35
-42.09398,-20.7038,68,33,5,-35
-42.09354,-20.7038,68,37,5,-31
-42.09331,-20.7038,68,37,5,-31
-42.09309,-20.7038,68,36,5,-32
-42.09286,-20.7038,68,33,5,-35
-42.09241,-20.7038,67,32,5,-35
-42.09219,-20.7038,67,32,5,-35
-42.09196,-20.7038,67,31,5,-36
-42.09174,-20.7038,67,30,5,-37
-42.09129,-20.7038,68,30,5,-38
-42.09106,-20.7038,68,30,5,-38
-42.09084,-20.7038,68,31,5,-37
-42.09061,-20.7038,68,34,5,-34
-42.09039,-20.7038,69,33,5,-36
-42.08994,-20.7038,70,34,5,-36
-42.08972,-20.7038,67,34,5,-33
-42.08949,-20.7038,66,38,5,-28
-42.08927,-20.7038,66,38,0,-28
-42.08882,-20.7038,65,38,0,-27
-42.08859,-20.7038,65,38,0,-27
-42.08837,-20.7038,62,38,0,-24
-42.08814,-20.7038,62,38,0,-24
-42.08769,-20.7038,62,38,0,-24
-42.08747,-20.7038,62,35,5,-27
-42.08724,-20.7038,62,31,5,-31
-42.08702,-20.7038,63,31,5,-32
-42.08657,-20.7038,64,35,5,-29
-42.08634,-20.7038,64,34,11,-30
-42.08612,-20.7038,64,34,5,-30
-42.08589,-20.7038,62,31,5,-31
-42.08545,-20.7038,57,31,5,-26
-42.08522,-20.7038,56,31,5,-25
-42.085,-20.7038,56,33,5,-23
-42.08477,-20.7038,56,33,5,-23
-42.08455,-20.7038,56,33,5,-23
-42.0841,-20.7038,56,35,5,-21
-42.08387,-20.7038,56,36,5,-20
-42.08365,-20.7038,57,36,5,-21
-42.08342,-20.7038,57,36,5,-21
-42.08297,-20.7038,58,39,5,-19
-42.08275,-20.7038,61,42,5,-19
-42.08252,-20.7038,62,42,5,-20
-42.0823,-20.7038,63,42,5,-21
-42.08185,-20.7038,63,41,5,-22
-42.08163,-20.7038,61,45,5,-16
-42.0814,-20.7038,57,42,5,-15
-42.08118,-20.7038,57,42,5,-15
-42.08073,-20.7038,57,41,5,-16
-42.0805,-20.7038,57,43,5,-14
-42.08028,-20.7038,57,44,5,-13
-42.08005,-20.7038,57,43,5,-14
-42.07983,-20.7038,58,40,5,-18
-42.07938,-20.7038,58,40,5,-18
-42.07915,-20.7038,58,39,5,-19
-42.07893,-20.7038,58,38,5,-20
-42.0787,-20.7038,58,39,5,-19
-42.07825,-20.7038,58,39,5,-19
-42.07803,-20.7038,58,40,5,-18
-42.07781,-20.7038,59,41,5,-18
-42.07758,-20.7038,59,39,5,-20
-42.07713,-20.7038,59,43,5,-16
-42.07691,-20.7038,59,43,5,-16
-42.07668,-20.7038,59,42,5,-17
-42.07646,-20.7038,59,42,5,-17
-42.07601,-20.7038,59,44,11,-15
-42.07578,-20.7038,59,44,5,-15
-42.07556,-20.7038,59,43,5,-16
-42.07533,-20.7038,59,43,5,-16
-42.07511,-20.7038,59,44,5,-15
-42.07466,-20.7038,59,44,5,-15
-42.07443,-20.7038,59,44,5,-15
-42.07421,-20.7038,59,44,5,-15
-42.07399,-20.7038,59,44,5,-15
-42.07354,-20.7038,59,44,5,-15
-42.07331,-20.7038,60,44,5,-16
-42.07309,-20.7038,60,44,5,-16
-42.07286,-20.7038,61,44,5,-17
-42.07241,-20.7038,61,44,0,-17
-42.07219,-20.7038,60,44,5,-16
-42.07196,-20.7038,60,44,5,-16
-42.07174,-20.7038,60,44,5,-16
-42.07129,-20.7038,60,44,5,-16
-42.07106,-20.7038,60,44,0,-16
-42.07084,-20.7038,60,44,11,-16
-42.07061,-20.7038,60,44,11,-16
-42.07039,-20.7038,60,44,11,-16
-42.06994,-20.7038,60,44,0,-16
-42.06972,-20.7038,60,44,0,-16
-42.06949,-20.7038,60,43,0,-17
-42.06927,-20.7038,60,43,0,-17
-42.06882,-20.7038,60,42,0,-18
-42.06859,-20.7038,60,43,0,-17
-42.06837,-20.7038,60,42,0,-18
-42.06814,-20.7038,60,42,0,-18
-42.06769,-20.7038,60,42,6,-18
-42.06747,-20.7038,60,41,6,-19
-42.06724,-20.7038,60,41,5,-19
-42.06702,-20.7038,60,42,5,-18
-42.06657,-20.7038,60,42,6,-18
-42.06634,-20.7038,61,42,5,-19
-42.06612,-20.7038,61,42,5,-19
-42.0659,-20.7038,60,42,5,-18
-42.06545,-20.7038,60,42,5,-18
-42.06522,-20.7038,60,42,0,-18
-42.065,-20.7038,60,42,0,-18
-42.06477,-20.7038,60,43,0,-17
-42.06455,-20.7038,60,43,0,-17
-42.0641,-20.7038,60,44,5,-16
-42.06387,-20.7038,60,44,5,-16
-42.06365,-20.7038,60,44,5,-16
-42.06342,-20.7038,60,46,5,-14
-42.06297,-20.7038,60,46,0,-14
-42.06275,-20.7038,61,45,0,-16
-42.06252,-20.7038,61,45,0,-16
-42.0623,-20.7038,61,45,11,-16
-42.06185,-20.7038,62,45,0,-17
-42.06163,-20.7038,62,45,0,-17
-42.0614,-20.7038,63,45,0,-18
-42.06118,-20.7038,63,45,0,-18
-42.06073,-20.7038,63,45,0,-18
-42.0605,-20.7038,63,45,0,-18
-42.06028,-20.7038,64,44,0,-20
-42.06005,-20.7038,64,44,0,-20
-42.05983,-20.7038,64,44,0,-20
-42.05938,-20.7038,65,44,0,-21
-42.05915,-20.7038,66,44,5,-22
-42.05893,-20.7038,68,42,5,-26
-42.0587,-20.7038,76,44,5,-32
-42.05826,-20.7038,77,43,5,-34
-42.05803,-20.7038,65,42,5,-23
-42.05781,-20.7038,64,43,5,-21
-42.05758,-20.7038,66,44,5,-22
-42.05713,-20.7038,64,43,5,-21
-42.05691,-20.7038,64,45,5,-19
-42.05668,-20.7038,60,45,11,-15
-42.05646,-20.7038,57,45,11,-12
-42.05601,-20.7038,58,45,11,-13
-42.05578,-20.7038,58,44,0,-14
-42.05556,-20.7038,58,44,0,-14
-42.05533,-20.7038,46,46,0,0
-42.05511,-20.7038,53,46,0,-7
-42.05466,-20.7038,57,46,0,-11
-42.05443,-20.7038,61,47,0,-14
-42.05421,-20.7038,69,47,0,-22
-42.05399,-20.7038,67,47,0,-20
-42.05354,-20.7038,63,47,11,-16
-42.05331,-20.7038,60,47,11,-13
-42.05309,-20.7038,62,47,11,-15
-42.05286,-20.7038,61,48,0,-13
-42.05241,-20.7038,61,47,5,-14
-42.05219,-20.7038,57,46,5,-11
-42.05196,-20.7038,57,46,5,-11
-42.05174,-20.7038,58,45,5,-13
-42.05129,-20.7038,58,48,0,-10
-42.05106,-20.7038,57,48,0,-9
-42.05084,-20.7038,57,48,0,-9
-42.05061,-20.7038,60,47,5,-13
-42.05039,-20.7038,59,46,5,-13
-42.04994,-20.7038,59,46,5,-13
-42.04972,-20.7038,59,46,5,-13
-42.04949,-20.7038,59,46,0,-13
-42.04927,-20.7038,60,43,0,-17
-42.04882,-20.7038,61,46,0,-15
-42.04859,-20.7038,59,46,5,-13
-42.04837,-20.7038,59,46,5,-13
-42.04814,-20.7038,59,47,5,-12
-42.04769,-20.7038,58,47,5,-11
-42.04747,-20.7038,54,42,5,-12
-42.04724,-20.7038,52,42,5,-10
-42.04702,-20.7038,55,42,5,-13
-42.04657,-20.7038,53,38,0,-15
-42.04635,-20.7038,52,41,0,-11
-42.04612,-20.7038,48,41,0,-7
-42.0459,-20.7038,54,42,0,-12
-42.04545,-20.7038,54,39,5,-15
-42.04522,-20.7038,57,37,5,-20
-42.045,-20.7038,59,39,5,-20
-42.04477,-20.7038,59,38,5,-21
-42.04455,-20.7038,61,41,5,-20
-42.0441,-20.7038,53,41,0,-12
-42.04387,-20.7038,52,38,0,-14
-42.04365,-20.7038,51,37,0,-14
-42.04342,-20.7038,48,37,0,-11
-42.04297,-20.7038,43,36,0,-7
-42.04275,-20.7038,43,34,0,-9
-42.04253,-20.7038,45,41,0,-4
-42.0423,-20.7038,45,43,0,-2
-42.04185,-20.7038,45,44,0,-1
-42.04163,-20.7038,47,45,0,-2
-42.0414,-20.7038,45,43,0,-2
-42.04118,-20.7038,45,43,0,-2
-42.04073,-20.7038,44,43,0,-1
-42.0405,-20.7038,44,45,0,1
-42.04028,-20.7038,45,44,2,-1
-42.04005,-20.7038,45,43,2,-2
-42.03983,-20.7038,44,41,2,-3
-42.03938,-20.7038,44,41,2,-3
-42.03915,-20.7038,41,41,2,0
-42.03893,-20.7038,39,41,2,2
-42.0387,-20.7038,38,41,2,3
-42.03826,-20.7038,38,45,5,7
-42.03803,-20.7038,36,41,6,5
-42.03781,-20.7038,36,43,11,7
-42.03758,-20.7038,34,42,5,8
-42.03713,-20.7038,35,42,5,7
-42.03691,-20.7038,35,41,5,6
-42.03668,-20.7038,35,41,5,6
-42.03646,-20.7038,34,40,5,6
-42.03601,-20.7038,35,41,5,6
-42.03578,-20.7038,34,41,5,7
-42.03556,-20.7038,34,41,5,7
-42.03533,-20.7038,34,41,5,7
-42.03511,-20.7038,33,41,5,8
-42.03466,-20.7038,32,40,5,8
-42.03444,-20.7038,31,40,5,9
-42.03421,-20.7038,27,40,5,13
-42.03399,-20.7038,24,40,5,16
-42.03354,-20.7038,21,41,0,20
-42.03331,-20.7038,19,42,0,23
-42.03309,-20.7038,19,44,0,25
-42.03286,-20.7038,22,44,0,22
-42.03241,-20.7038,25,41,0,16
-42.03219,-20.7038,24,42,0,18
-42.03196,-20.7038,27,41,0,14
-42.03174,-20.7038,39,43,0,4
-42.03129,-20.7038,43,42,11,-1
-42.03106,-20.7038,46,45,0,-1
-42.03084,-20.7038,47,46,0,-1
-42.03062,-20.7038,48,48,0,0
-42.03017,-20.7038,48,50,0,2
-42.02994,-20.7038,49,51,0,2
-42.02972,-20.7038,48,51,0,3
-42.02949,-20.7038,48,51,0,3
-42.02927,-20.7038,48,51,0,3
-42.02882,-20.7038,49,49,11,0
-42.02859,-20.7038,49,48,0,-1
-42.02837,-20.7038,48,48,0,0
-42.02814,-20.7038,47,47,0,0
-42.02769,-20.7038,46,46,0,0
-42.02747,-20.7038,45,45,0,0
-42.02724,-20.7038,45,44,0,-1
-42.02702,-20.7038,44,42,0,-2
-42.02657,-20.7038,44,42,0,-2
-42.02635,-20.7038,45,41,5,-4
-42.02612,-20.7038,46,38,5,-8
-42.0259,-20.7038,47,39,5,-8
-42.02545,-20.7038,48,38,5,-10
-42.02522,-20.7038,48,39,5,-9
-42.025,-20.7038,48,40,5,-8
-42.02477,-20.7038,49,41,5,-8
-42.02455,-20.7038,49,44,5,-5
-42.0241,-20.7038,49,48,5,-1
-42.02387,-20.7038,49,49,5,0
-42.02365,-20.7038,49,49,5,0
-42.02342,-20.7038,49,48,5,-1
-42.02297,-20.7038,49,49,5,0
-42.02275,-20.7038,49,50,5,1
-42.02253,-20.7038,48,48,5,0
-42.0223,-20.7038,47,47,5,0
-42.02185,-20.7038,47,48,5,1
-42.02163,-20.7038,47,48,5,1
-42.0214,-20.7038,46,45,5,-1
-42.02118,-20.7038,46,46,5,0
-42.02073,-20.7038,46,44,5,-2
-42.0205,-20.7038,45,44,0,-1
-42.02028,-20.7038,46,44,0,-2
-42.02005,-20.7038,45,44,0,-1
-42.01983,-20.7038,45,44,0,-1
-42.01938,-20.7038,45,43,0,-2
-42.01915,-20.7038,47,43,0,-4
-42.01893,-20.7038,51,43,0,-8
-42.01871,-20.7038,52,43,11,-9
-42.01826,-20.7038,53,43,0,-10
-42.01803,-20.7038,51,43,0,-8
-42.01781,-20.7038,54,44,0,-10
-42.01758,-20.7038,52,44,0,-8
-42.01713,-20.7038,51,45,0,-6
-42.01691,-20.7038,56,45,0,-11
-42.01668,-20.7038,53,45,0,-8
-42.01646,-20.7038,53,44,0,-9
-42.01601,-20.7038,59,44,0,-15
-42.01578,-20.7038,56,43,5,-13
-42.01556,-20.7038,55,41,5,-14
-42.01533,-20.7038,54,38,5,-16
-42.01511,-20.7038,52,38,5,-14
-42.01466,-20.7038,49,39,5,-10
-42.01444,-20.7038,48,40,5,-8
-42.01421,-20.7038,43,41,5,-2
-42.01399,-20.7038,46,41,5,-5
-42.01354,-20.7038,49,41,5,-8
-42.01331,-20.7038,47,41,5,-6
-42.01309,-20.7038,44,41,5,-3
-42.01286,-20.7038,47,40,5,-7
-42.01241,-20.7038,48,44,5,-4
-42.01219,-20.7038,47,45,5,-2
-42.01196,-20.7038,46,45,5,-1
-42.01174,-20.7038,47,44,5,-3
-42.01129,-20.7038,48,42,5,-6
-42.01106,-20.7038,56,43,5,-13
-42.01084,-20.7038,59,42,5,-17
-42.01062,-20.7038,58,39,5,-19
-42.01017,-20.7038,58,41,5,-17
-42.00994,-20.7038,57,41,5,-16
-42.00972,-20.7038,56,41,5,-15
-42.00949,-20.7038,54,37,5,-17
-42.00927,-20.7038,54,40,5,-14
-42.00882,-20.7038,53,46,5,-7
-42.00859,-20.7038,53,46,5,-7
-42.00837,-20.7038,53,46,5,-7
-42.00814,-20.7038,53,46,5,-7
-42.00769,-20.7038,52,46,5,-6
-42.00747,-20.7038,52,43,5,-9
-42.00724,-20.7038,52,40,5,-12
-42.00702,-20.7038,51,38,5,-13
-42.00657,-20.7038,50,36,5,-14
-42.00635,-20.7038,49,37,5,-12
-42.00612,-20.7038,49,37,5,-12
-42.0059,-20.7038,49,37,5,-12
-42.00545,-20.7038,48,36,5,-12
-42.00522,-20.7038,48,36,5,-12
-42.005,-20.7038,48,36,5,-12
-42.00477,-20.7038,47,39,0,-8
-42.00455,-20.7038,47,39,0,-8
-42.0041,-20.7038,47,37,5,-10
-42.00387,-20.7038,48,34,5,-14
-42.00365,-20.7038,48,36,5,-12
-42.00342,-20.7038,55,36,5,-19
-42.00298,-20.7038,48,45,5,-3
-42.00275,-20.7038,51,46,5,-5
-42.00253,-20.7038,48,46,5,-2
-42.0023,-20.7038,48,46,5,-2
-42.00185,-20.7038,48,41,5,-7
-42.00163,-20.7038,48,39,5,-9
-42.0014,-20.7038,49,39,5,-10
-42.00118,-20.7038,49,37,5,-12
-42.00073,-20.7038,49,38,5,-11
-42.0005,-20.7038,49,38,5,-11
-42.00028,-20.7038,49,37,5,-12
-42.00005,-20.7038,49,36,5,-13
-41.99983,-20.7038,49,35,5,-14
-41.99938,-20.7038,50,35,5,-15
-41.99916,-20.7038,50,35,5,-15
-41.99893,-20.7038,50,38,5,-12
-41.99871,-20.7038,50,38,0,-12
-41.99826,-20.7038,50,39,0,-11
-41.99803,-20.7038,50,39,0,-11
-41.99781,-20.7038,50,38,0,-12
-41.99758,-20.7038,56,39,0,-17
-41.99713,-20.7038,50,39,5,-11
-41.99691,-20.7038,52,39,5,-13
-41.99668,-20.7038,61,36,5,-25
-41.99646,-20.7038,52,37,5,-15
-41.99601,-20.7038,52,36,5,-16
-41.99578,-20.7038,52,36,5,-16
-41.99556,-20.7038,52,36,5,-16
-41.99533,-20.7038,52,36,5,-16
-41.99511,-20.7038,51,33,5,-18
-41.99466,-20.7038,51,33,5,-18
-41.99444,-20.7038,51,36,5,-15
-41.99421,-20.7038,51,38,0,-13
-41.99399,-20.7038,55,38,0,-17
-41.99354,-20.7038,59,38,0,-21
-41.99331,-20.7038,60,37,0,-23
-41.99309,-20.7038,59,37,0,-22
-41.99286,-20.7038,63,37,0,-26
-41.99241,-20.7038,62,36,0,-26
-41.99219,-20.7038,61,36,0,-25
-41.99196,-20.7038,59,36,0,-23
-41.99174,-20.7038,58,36,0,-22
-41.99129,-20.7038,57,37,0,-20
-41.99107,-20.7038,58,37,0,-21
-41.99084,-20.7038,58,37,0,-21
-41.99062,-20.7038,63,37,0,-26
-41.99017,-20.7038,64,37,0,-27
-41.98994,-20.7038,62,36,0,-26
-41.98972,-20.7038,63,36,0,-27
-41.98949,-20.7038,62,34,0,-28
-41.98927,-20.7038,61,34,0,-27
-41.98882,-20.7038,61,33,0,-28
-41.98859,-20.7038,60,32,5,-28
-41.98837,-20.7038,59,31,5,-28
-41.98814,-20.7038,59,29,5,-30
-41.98769,-20.7038,58,30,5,-28
-41.98747,-20.7038,59,33,0,-26
-41.98725,-20.7038,58,33,0,-25
-41.98702,-20.7038,58,32,0,-26
-41.98657,-20.7038,57,33,0,-24
-41.98635,-20.7038,55,33,0,-22
-41.98612,-20.7038,55,32,0,-23
-41.9859,-20.7038,54,32,0,-22
-41.98545,-20.7038,52,32,0,-20
-41.98522,-20.7038,52,31,0,-21
-41.985,-20.7038,52,31,0,-21
-41.98477,-20.7038,65,30,0,-35
-41.98455,-20.7038,67,30,0,-37
-41.9841,-20.7038,67,29,0,-38
-41.98387,-20.7038,65,28,0,-37
-41.98365,-20.7038,66,27,0,-39
-41.98343,-20.7038,65,27,0,-38
-41.98298,-20.7038,63,29,0,-34
-41.98275,-20.7038,64,30,0,-34
-41.98253,-20.7038,64,30,0,-34
-41.9823,-20.7038,64,31,0,-33
-41.98185,-20.7038,64,32,11,-32
-41.98163,-20.7038,64,34,0,-30
-41.9814,-20.7038,65,34,0,-31
-41.98118,-20.7038,64,34,0,-30
-41.98073,-20.7038,64,35,0,-29
-41.9805,-20.7038,64,35,0,-29
-41.98028,-20.7038,65,37,0,-28
-41.98005,-20.7038,65,38,0,-27
-41.97983,-20.7038,65,39,0,-26
-41.97938,-20.7038,65,37,5,-28
-41.97916,-20.7038,65,32,5,-33
-41.97893,-20.7038,64,29,5,-35
-41.97871,-20.7038,64,29,5,-35
-41.97826,-20.7038,64,40,0,-24
-41.97803,-20.7038,63,41,0,-22
-41.97781,-20.7038,63,42,0,-21
-41.97758,-20.7038,63,42,0,-21
-41.97713,-20.7038,63,42,0,-21
-41.97691,-20.7038,62,42,0,-20
-41.97668,-20.7038,62,43,0,-19
-41.97646,-20.7038,61,42,0,-19
-41.97601,-20.7038,60,43,5,-17
-41.97578,-20.7038,60,43,5,-17
-41.97556,-20.7038,60,43,5,-17
-41.97534,-20.7038,59,43,5,-16
-41.97511,-20.7038,58,43,0,-15
-41.97466,-20.7038,56,43,5,-13
-41.97444,-20.7038,54,43,5,-11
-41.97421,-20.7038,54,43,5,-11
-41.97399,-20.7038,54,44,5,-10
-41.97354,-20.7038,53,45,5,-8
-41.97331,-20.7038,54,46,5,-8
-41.97309,-20.7038,53,47,5,-6
-41.97286,-20.7038,53,47,5,-6
-41.97241,-20.7038,54,46,5,-8
-41.97219,-20.7038,54,35,5,-19
-41.97196,-20.7038,53,33,5,-20
-41.97174,-20.7038,53,33,5,-20
-41.97129,-20.7038,53,34,5,-19
-41.97107,-20.7038,53,34,5,-19
-41.97084,-20.7038,52,33,5,-19
-41.97062,-20.7038,53,33,5,-20
-41.97017,-20.7038,53,33,5,-20
-41.96994,-20.7038,52,35,5,-17
-41.96972,-20.7038,51,44,5,-7
-41.96949,-20.7038,51,36,5,-15
-41.96927,-20.7038,51,35,5,-16
-42.1005,-20.70358,61,38,0,-23
-42.0978,-20.70358,68,38,0,-30
-42.09511,-20.70358,68,38,0,-30
-42.09219,-20.70358,67,31,5,-36
-42.08949,-20.70358,66,38,0,-28
-42.08657,-20.70358,63,35,11,-28
-42.08387,-20.70358,57,34,5,-23
-42.08118,-20.70358,57,42,5,-15
-42.07825,-20.70358,58,39,5,-19
-42.07556,-20.70358,59,40,5,-19
-42.07286,-20.70358,62,44,5,-18
-42.06994,-20.70358,60,45,11,-15
-42.06724,-20.70358,60,42,6,-18
-42.06455,-20.70358,60,43,0,-17
-42.06163,-20.70358,62,45,0,-17
-42.05893,-20.70358,68,42,5,-26
-42.05601,-20.70358,59,45,0,-14
-42.05331,-20.70358,61,48,0,-13
-42.05061,-20.70358,60,46,5,-14
-42.04769,-20.70358,54,40,5,-14
-42.045,-20.70358,59,39,5,-20
-42.0423,-20.70358,43,43,0,0
-42.03938,-20.70358,42,41,2,-1
-42.03668,-20.70358,34,40,5,6
-42.03399,-20.70358,23,38,5,15
-42.03106,-20.70358,45,44,0,-1
-42.02837,-20.70358,49,48,0,-1
-42.02545,-20.70358,47,38,5,-9
-42.02275,-20.70358,48,48,5,0
-42.02005,-20.70358,45,44,0,-1
-42.01713,-20.70358,53,45,0,-8
-42.01444,-20.70358,47,41,5,-6
-42.01174,-20.70358,44,44,5,0
-42.00882,-20.70358,54,46,5,-8
-42.00612,-20.70358,48,37,5,-11
-42.00342,-20.70358,56,36,5,-20
-42.0005,-20.70358,49,37,5,-12
-41.99781,-20.70358,50,38,0,-12
-41.99511,-20.70358,51,36,5,-15
-41.99219,-20.70358,62,36,0,-26
-41.98949,-20.70358,61,34,0,-27
-41.98657,-20.70358,56,31,0,-25
-41.98387,-20.70358,66,26,0,-40
-41.98118,-20.70358,64,35,0,-29
-41.97826,-20.70358,64,39,0,-25
-41.97556,-20.70358,59,43,0,-16
-41.97286,-20.70358,53,47,5,-6
-41.96994,-20.70358,50,44,0,-6
-42.1005,-20.70337,62,38,0,-24
-42.0978,-20.70337,67,38,0,-29
-42.09511,-20.70337,68,37,0,-31
-42.09219,-20.70337,67,33,5,-34
-42.08949,-20.70337,66,38,0,-28
-42.08657,-20.70337,62,36,5,-26
-42.08387,-20.70337,57,38,5,-19
-42.08118,-20.70337,57,42,5,-15
-42.07825,-20.70337,58,38,5,-20
-42.07556,-20.70337,59,39,5,-20
-42.07286,-20.70337,61,45,5,-16
-42.06994,-20.70337,60,45,0,-15
-42.06724,-20.70337,60,43,5,-17
-42.06455,-20.70337,60,42,5,-18
-42.06163,-20.70337,61,45,6,-16
-42.05893,-20.70337,65,42,5,-23
-42.05601,-20.70337,66,46,0,-20
-42.05331,-20.70337,61,48,0,-13
-42.05061,-20.70337,59,44,5,-15
-42.04769,-20.70337,54,39,5,-15
-42.045,-20.70337,59,45,5,-14
-42.0423,-20.70337,41,41,0,0
-42.03938,-20.70337,41,40,2,-1
-42.03668,-20.70337,34,39,5,5
-42.03399,-20.70337,21,38,5,17
-42.03106,-20.70337,44,43,0,-1
-42.02837,-20.70337,48,48,0,0
-42.02545,-20.70337,47,38,5,-9
-42.02275,-20.70337,48,48,5,0
-42.02005,-20.70337,46,44,0,-2
-42.01713,-20.70337,54,45,0,-9
-42.01444,-20.70337,50,41,5,-9
-42.01174,-20.70337,44,43,5,-1
-42.00882,-20.70337,55,46,5,-9
-42.00612,-20.70337,48,36,5,-12
-42.00342,-20.70337,56,36,5,-20
-42.0005,-20.70337,49,36,5,-13
-41.99781,-20.70337,50,38,0,-12
-41.99511,-20.70337,51,37,5,-14
-41.99219,-20.70337,63,36,0,-27
-41.98949,-20.70337,61,34,0,-27
-41.98657,-20.70337,56,31,0,-25
-41.98387,-20.70337,68,25,0,-43
-41.98118,-20.70337,64,36,0,-28
-41.97826,-20.70337,63,39,0,-24
-41.97556,-20.70337,60,43,0,-17
-41.97286,-20.70337,53,47,5,-6
-41.96994,-20.70337,50,35,5,-15
-42.1005,-20.70316,65,38,0,-27
-42.0978,-20.70316,67,38,0,-29
-42.09511,-20.70316,68,37,0,-31
-42.09219,-20.70316,67,34,5,-33
-42.08949,-20.70316,67,38,0,-29
-42.08657,-20.70316,61,35,5,-26
-42.08387,-20.70316,56,38,5,-18
-42.08118,-20.70316,57,41,5,-16
-42.07825,-20.70316,58,38,5,-20
-42.07556,-20.70316,59,39,5,-20
-42.07286,-20.70316,60,45,5,-15
-42.06994,-20.70316,60,45,0,-15
-42.06724,-20.70316,60,44,0,-16
-42.06455,-20.70316,60,41,5,-19
-42.06163,-20.70316,61,45,0,-16
-42.05893,-20.70316,63,43,5,-20
-42.05601,-20.70316,67,46,0,-21
-42.05331,-20.70316,60,48,5,-12
-42.05061,-20.70316,59,44,5,-15
-42.04769,-20.70316,55,39,5,-16
-42.045,-20.70316,59,45,0,-14
-42.0423,-20.70316,41,42,0,1
-42.03938,-20.70316,39,39,2,0
-42.03668,-20.70316,34,39,5,5
-42.03399,-20.70316,22,37,5,15
-42.03106,-20.70316,42,42,0,0
-42.02837,-20.70316,47,46,11,-1
-42.02545,-20.70316,46,38,5,-8
-42.02275,-20.70316,47,46,5,-1
-42.02005,-20.70316,50,43,0,-7
-42.01713,-20.70316,53,44,5,-9
-42.01444,-20.70316,51,41,5,-10
-42.01174,-20.70316,55,46,5,-9
-42.00882,-20.70316,53,46,5,-7
-42.00612,-20.70316,49,36,5,-13
-42.00342,-20.70316,55,35,5,-20
-42.0005,-20.70316,48,36,5,-12
-41.99781,-20.70316,55,38,0,-17
-41.99511,-20.70316,51,37,0,-14
-41.99219,-20.70316,63,36,0,-27
-41.98949,-20.70316,60,34,0,-26
-41.98657,-20.70316,55,28,0,-27
-41.98387,-20.70316,69,24,0,-45
-41.98118,-20.70316,63,37,0,-26
-41.97826,-20.70316,63,40,0,-23
-41.97556,-20.70316,60,43,0,-17
-41.97286,-20.70316,53,47,5,-6
-41.96994,-20.70316,65,36,5,-29
-42.1005,-20.70274,66,37,0,-29
-42.0978,-20.70274,67,38,0,-29
-42.09511,-20.70274,68,38,0,-30
-42.09219,-20.70274,68,33,5,-35
-42.08949,-20.70274,68,38,0,-30
-42.08657,-20.70274,61,32,5,-29
-42.08387,-20.70274,56,37,5,-19
-42.08118,-20.70274,60,41,5,-19
-42.07825,-20.70274,58,43,5,-15
-42.07556,-20.70274,59,38,5,-21
-42.07286,-20.70274,60,46,5,-14
-42.06994,-20.70274,60,46,0,-14
-42.06724,-20.70274,60,46,0,-14
-42.06455,-20.70274,60,41,5,-19
-42.06163,-20.70274,61,45,0,-16
-42.05893,-20.70274,64,44,5,-20
-42.05601,-20.70274,70,45,5,-25
-42.05331,-20.70274,59,46,5,-13
-42.05061,-20.70274,60,45,5,-15
-42.04769,-20.70274,55,43,5,-12
-42.045,-20.70274,60,47,0,-13
-42.0423,-20.70274,41,45,0,4
-42.03938,-20.70274,38,39,5,1
-42.03668,-20.70274,33,39,5,6
-42.03399,-20.70274,18,36,5,18
-42.03106,-20.70274,41,44,0,3
-42.02837,-20.70274,47,45,5,-2
-42.02545,-20.70274,45,39,5,-6
-42.02275,-20.70274,45,45,5,0
-42.02005,-20.70274,51,42,0,-9
-42.01713,-20.70274,52,42,5,-10
-42.01444,-20.70274,50,40,5,-10
-42.01174,-20.70274,56,42,5,-14
-42.00882,-20.70274,53,47,5,-6
-42.00612,-20.70274,49,37,0,-12
-42.00342,-20.70274,58,36,5,-22
-42.0005,-20.70274,48,35,5,-13
-41.99781,-20.70274,49,37,0,-12
-41.99511,-20.70274,51,36,0,-15
-41.99219,-20.70274,63,36,0,-27
-41.98949,-20.70274,58,33,0,-25
-41.98657,-20.70274,54,24,0,-30
-41.98387,-20.70274,68,28,0,-40
-41.98118,-20.70274,63,43,0,-20
-41.97826,-20.70274,62,41,0,-21
-41.97556,-20.70274,59,43,0,-16
-41.97286,-20.70274,53,47,0,-6
-41.96994,-20.70274,63,32,5,-31
-42.1005,-20.70253,65,37,0,-28
-42.0978,-20.70253,67,38,0,-29
-42.09511,-20.70253,68,38,0,-30
-42.09219,-20.70253,68,31,5,-37
-42.08949,-20.70253,69,38,0,-31
-42.08657,-20.70253,59,31,5,-28
-42.08387,-20.70253,57,37,5,-20
-42.08118,-20.70253,62,41,5,-21
-42.07825,-20.70253,58,43,0,-15
-42.07556,-20.70253,59,36,5,-23
-42.07286,-20.70253,59,46,5,-13
-42.06994,-20.70253,60,46,5,-14
-42.06724,-20.70253,60,46,11,-14
-42.06455,-20.70253,60,43,5,-17
-42.06163,-20.70253,61,45,0,-16
-42.05893,-20.70253,69,44,5,-25
-42.05601,-20.70253,70,43,5,-27
-42.05331,-20.70253,59,45,5,-14
-42.05061,-20.70253,60,46,5,-14
-42.04769,-20.70253,55,40,5,-15
-42.045,-20.70253,60,47,0,-13
-42.0423,-20.70253,41,39,2,-2
-42.03938,-20.70253,38,39,5,1
-42.03668,-20.70253,32,39,5,7
-42.03399,-20.70253,20,36,5,16
-42.03106,-20.70253,42,43,0,1
-42.02837,-20.70253,47,45,5,-2
-42.02545,-20.70253,45,38,5,-7
-42.02275,-20.70253,45,46,5,1
-42.02005,-20.70253,52,42,0,-10
-42.01713,-20.70253,51,42,5,-9
-42.01444,-20.70253,49,41,5,-8
-42.01174,-20.70253,54,41,5,-13
-42.00882,-20.70253,51,47,5,-4
-42.00612,-20.70253,49,38,0,-11
-42.00342,-20.70253,58,37,5,-21
-42.0005,-20.70253,47,35,5,-12
-41.99781,-20.70253,49,37,0,-12
-41.99511,-20.70253,51,36,0,-15
-41.99219,-20.70253,63,36,0,-27
-41.98949,-20.70253,57,34,0,-23
-41.98657,-20.70253,54,25,0,-29
-41.98387,-20.70253,67,25,0,-42
-41.98118,-20.70253,62,44,0,-18
-41.97826,-20.70253,62,41,0,-21
-41.97556,-20.70253,58,43,0,-15
-41.97286,-20.70253,53,47,0,-6
-41.96994,-20.70253,62,33,5,-29
-42.1005,-20.70232,65,37,0,-28
-42.0978,-20.70232,67,38,0,-29
-42.09511,-20.70232,68,37,0,-31
-42.09219,-20.70232,68,30,5,-38
-42.08949,-20.70232,69,38,0,-31
-42.08657,-20.70232,60,31,5,-29
-42.08387,-20.70232,57,37,5,-20
-42.08118,-20.70232,58,41,5,-17
-42.07825,-20.70232,58,43,5,-15
-42.07556,-20.70232,59,37,5,-22
-42.07286,-20.70232,60,46,5,-14
-42.06994,-20.70232,60,46,5,-14
-42.06724,-20.70232,61,46,5,-15
-42.06455,-20.70232,60,43,6,-17
-42.06163,-20.70232,61,45,0,-16
-42.05893,-20.70232,69,45,5,-24
-42.05601,-20.70232,69,44,5,-25
-42.05331,-20.70232,59,44,5,-15
-42.05061,-20.70232,60,49,5,-11
-42.04769,-20.70232,58,40,5,-18
-42.045,-20.70232,60,48,0,-12
-42.0423,-20.70232,40,40,2,0
-42.03938,-20.70232,38,39,5,1
-42.03668,-20.70232,30,39,5,9
-42.03399,-20.70232,22,36,5,14
-42.03106,-20.70232,46,45,0,-1
-42.02837,-20.70232,49,40,5,-9
-42.02545,-20.70232,43,38,5,-5
-42.02275,-20.70232,43,43,0,0
-42.02005,-20.70232,50,42,0,-8
-42.01713,-20.70232,50,39,5,-11
-42.01444,-20.70232,47,42,5,-5
-42.01174,-20.70232,54,41,5,-13
-42.00882,-20.70232,51,44,5,-7
-42.00612,-20.70232,49,39,0,-10
-42.00342,-20.70232,56,36,5,-20
-42.0005,-20.70232,47,36,5,-11
-41.99781,-20.70232,55,37,0,-18
-41.99511,-20.70232,56,36,0,-20
-41.99219,-20.70232,64,37,0,-27
-41.98949,-20.70232,57,34,0,-23
-41.98657,-20.70232,54,24,0,-30
-41.98387,-20.70232,68,27,0,-41
-41.98118,-20.70232,63,44,0,-19
-41.97826,-20.70232,61,38,0,-23
-41.97556,-20.70232,57,43,0,-14
-41.97286,-20.70232,53,47,0,-6
-41.96994,-20.70232,51,34,5,-17
-42.1005,-20.70189,65,37,0,-28
-42.0978,-20.70189,67,35,0,-32
-42.09511,-20.70189,68,38,0,-30
-42.09219,-20.70189,68,36,5,-32
-42.08949,-20.70189,69,37,5,-32
-42.08657,-20.70189,59,35,5,-24
-42.08387,-20.70189,57,36,5,-21
-42.08118,-20.70189,58,39,5,-19
-42.07825,-20.70189,58,37,5,-21
-42.07556,-20.70189,59,36,5,-23
-42.07286,-20.70189,59,45,5,-14
-42.06994,-20.70189,60,47,5,-13
-42.06724,-20.70189,61,46,5,-15
-42.06455,-20.70189,60,43,5,-17
-42.06163,-20.70189,61,45,0,-16
-42.05893,-20.70189,68,45,5,-23
-42.05601,-20.70189,67,44,5,-23
-42.05331,-20.70189,58,44,5,-14
-42.05061,-20.70189,60,49,5,-11
-42.04769,-20.70189,57,46,5,-11
-42.045,-20.70189,60,48,0,-12
-42.0423,-20.70189,40,41,2,1
-42.03938,-20.70189,38,40,5,2
-42.03668,-20.70189,27,39,5,12
-42.03399,-20.70189,23,40,0,17
-42.03106,-20.70189,48,45,0,-3
-42.02837,-20.70189,51,39,2,-12
-42.02545,-20.70189,42,42,0,0
-42.02275,-20.70189,43,44,0,1
-42.02005,-20.70189,52,43,0,-9
-42.01713,-20.70189,49,39,5,-10
-42.01444,-20.70189,45,45,5,0
-42.01174,-20.70189,52,42,5,-10
-42.00882,-20.70189,49,44,5,-5
-42.00612,-20.70189,49,38,0,-11
-42.00342,-20.70189,57,36,5,-21
-42.0005,-20.70189,47,34,5,-13
-41.99781,-20.70189,56,36,0,-20
-41.99511,-20.70189,57,35,0,-22
-41.99219,-20.70189,63,35,0,-28
-41.98949,-20.70189,57,34,0,-23
-41.98657,-20.70189,57,28,0,-29
-41.98387,-20.70189,69,31,0,-38
-41.98118,-20.70189,64,44,0,-20
-41.97826,-20.70189,60,37,0,-23
-41.97556,-20.70189,56,43,0,-13
-41.97286,-20.70189,53,46,5,-7
-41.96994,-20.70189,51,37,5,-14
-42.1005,-20.70168,65,36,5,-29
-42.0978,-20.70168,68,35,0,-33
-42.09511,-20.70168,68,38,0,-30
-42.09219,-20.70168,68,38,0,-30
-42.08949,-20.70168,68,32,5,-36
-42.08657,-20.70168,61,35,5,-26
-42.08387,-20.70168,57,36,5,-21
-42.08118,-20.70168,60,45,5,-15
-42.07825,-20.70168,58,37,5,-21
-42.07556,-20.70168,60,35,5,-25
-42.07286,-20.70168,59,45,5,-14
-42.06994,-20.70168,60,47,5,-13
-42.06724,-20.70168,61,45,5,-16
-42.06455,-20.70168,60,45,0,-15
-42.06163,-20.70168,61,45,5,-16
-42.05893,-20.70168,68,46,5,-22
-42.05601,-20.70168,69,47,5,-22
-42.05331,-20.70168,58,42,5,-16
-42.05061,-20.70168,56,44,5,-12
-42.04769,-20.70168,56,46,5,-10
-42.045,-20.70168,62,48,0,-14
-42.0423,-20.70168,39,40,2,1
-42.03938,-20.70168,38,40,5,2
-42.03668,-20.70168,24,39,5,15
-42.03399,-20.70168,18,40,0,22
-42.03106,-20.70168,49,45,0,-4
-42.02837,-20.70168,52,39,2,-13
-42.02545,-20.70168,40,43,0,3
-42.02275,-20.70168,42,44,0,2
-42.02005,-20.70168,52,43,0,-9
-42.01713,-20.70168,47,39,5,-8
-42.01444,-20.70168,43,42,5,-1
-42.01174,-20.70168,54,43,5,-11
-42.00882,-20.70168,48,38,5,-10
-42.00612,-20.70168,49,38,0,-11
-42.00342,-20.70168,57,36,5,-21
-42.0005,-20.70168,46,35,5,-11
-41.99781,-20.70168,57,37,0,-20
-41.99511,-20.70168,58,35,0,-23
-41.99219,-20.70168,63,35,0,-28
-41.98949,-20.70168,57,33,0,-24
-41.98657,-20.70168,63,28,0,-35
-41.98387,-20.70168,70,31,0,-39
-41.98118,-20.70168,63,44,0,-19
-41.97826,-20.70168,59,35,0,-24
-41.97556,-20.70168,55,43,0,-12
-41.97286,-20.70168,53,46,5,-7
-41.96994,-20.70168,51,42,0,-9
-42.1005,-20.70147,66,33,5,-33
-42.0978,-20.70147,68,35,0,-33
-42.09511,-20.70147,68,38,0,-30
-42.09219,-20.70147,68,38,0,-30
-42.08949,-20.70147,68,31,5,-37
-42.08657,-20.70147,59,35,5,-24
-42.08387,-20.70147,57,36,5,-21
-42.08118,-20.70147,61,41,5,-20
-42.07825,-20.70147,59,38,5,-21
-42.07556,-20.70147,60,36,5,-24
-42.07286,-20.70147,59,45,5,-14
-42.06994,-20.70147,60,47,5,-13
-42.06724,-20.70147,61,42,5,-19
-42.06455,-20.70147,60,43,5,-17
-42.06163,-20.70147,61,44,5,-17
-42.05893,-20.70147,69,46,5,-23
-42.05601,-20.70147,68,49,5,-19
-42.05331,-20.70147,57,41,5,-16
-42.05061,-20.70147,57,43,5,-14
-42.04769,-20.70147,61,47,5,-14
-42.045,-20.70147,62,49,2,-13
-42.0423,-20.70147,39,40,2,1
-42.03938,-20.70147,37,40,5,3
-42.03668,-20.70147,22,41,5,19
-42.03399,-20.70147,17,41,0,24
-42.03106,-20.70147,49,46,0,-3
-42.02837,-20.70147,52,39,2,-13
-42.02545,-20.70147,38,43,5,5
-42.02275,-20.70147,40,43,0,3
-42.02005,-20.70147,49,43,0,-6
-42.01713,-20.70147,46,40,5,-6
-42.01444,-20.70147,43,43,5,0
-42.01174,-20.70147,49,48,5,-1
-42.00882,-20.70147,48,37,5,-11
-42.00612,-20.70147,50,38,0,-12
-42.00342,-20.70147,53,35,5,-18
-42.0005,-20.70147,46,38,5,-8
-41.99781,-20.70147,58,38,0,-20
-41.99511,-20.70147,60,35,0,-25
-41.99219,-20.70147,63,35,0,-28
-41.98949,-20.70147,57,33,0,-24
-41.98657,-20.70147,65,28,0,-37
-41.98387,-20.70147,70,32,0,-38
-41.98118,-20.70147,63,44,0,-19
-41.97826,-20.70147,59,35,0,-24
-41.97556,-20.70147,52,43,0,-9
-41.97286,-20.70147,53,46,5,-7
-41.96994,-20.70147,51,45,0,-6
-42.10297,-20.70105,63,37,0,-26
-42.10275,-20.70105,63,32,5,-31
-42.10252,-20.70105,63,29,5,-34
-42.1023,-20.70105,63,28,5,-35
-42.10185,-20.70105,63,27,5,-36
-42.10163,-20.70105,64,27,5,-37
-42.1014,-20.70105,65,27,5,-38
-42.10118,-20.70105,65,27,5,-38
-42.10073,-20.70105,65,27,5,-38
-42.1005,-20.70105,66,27,5,-39
-42.10028,-20.70105,66,28,5,-38
-42.10005,-20.70105,66,31,5,-35
-42.09983,-20.70105,67,32,5,-35
-42.09938,-20.70105,66,32,0,-34
-42.09915,-20.70105,66,32,0,-34
-42.09893,-20.70105,66,32,0,-34
-42.0987,-20.70105,67,32,0,-35
-42.09825,-20.70105,67,33,0,-34
-42.09803,-20.70105,67,34,0,-33
-42.0978,-20.70105,68,34,0,-34
-42.09758,-20.70105,68,35,0,-33
-42.09713,-20.70105,68,35,0,-33
-42.09691,-20.70105,68,36,0,-32
-42.09668,-20.70105,68,36,0,-32
-42.09646,-20.70105,68,38,0,-30
-42.09601,-20.70105,68,38,0,-30
-42.09578,-20.70105,68,38,0,-30
-42.09556,-20.70105,68,38,0,-30
-42.09533,-20.70105,68,38,0,-30
-42.09511,-20.70105,68,38,0,-30
-42.09466,-20.70105,68,38,0,-30
-42.09443,-20.70105,68,38,0,-30
-42.09421,-20.70105,68,38,0,-30
-42.09398,-20.70105,68,38,0,-30
-42.09354,-20.70105,68,38,0,-30
-42.09331,-20.70105,68,38,0,-30
-42.09309,-20.70105,68,38,0,-30
-42.09286,-20.70105,67,38,5,-29
-42.09241,-20.70105,67,38,5,-29
-42.09219,-20.70105,67,38,5,-29
-42.09196,-20.70105,67,38,5,-29
-42.09174,-20.70105,67,34,5,-33
-42.09129,-20.70105,66,36,5,-30
-42.09106,-20.70105,66,32,5,-34
-42.09084,-20.70105,66,32,5,-34
-42.09061,-20.70105,66,32,5,-34
-42.09039,-20.70105,67,32,5,-35
-42.08994,-20.70105,67,32,5,-35
-42.08972,-20.70105,68,32,5,-36
-42.08949,-20.70105,68,32,5,-36
-42.08927,-20.70105,67,32,5,-35
-42.08882,-20.70105,67,34,5,-33
-42.08859,-20.70105,66,36,5,-30
-42.08837,-20.70105,62,38,5,-24
-42.08814,-20.70105,61,38,11,-23
-42.08769,-20.70105,57,34,5,-23
-42.08747,-20.70105,57,34,5,-23
-42.08724,-20.70105,57,34,5,-23
-42.08702,-20.70105,58,34,5,-24
-42.08657,-20.70105,59,34,5,-25
-42.08634,-20.70105,60,34,5,-26
-42.08612,-20.70105,60,34,5,-26
-42.08589,-20.70105,61,35,5,-26
-42.08545,-20.70105,61,35,5,-26
-42.08522,-20.70105,62,35,5,-27
-42.085,-20.70105,63,34,5,-29
-42.08477,-20.70105,63,35,5,-28
-42.08455,-20.70105,63,35,5,-28
-42.0841,-20.70105,59,37,5,-22
-42.08387,-20.70105,60,36,0,-24
-42.08365,-20.70105,58,36,5,-22
-42.08342,-20.70105,58,36,5,-22
-42.08297,-20.70105,58,36,5,-22
-42.08275,-20.70105,58,36,5,-22
-42.08252,-20.70105,58,36,5,-22
-42.0823,-20.70105,58,36,5,-22
-42.08185,-20.70105,58,39,5,-19
-42.08163,-20.70105,58,39,5,-19
-42.0814,-20.70105,58,41,5,-17
-42.08118,-20.70105,58,37,5,-21
-42.08073,-20.70105,58,44,5,-14
-42.0805,-20.70105,59,44,5,-15
-42.08028,-20.70105,59,44,5,-15
-42.08005,-20.70105,59,42,5,-17
-42.07983,-20.70105,59,40,5,-19
-42.07938,-20.70105,59,40,5,-19
-42.07915,-20.70105,59,40,5,-19
-42.07893,-20.70105,61,39,5,-22
-42.0787,-20.70105,60,39,5,-21
-42.07825,-20.70105,59,39,5,-20
-42.07803,-20.70105,59,39,5,-20
-42.07781,-20.70105,59,39,5,-20
-42.07758,-20.70105,59,39,5,-20
-42.07713,-20.70105,59,38,5,-21
-42.07691,-20.70105,59,38,5,-21
-42.07668,-20.70105,59,37,6,-22
-42.07646,-20.70105,60,37,5,-23
-42.07601,-20.70105,60,35,5,-25
-42.07578,-20.70105,60,33,5,-27
-42.07556,-20.70105,60,35,5,-25
-42.07533,-20.70105,60,35,5,-25
-42.07511,-20.70105,60,35,5,-25
-42.07466,-20.70105,60,36,5,-24
-42.07443,-20.70105,62,37,5,-25
-42.07421,-20.70105,61,37,5,-24
-42.07399,-20.70105,60,37,5,-23
-42.07354,-20.70105,60,43,5,-17
-42.07331,-20.70105,59,45,5,-14
-42.07309,-20.70105,59,45,5,-14
-42.07286,-20.70105,60,45,5,-15
-42.07241,-20.70105,60,43,5,-17
-42.07219,-20.70105,60,43,5,-17
-42.07196,-20.70105,60,41,5,-19
-42.07174,-20.70105,60,41,5,-19
-42.07129,-20.70105,60,42,5,-18
-42.07106,-20.70105,60,43,5,-17
-42.07084,-20.70105,60,44,5,-16
-42.07061,-20.70105,60,43,5,-17
-42.07039,-20.70105,60,46,5,-14
-42.06994,-20.70105,60,47,5,-13
-42.06972,-20.70105,60,47,5,-13
-42.06949,-20.70105,60,47,5,-13
-42.06927,-20.70105,60,47,5,-13
-42.06882,-20.70105,60,47,5,-13
-42.06859,-20.70105,61,47,5,-14
-42.06837,-20.70105,61,47,5,-14
-42.06814,-20.70105,61,45,5,-16
-42.06769,-20.70105,61,44,5,-17
-42.06747,-20.70105,61,43,5,-18
-42.06724,-20.70105,61,43,5,-18
-42.06702,-20.70105,61,43,5,-18
-42.06657,-20.70105,61,46,5,-15
-42.06634,-20.70105,61,46,5,-15
-42.06612,-20.70105,61,46,0,-15
-42.0659,-20.70105,62,46,0,-16
-42.06545,-20.70105,61,46,0,-15
-42.06522,-20.70105,61,45,0,-16
-42.065,-20.70105,60,45,5,-15
-42.06477,-20.70105,60,45,11,-15
-42.06455,-20.70105,60,44,5,-16
-42.0641,-20.70105,60,44,6,-16
-42.06387,-20.70105,60,45,5,-15
-42.06365,-20.70105,60,45,11,-15
-42.06342,-20.70105,60,45,5,-15
-42.06297,-20.70105,60,42,5,-18
-42.06275,-20.70105,60,43,5,-17
-42.06252,-20.70105,60,43,5,-17
-42.0623,-20.70105,60,43,5,-17
-42.06185,-20.70105,60,43,5,-17
-42.06163,-20.70105,61,42,5,-19
-42.0614,-20.70105,61,42,5,-19
-42.06118,-20.70105,61,42,5,-19
-42.06073,-20.70105,61,43,5,-18
-42.0605,-20.70105,61,44,5,-17
-42.06028,-20.70105,61,44,5,-17
-42.06005,-20.70105,61,44,5,-17
-42.05983,-20.70105,61,46,5,-15
-42.05938,-20.70105,68,44,5,-24
-42.05915,-20.70105,69,46,5,-23
-42.05893,-20.70105,69,44,5,-25
-42.0587,-20.70105,68,44,5,-24
-42.05826,-20.70105,68,46,5,-22
-42.05803,-20.70105,68,46,5,-22
-42.05781,-20.70105,68,47,5,-21
-42.05758,-20.70105,68,45,5,-23
-42.05713,-20.70105,68,47,5,-21
-42.05691,-20.70105,68,47,5,-21
-42.05668,-20.70105,67,47,5,-20
-42.05646,-20.70105,66,45,5,-21
-42.05601,-20.70105,67,49,5,-18
-42.05578,-20.70105,67,46,5,-21
-42.05556,-20.70105,68,43,5,-25
-42.05533,-20.70105,67,42,5,-25
-42.05511,-20.70105,62,40,5,-22
-42.05466,-20.70105,63,40,5,-23
-42.05443,-20.70105,65,40,5,-25
-42.05421,-20.70105,58,40,5,-18
-42.05399,-20.70105,57,39,5,-18
-42.05354,-20.70105,56,39,5,-17
-42.05331,-20.70105,56,40,5,-16
-42.05309,-20.70105,60,40,5,-20
-42.05286,-20.70105,55,40,5,-15
-42.05241,-20.70105,56,41,5,-15
-42.05219,-20.70105,60,41,5,-19
-42.05196,-20.70105,60,41,5,-19
-42.05174,-20.70105,60,42,5,-18
-42.05129,-20.70105,60,42,5,-18
-42.05106,-20.70105,56,41,5,-15
-42.05084,-20.70105,61,41,5,-20
-42.05061,-20.70105,58,41,5,-17
-42.05039,-20.70105,61,41,5,-20
-42.04994,-20.70105,55,41,5,-14
-42.04972,-20.70105,55,42,5,-13
-42.04949,-20.70105,54,43,5,-11
-42.04927,-20.70105,54,42,5,-12
-42.04882,-20.70105,54,43,5,-11
-42.04859,-20.70105,55,43,5,-12
-42.04837,-20.70105,60,47,5,-13
-42.04814,-20.70105,60,47,5,-13
-42.04769,-20.70105,62,48,5,-14
-42.04747,-20.70105,62,48,5,-14
-42.04724,-20.70105,62,48,5,-14
-42.04702,-20.70105,65,48,5,-17
-42.04657,-20.70105,63,48,5,-15
-42.04635,-20.70105,63,49,5,-14
-42.04612,-20.70105,64,49,5,-15
-42.0459,-20.70105,63,49,5,-14
-42.04545,-20.70105,61,50,5,-11
-42.04522,-20.70105,63,50,5,-13
-42.045,-20.70105,62,50,5,-12
-42.04477,-20.70105,64,49,5,-15
-42.04455,-20.70105,66,50,2,-16
-42.0441,-20.70105,66,50,5,-16
-42.04387,-20.70105,65,49,5,-16
-42.04365,-20.70105,54,49,5,-5
-42.04342,-20.70105,53,49,5,-4
-42.04297,-20.70105,51,49,5,-2
-42.04275,-20.70105,48,49,5,1
-42.04253,-20.70105,40,41,5,1
-42.0423,-20.70105,39,41,5,2
-42.04185,-20.70105,38,39,5,1
-42.04163,-20.70105,38,39,5,1
-42.0414,-20.70105,37,39,5,2
-42.04118,-20.70105,37,39,5,2
-42.04073,-20.70105,38,38,5,0
-42.0405,-20.70105,37,39,5,2
-42.04028,-20.70105,37,39,5,2
-42.04005,-20.70105,37,40,5,3
-42.03983,-20.70105,37,40,5,3
-42.03938,-20.70105,37,40,5,3
-42.03915,-20.70105,36,40,5,4
-42.03893,-20.70105,36,40,5,4
-42.0387,-20.70105,36,40,5,4
-42.03826,-20.70105,34,39,5,5
-42.03803,-20.70105,34,38,11,4
-42.03781,-20.70105,30,38,5,8
-42.03758,-20.70105,27,37,5,10
-42.03713,-20.70105,26,41,5,15
-42.03691,-20.70105,23,40,5,17
-42.03668,-20.70105,23,39,5,16
-42.03646,-20.70105,23,40,5,17
-42.03601,-20.70105,23,38,5,15
-42.03578,-20.70105,23,42,0,19
-42.03556,-20.70105,23,41,0,18
-42.03533,-20.70105,23,41,0,18
-42.03511,-20.70105,23,39,0,16
-42.03466,-20.70105,23,40,0,17
-42.03444,-20.70105,23,41,0,18
-42.03421,-20.70105,23,42,0,19
-42.03399,-20.70105,23,42,0,19
-42.03354,-20.70105,24,42,0,18
-42.03331,-20.70105,26,42,0,16
-42.03309,-20.70105,31,42,0,11
-42.03286,-20.70105,37,42,0,5
-42.03241,-20.70105,42,42,0,0
-42.03219,-20.70105,45,42,0,-3
-42.03196,-20.70105,46,42,0,-4
-42.03174,-20.70105,47,42,0,-5
-42.03129,-20.70105,48,45,0,-3
-42.03106,-20.70105,49,47,0,-2
-42.03084,-20.70105,50,48,11,-2
-42.03062,-20.70105,50,50,0,0
-42.03017,-20.70105,51,50,0,-1
-42.02994,-20.70105,52,51,0,-1
-42.02972,-20.70105,52,51,0,-1
-42.02949,-20.70105,51,51,0,0
-42.02927,-20.70105,52,51,0,-1
-42.02882,-20.70105,52,51,2,-1
-42.02859,-20.70105,52,41,2,-11
-42.02837,-20.70105,51,39,2,-12
-42.02814,-20.70105,50,39,2,-11
-42.02769,-20.70105,49,49,2,0
-42.02747,-20.70105,48,49,11,1
-42.02724,-20.70105,47,49,2,2
-42.02702,-20.70105,45,46,2,1
-42.02657,-20.70105,44,46,2,2
-42.02635,-20.70105,44,45,2,1
-42.02612,-20.70105,41,41,11,0
-42.0259,-20.70105,38,40,5,2
-42.02545,-20.70105,35,46,11,11
-42.02522,-20.70105,33,43,11,10
-42.025,-20.70105,32,43,5,11
-42.02477,-20.70105,32,39,5,7
-42.02455,-20.70105,31,39,5,8
-42.0241,-20.70105,35,38,5,3
-42.02387,-20.70105,35,36,5,1
-42.02365,-20.70105,36,36,5,0
-42.02342,-20.70105,38,38,0,0
-42.02297,-20.70105,40,40,0,0
-42.02275,-20.70105,40,42,0,2
-42.02253,-20.70105,41,43,0,2
-42.0223,-20.70105,50,44,0,-6
-42.02185,-20.70105,49,45,0,-4
-42.02163,-20.70105,50,45,0,-5
-42.0214,-20.70105,52,46,0,-6
-42.02118,-20.70105,52,46,0,-6
-42.02073,-20.70105,51,46,0,-5
-42.0205,-20.70105,50,46,0,-4
-42.02028,-20.70105,48,46,0,-2
-42.02005,-20.70105,47,46,0,-1
-42.01983,-20.70105,47,45,0,-2
-42.01938,-20.70105,46,42,5,-4
-42.01915,-20.70105,46,39,5,-7
-42.01893,-20.70105,46,43,5,-3
-42.01871,-20.70105,45,43,11,-2
-42.01826,-20.70105,45,44,5,-1
-42.01803,-20.70105,45,40,5,-5
-42.01781,-20.70105,45,41,5,-4
-42.01758,-20.70105,45,41,5,-4
-42.01713,-20.70105,46,45,5,-1
-42.01691,-20.70105,53,44,5,-9
-42.01668,-20.70105,50,44,5,-6
-42.01646,-20.70105,54,44,5,-10
-42.01601,-20.70105,58,46,5,-12
-42.01578,-20.70105,53,47,5,-6
-42.01556,-20.70105,51,48,5,-3
-42.01533,-20.70105,51,48,5,-3
-42.01511,-20.70105,49,49,5,0
-42.01466,-20.70105,47,48,5,1
-42.01444,-20.70105,50,49,5,-1
-42.01421,-20.70105,50,43,5,-7
-42.01399,-20.70105,41,41,5,0
-42.01354,-20.70105,53,48,5,-5
-42.01331,-20.70105,40,40,5,0
-42.01309,-20.70105,40,41,5,1
-42.01286,-20.70105,40,40,5,0
-42.01241,-20.70105,44,42,5,-2
-42.01219,-20.70105,47,48,5,1
-42.01196,-20.70105,41,42,5,1
-42.01174,-20.70105,41,45,5,4
-42.01129,-20.70105,41,44,5,3
-42.01106,-20.70105,41,47,5,6
-42.01084,-20.70105,52,48,5,-4
-42.01062,-20.70105,55,48,5,-7
-42.01017,-20.70105,56,45,5,-11
-42.00994,-20.70105,58,41,5,-17
-42.00972,-20.70105,57,38,5,-19
-42.00949,-20.70105,56,38,5,-18
-42.00927,-20.70105,57,38,5,-19
-42.00882,-20.70105,51,37,0,-14
-42.00859,-20.70105,52,37,0,-15
-42.00837,-20.70105,47,38,0,-9
-42.00814,-20.70105,47,37,0,-10
-42.00769,-20.70105,47,38,0,-9
-42.00747,-20.70105,46,38,0,-8
-42.00724,-20.70105,47,38,0,-9
-42.00702,-20.70105,55,38,0,-17
-42.00657,-20.70105,59,38,0,-21
-42.00635,-20.70105,53,38,0,-15
-42.00612,-20.70105,49,38,0,-11
-42.0059,-20.70105,48,38,0,-10
-42.00545,-20.70105,48,38,0,-10
-42.00522,-20.70105,46,37,0,-9
-42.005,-20.70105,46,37,0,-9
-42.00477,-20.70105,46,37,0,-9
-42.00455,-20.70105,46,37,0,-9
-42.0041,-20.70105,45,36,5,-9
-42.00387,-20.70105,45,33,5,-12
-42.00365,-20.70105,45,35,5,-10
-42.00342,-20.70105,45,35,5,-10
-42.00298,-20.70105,45,37,5,-8
-42.00275,-20.70105,56,39,5,-17
-42.00253,-20.70105,45,40,5,-5
-42.0023,-20.70105,45,40,5,-5
-42.00185,-20.70105,45,37,5,-8
-42.00163,-20.70105,47,38,5,-9
-42.0014,-20.70105,47,37,5,-10
-42.00118,-20.70105,46,36,5,-10
-42.00073,-20.70105,46,38,5,-8
-42.0005,-20.70105,52,39,0,-13
-42.00028,-20.70105,56,39,0,-17
-42.00005,-20.70105,55,39,5,-16
-41.99983,-20.70105,53,34,5,-19
-41.99938,-20.70105,53,33,5,-20
-41.99916,-20.70105,50,33,5,-17
-41.99893,-20.70105,48,36,5,-12
-41.99871,-20.70105,47,36,5,-11
-41.99826,-20.70105,52,38,0,-14
-41.99803,-20.70105,56,37,0,-19
-41.99781,-20.70105,58,37,0,-21
-41.99758,-20.70105,58,37,0,-21
-41.99713,-20.70105,59,37,0,-22
-41.99691,-20.70105,58,37,0,-21
-41.99668,-20.70105,60,36,0,-24
-41.99646,-20.70105,59,36,0,-23
-41.99601,-20.70105,62,35,0,-27
-41.99578,-20.70105,63,35,0,-28
-41.99556,-20.70105,63,34,0,-29
-41.99533,-20.70105,62,34,0,-28
-41.99511,-20.70105,61,34,0,-27
-41.99466,-20.70105,59,35,0,-24
-41.99444,-20.70105,57,36,0,-21
-41.99421,-20.70105,56,35,0,-21
-41.99399,-20.70105,55,35,0,-20
-41.99354,-20.70105,58,35,0,-23
-41.99331,-20.70105,56,35,0,-21
-41.99309,-20.70105,58,35,0,-23
-41.99286,-20.70105,61,35,0,-26
-41.99241,-20.70105,61,35,0,-26
-41.99219,-20.70105,60,35,0,-25
-41.99196,-20.70105,58,34,0,-24
-41.99174,-20.70105,57,35,0,-22
-41.99129,-20.70105,55,34,0,-21
-41.99107,-20.70105,54,34,0,-20
-41.99084,-20.70105,54,34,0,-20
-41.99062,-20.70105,53,34,0,-19
-41.99017,-20.70105,54,33,0,-21
-41.98994,-20.70105,53,33,0,-20
-41.98972,-20.70105,65,33,0,-32
-41.98949,-20.70105,59,32,0,-27
-41.98927,-20.70105,56,32,0,-24
-41.98882,-20.70105,55,32,0,-23
-41.98859,-20.70105,55,32,0,-23
-41.98837,-20.70105,54,32,0,-22
-41.98814,-20.70105,54,31,0,-23
-41.98769,-20.70105,53,31,0,-22
-41.98747,-20.70105,60,31,0,-29
-41.98725,-20.70105,63,30,0,-33
-41.98702,-20.70105,62,30,0,-32
-41.98657,-20.70105,62,29,0,-33
-41.98635,-20.70105,62,29,0,-33
-41.98612,-20.70105,60,29,0,-31
-41.9859,-20.70105,59,32,5,-27
-41.98545,-20.70105,57,28,5,-29
-41.98522,-20.70105,54,28,5,-26
-41.985,-20.70105,53,28,5,-25
-41.98477,-20.70105,52,29,0,-23
-41.98455,-20.70105,58,30,0,-28
-41.9841,-20.70105,63,30,0,-33
-41.98387,-20.70105,69,33,0,-36
-41.98365,-20.70105,68,33,0,-35
-41.98343,-20.70105,67,34,0,-33
-41.98298,-20.70105,66,36,0,-30
-41.98275,-20.70105,65,36,0,-29
-41.98253,-20.70105,64,39,0,-25
-41.9823,-20.70105,64,40,0,-24
-41.98185,-20.70105,63,43,0,-20
-41.98163,-20.70105,63,44,0,-19
-41.9814,-20.70105,63,44,0,-19
-41.98118,-20.70105,63,44,0,-19
-41.98073,-20.70105,63,45,0,-18
-41.9805,-20.70105,62,45,0,-17
-41.98028,-20.70105,62,45,0,-17
-41.98005,-20.70105,63,45,0,-18
-41.97983,-20.70105,62,45,0,-17
-41.97938,-20.70105,61,41,0,-20
-41.97916,-20.70105,61,34,0,-27
-41.97893,-20.70105,60,34,0,-26
-41.97871,-20.70105,59,34,0,-25
-41.97826,-20.70105,59,35,0,-24
-41.97803,-20.70105,58,36,0,-22
-41.97781,-20.70105,57,36,0,-21
-41.97758,-20.70105,56,36,0,-20
-41.97713,-20.70105,55,38,0,-17
-41.97691,-20.70105,55,40,0,-15
-41.97668,-20.70105,53,43,0,-10
-41.97646,-20.70105,53,43,0,-10
-41.97601,-20.70105,52,43,0,-9
-41.97578,-20.70105,52,44,0,-8
-41.97556,-20.70105,61,44,0,-17
-41.97534,-20.70105,57,44,0,-13
-41.97511,-20.70105,63,44,0,-19
-41.97466,-20.70105,65,45,0,-20
-41.97444,-20.70105,66,45,0,-21
-41.97421,-20.70105,64,45,0,-19
-41.97399,-20.70105,63,45,0,-18
-41.97354,-20.70105,63,45,5,-18
-41.97331,-20.70105,62,36,5,-26
-41.97309,-20.70105,59,35,5,-24
-41.97286,-20.70105,52,40,5,-12
-41.97241,-20.70105,52,46,0,-6
-41.97219,-20.70105,52,46,0,-6
-41.97196,-20.70105,52,46,0,-6
-41.97174,-20.70105,52,46,0,-6
-41.97129,-20.70105,52,46,0,-6
-41.97107,-20.70105,51,46,0,-5
-41.97084,-20.70105,51,46,0,-5
-41.97062,-20.70105,51,46,0,-5
-41.97017,-20.70105,51,46,0,-5
-41.96994,-20.70105,51,46,0,-5
-41.96972,-20.70105,60,46,0,-14
-41.96949,-20.70105,68,46,0,-22
-41.96927,-20.70105,67,40,0,-27
-42.1005,-20.70084,66,28,5,-38
-42.0978,-20.70084,68,35,0,-33
-42.09511,-20.70084,68,38,0,-30
-42.09219,-20.70084,67,35,5,-32
-42.08949,-20.70084,68,35,5,-33
-42.08657,-20.70084,58,34,5,-24
-42.08387,-20.70084,59,37,5,-22
-42.08118,-20.70084,59,37,5,-22
-42.07825,-20.70084,61,38,5,-23
-42.07556,-20.70084,60,34,5,-26
-42.07286,-20.70084,60,44,5,-16
-42.06994,-20.70084,61,47,5,-14
-42.06724,-20.70084,61,42,5,-19
-42.06455,-20.70084,60,45,5,-15
-42.06163,-20.70084,61,42,5,-19
-42.05893,-20.70084,68,43,5,-25
-42.05601,-20.70084,66,43,5,-23
-42.05331,-20.70084,56,40,5,-16
-42.05061,-20.70084,61,41,5,-20
-42.04769,-20.70084,62,48,5,-14
-42.045,-20.70084,63,45,5,-18
-42.0423,-20.70084,39,40,5,1
-42.03938,-20.70084,37,38,5,1
-42.03668,-20.70084,23,39,5,16
-42.03399,-20.70084,25,42,0,17
-42.03106,-20.70084,49,48,0,-1
-42.02837,-20.70084,50,39,2,-11
-42.02545,-20.70084,32,40,11,8
-42.02275,-20.70084,40,40,0,0
-42.02005,-20.70084,45,45,0,0
-42.01713,-20.70084,47,45,5,-2
-42.01444,-20.70084,52,43,5,-9
-42.01174,-20.70084,41,45,5,4
-42.00882,-20.70084,47,37,0,-10
-42.00612,-20.70084,49,38,0,-11
-42.00342,-20.70084,45,35,5,-10
-42.0005,-20.70084,57,40,0,-17
-41.99781,-20.70084,58,37,0,-21
-41.99511,-20.70084,61,34,0,-27
-41.99219,-20.70084,56,34,0,-22
-41.98949,-20.70084,59,32,0,-27
-41.98657,-20.70084,64,30,0,-34
-41.98387,-20.70084,66,32,0,-34
-41.98118,-20.70084,63,44,0,-19
-41.97826,-20.70084,59,35,0,-24
-41.97556,-20.70084,63,44,0,-19
-41.97286,-20.70084,57,46,5,-11
-41.96994,-20.70084,51,46,0,-5
-42.1005,-20.70062,66,28,5,-38
-42.0978,-20.70062,66,36,0,-30
-42.09511,-20.70062,67,38,0,-29
-42.09219,-20.70062,67,35,5,-32
-42.08949,-20.70062,67,36,5,-31
-42.08657,-20.70062,58,34,5,-24
-42.08387,-20.70062,61,35,5,-26
-42.08118,-20.70062,59,37,5,-22
-42.07825,-20.70062,63,38,5,-25
-42.07556,-20.70062,60,35,5,-25
-42.07286,-20.70062,60,44,5,-16
-42.06994,-20.70062,61,42,5,-19
-42.06724,-20.70062,61,42,5,-19
-42.06455,-20.70062,60,44,11,-16
-42.06163,-20.70062,60,44,5,-16
-42.05893,-20.70062,68,44,5,-24
-42.05601,-20.70062,67,42,5,-25
-42.05331,-20.70062,58,40,5,-18
-42.05061,-20.70062,57,40,5,-17
-42.04769,-20.70062,62,44,5,-18
-42.045,-20.70062,71,47,5,-24
-42.0423,-20.70062,44,41,5,-3
-42.03938,-20.70062,35,39,5,4
-42.03668,-20.70062,17,39,5,22
-42.03399,-20.70062,21,42,0,21
-42.03106,-20.70062,49,46,0,-3
-42.02837,-20.70062,50,39,2,-11
-42.02545,-20.70062,27,41,2,14
-42.02275,-20.70062,47,43,0,-4
-42.02005,-20.70062,45,45,0,0
-42.01713,-20.70062,45,45,5,0
-42.01444,-20.70062,48,42,5,-6
-42.01174,-20.70062,40,48,5,8
-42.00882,-20.70062,42,38,0,-4
-42.00612,-20.70062,49,38,0,-11
-42.00342,-20.70062,44,33,5,-11
-42.0005,-20.70062,61,42,0,-19
-41.99781,-20.70062,61,37,0,-24
-41.99511,-20.70062,61,34,0,-27
-41.99219,-20.70062,51,34,0,-17
-41.98949,-20.70062,55,32,0,-23
-41.98657,-20.70062,65,30,0,-35
-41.98387,-20.70062,65,33,0,-32
-41.98118,-20.70062,63,44,0,-19
-41.97826,-20.70062,60,35,0,-25
-41.97556,-20.70062,62,44,0,-18
-41.97286,-20.70062,56,38,5,-18
-41.96994,-20.70062,51,46,0,-5
-42.1005,-20.7002,66,27,5,-39
-42.0978,-20.7002,68,32,0,-36
-42.09511,-20.7002,66,37,0,-29
-42.09219,-20.7002,66,36,5,-30
-42.08949,-20.7002,66,39,5,-27
-42.08657,-20.7002,58,36,0,-22
-42.08387,-20.7002,60,34,5,-26
-42.08118,-20.7002,59,36,5,-23
-42.07825,-20.7002,62,39,5,-23
-42.07556,-20.7002,60,35,5,-25
-42.07286,-20.7002,62,43,5,-19
-42.06994,-20.7002,61,41,5,-20
-42.06724,-20.7002,61,46,5,-15
-42.06455,-20.7002,59,44,11,-15
-42.06163,-20.7002,60,44,5,-16
-42.05893,-20.7002,69,47,5,-22
-42.05601,-20.7002,68,40,5,-28
-42.05331,-20.7002,60,40,5,-20
-42.05061,-20.7002,55,41,5,-14
-42.04769,-20.7002,62,44,5,-18
-42.045,-20.7002,71,47,5,-24
-42.0423,-20.7002,50,40,5,-10
-42.03938,-20.7002,34,37,5,3
-42.03668,-20.7002,16,37,5,21
-42.03399,-20.7002,17,43,0,26
-42.03106,-20.7002,49,47,0,-2
-42.02837,-20.7002,49,38,2,-11
-42.02545,-20.7002,24,43,2,19
-42.02275,-20.7002,47,42,11,-5
-42.02005,-20.7002,44,44,0,0
-42.01713,-20.7002,45,45,5,0
-42.01444,-20.7002,48,43,5,-5
-42.01174,-20.7002,40,40,5,0
-42.00882,-20.7002,45,38,0,-7
-42.00612,-20.7002,49,39,0,-10
-42.00342,-20.7002,44,33,5,-11
-42.0005,-20.7002,61,42,0,-19
-41.99781,-20.7002,62,36,0,-26
-41.99511,-20.7002,61,33,5,-28
-41.99219,-20.7002,51,35,0,-16
-41.98949,-20.7002,51,32,0,-19
-41.98657,-20.7002,64,32,0,-32
-41.98387,-20.7002,64,34,0,-30
-41.98118,-20.7002,62,44,0,-18
-41.97826,-20.7002,60,35,0,-25
-41.97556,-20.7002,68,44,0,-24
-41.97286,-20.7002,55,30,5,-25
-41.96994,-20.7002,50,33,0,-17
-42.1005,-20.69999,65,27,5,-38
-42.0978,-20.69999,66,34,0,-32
-42.09511,-20.69999,66,37,0,-29
-42.09219,-20.69999,66,36,5,-30
-42.08949,-20.69999,65,39,5,-26
-42.08657,-20.69999,58,36,0,-22
-42.08387,-20.69999,58,34,5,-24
-42.08118,-20.69999,58,36,5,-22
-42.07825,-20.69999,62,38,5,-24
-42.07556,-20.69999,60,36,11,-24
-42.07286,-20.69999,60,43,5,-17
-42.06994,-20.69999,61,40,5,-21
-42.06724,-20.69999,61,46,5,-15
-42.06455,-20.69999,59,44,11,-15
-42.06163,-20.69999,60,44,5,-16
-42.05893,-20.69999,69,41,5,-28
-42.05601,-20.69999,65,39,5,-26
-42.05331,-20.69999,60,40,5,-20
-42.05061,-20.69999,54,41,5,-13
-42.04769,-20.69999,63,43,5,-20
-42.045,-20.69999,67,42,5,-25
-42.0423,-20.69999,49,40,5,-9
-42.03938,-20.69999,33,37,5,4
-42.03668,-20.69999,24,37,0,13
-42.03399,-20.69999,24,40,5,16
-42.03106,-20.69999,49,48,0,-1
-42.02837,-20.69999,49,40,2,-9
-42.02545,-20.69999,23,43,2,20
-42.02275,-20.69999,43,41,0,-2
-42.02005,-20.69999,44,42,5,-2
-42.01713,-20.69999,45,45,5,0
-42.01444,-20.69999,52,49,0,-3
-42.01174,-20.69999,40,40,5,0
-42.00882,-20.69999,56,38,0,-18
-42.00612,-20.69999,46,39,0,-7
-42.00342,-20.69999,57,33,5,-24
-42.0005,-20.69999,60,41,0,-19
-41.99781,-20.69999,61,36,0,-25
-41.99511,-20.69999,61,33,5,-28
-41.99219,-20.69999,51,34,0,-17
-41.98949,-20.69999,54,31,0,-23
-41.98657,-20.69999,63,32,0,-31
-41.98387,-20.69999,64,35,0,-29
-41.98118,-20.69999,62,44,0,-18
-41.97826,-20.69999,60,36,0,-24
-41.97556,-20.69999,68,43,0,-25
-41.97286,-20.69999,53,31,5,-22
-41.96994,-20.69999,51,33,0,-18
-42.1005,-20.69978,64,27,5,-37
-42.0978,-20.69978,65,34,0,-31
-42.09511,-20.69978,66,38,0,-28
-42.09219,-20.69978,66,32,5,-34
-42.08949,-20.69978,66,39,5,-27
-42.08657,-20.69978,58,36,0,-22
-42.08387,-20.69978,58,34,5,-24
-42.08118,-20.69978,59,35,5,-24
-42.07825,-20.69978,61,39,5,-22
-42.07556,-20.69978,60,36,11,-24
-42.07286,-20.69978,60,41,5,-19
-42.06994,-20.69978,61,41,5,-20
-42.06724,-20.69978,61,46,5,-15
-42.06455,-20.69978,59,44,11,-15
-42.06163,-20.69978,60,41,5,-19
-42.05893,-20.69978,69,41,5,-28
-42.05601,-20.69978,65,39,5,-26
-42.05331,-20.69978,60,40,5,-20
-42.05061,-20.69978,54,41,5,-13
-42.04769,-20.69978,64,39,5,-25
-42.045,-20.69978,65,38,5,-27
-42.0423,-20.69978,49,40,5,-9
-42.03938,-20.69978,32,37,5,5
-42.03668,-20.69978,25,38,0,13
-42.03399,-20.69978,30,37,5,7
-42.03106,-20.69978,49,49,0,0
-42.02837,-20.69978,48,41,2,-7
-42.02545,-20.69978,23,41,0,18
-42.02275,-20.69978,37,38,0,1
-42.02005,-20.69978,43,42,5,-1
-42.01713,-20.69978,47,47,5,0
-42.01444,-20.69978,49,49,0,0
-42.01174,-20.69978,40,40,5,0
-42.00882,-20.69978,56,38,0,-18
-42.00612,-20.69978,44,39,0,-5
-42.00342,-20.69978,57,33,5,-24
-42.0005,-20.69978,61,41,0,-20
-41.99781,-20.69978,60,36,0,-24
-41.99511,-20.69978,61,33,5,-28
-41.99219,-20.69978,52,35,0,-17
-41.98949,-20.69978,51,31,0,-20
-41.98657,-20.69978,62,33,0,-29
-41.98387,-20.69978,54,36,0,-18
-41.98118,-20.69978,62,43,0,-19
-41.97826,-20.69978,60,36,0,-24
-41.97556,-20.69978,63,44,0,-19
-41.97286,-20.69978,53,31,5,-22
-41.96994,-20.69978,51,32,0,-19
-42.1005,-20.69936,64,30,5,-34
-42.0978,-20.69936,64,35,0,-29
-42.09511,-20.69936,66,34,0,-32
-42.09219,-20.69936,66,34,5,-32
-42.08949,-20.69936,63,39,0,-24
-42.08657,-20.69936,58,37,0,-21
-42.08387,-20.69936,59,34,5,-25
-42.08118,-20.69936,59,35,5,-24
-42.07825,-20.69936,60,40,5,-20
-42.07556,-20.69936,60,37,5,-23
-42.07286,-20.69936,62,39,5,-23
-42.06994,-20.69936,61,41,5,-20
-42.06724,-20.69936,61,46,5,-15
-42.06455,-20.69936,59,44,11,-15
-42.06163,-20.69936,60,41,5,-19
-42.05893,-20.69936,69,40,5,-29
-42.05601,-20.69936,66,38,5,-28
-42.05331,-20.69936,62,39,5,-23
-42.05061,-20.69936,54,40,5,-14
-42.04769,-20.69936,63,37,5,-26
-42.045,-20.69936,65,38,5,-27
-42.0423,-20.69936,51,41,5,-10
-42.03938,-20.69936,31,39,5,8
-42.03668,-20.69936,36,38,5,2
-42.03399,-20.69936,33,37,5,4
-42.03106,-20.69936,48,49,0,1
-42.02837,-20.69936,48,50,0,2
-42.02545,-20.69936,20,37,2,17
-42.02275,-20.69936,36,38,0,2
-42.02005,-20.69936,43,38,5,-5
-42.01713,-20.69936,49,42,5,-7
-42.01444,-20.69936,48,46,0,-2
-42.01174,-20.69936,40,40,0,0
-42.00882,-20.69936,52,36,0,-16
-42.00612,-20.69936,43,38,0,-5
-42.00342,-20.69936,63,33,5,-30
-42.0005,-20.69936,64,39,0,-25
-41.99781,-20.69936,61,37,0,-24
-41.99511,-20.69936,61,34,5,-27
-41.99219,-20.69936,51,34,0,-17
-41.98949,-20.69936,56,32,0,-24
-41.98657,-20.69936,62,34,0,-28
-41.98387,-20.69936,52,37,0,-15
-41.98118,-20.69936,63,43,0,-20
-41.97826,-20.69936,60,37,0,-23
-41.97556,-20.69936,62,45,0,-17
-41.97286,-20.69936,53,31,5,-22
-41.96994,-20.69936,51,34,0,-17
-42.1005,-20.69914,64,32,0,-32
-42.0978,-20.69914,64,35,0,-29
-42.09511,-20.69914,66,34,0,-32
-42.09219,-20.69914,66,33,5,-33
-42.08949,-20.69914,63,40,11,-23
-42.08657,-20.69914,58,37,0,-21
-42.08387,-20.69914,59,34,5,-25
-42.08118,-20.69914,59,35,5,-24
-42.07825,-20.69914,60,39,5,-21
-42.07556,-20.69914,60,36,5,-24
-42.07286,-20.69914,61,39,5,-22
-42.06994,-20.69914,61,40,5,-21
-42.06724,-20.69914,60,46,0,-14
-42.06455,-20.69914,59,44,5,-15
-42.06163,-20.69914,60,39,5,-21
-42.05893,-20.69914,69,40,5,-29
-42.05601,-20.69914,65,38,5,-27
-42.05331,-20.69914,60,39,5,-21
-42.05061,-20.69914,54,40,5,-14
-42.04769,-20.69914,64,36,5,-28
-42.045,-20.69914,66,38,5,-28
-42.0423,-20.69914,52,40,5,-12
-42.03938,-20.69914,26,40,5,14
-42.03668,-20.69914,36,38,5,2
-42.03399,-20.69914,36,37,5,1
-42.03106,-20.69914,48,50,0,2
-42.02837,-20.69914,48,48,0,0
-42.02545,-20.69914,19,37,2,18
-42.02275,-20.69914,34,38,0,4
-42.02005,-20.69914,44,37,5,-7
-42.01713,-20.69914,49,42,5,-7
-42.01444,-20.69914,48,46,0,-2
-42.01174,-20.69914,40,40,0,0
-42.00882,-20.69914,51,37,0,-14
-42.00612,-20.69914,43,38,0,-5
-42.00342,-20.69914,62,37,5,-25
-42.0005,-20.69914,65,39,0,-26
-41.99781,-20.69914,62,37,0,-25
-41.99511,-20.69914,61,34,5,-27
-41.99219,-20.69914,53,34,0,-19
-41.98949,-20.69914,62,32,0,-30
-41.98657,-20.69914,61,34,0,-27
-41.98387,-20.69914,52,38,0,-14
-41.98118,-20.69914,64,43,5,-21
-41.97826,-20.69914,60,37,0,-23
-41.97556,-20.69914,58,44,0,-14
-41.97286,-20.69914,53,31,5,-22
-41.96994,-20.69914,51,34,0,-17
-42.1005,-20.69893,64,33,0,-31
-42.0978,-20.69893,64,36,0,-28
-42.09511,-20.69893,65,34,0,-31
-42.09219,-20.69893,65,33,5,-32
-42.08949,-20.69893,65,40,11,-25
-42.08657,-20.69893,58,37,0,-21
-42.08387,-20.69893,59,34,5,-25
-42.08118,-20.69893,59,34,5,-25
-42.07825,-20.69893,60,39,5,-21
-42.07556,-20.69893,60,37,5,-23
-42.07286,-20.69893,61,38,5,-23
-42.06994,-20.69893,61,40,5,-21
-42.06724,-20.69893,60,46,0,-14
-42.06455,-20.69893,58,42,5,-16
-42.06163,-20.69893,59,40,5,-19
-42.05893,-20.69893,68,40,5,-28
-42.05601,-20.69893,64,38,5,-26
-42.05331,-20.69893,60,39,5,-21
-42.05061,-20.69893,54,40,5,-14
-42.04769,-20.69893,64,37,5,-27
-42.045,-20.69893,66,37,5,-29
-42.0423,-20.69893,52,40,5,-12
-42.03938,-20.69893,25,40,11,15
-42.03668,-20.69893,34,38,5,4
-42.03399,-20.69893,36,37,0,1
-42.03106,-20.69893,47,50,0,3
-42.02837,-20.69893,47,48,0,1
-42.02545,-20.69893,26,37,2,11
-42.02275,-20.69893,31,39,0,8
-42.02005,-20.69893,49,37,5,-12
-42.01713,-20.69893,50,42,5,-8
-42.01444,-20.69893,47,46,0,-1
-42.01174,-20.69893,40,40,0,0
-42.00882,-20.69893,48,37,0,-11
-42.00612,-20.69893,42,38,0,-4
-42.00342,-20.69893,61,38,0,-23
-42.0005,-20.69893,64,39,0,-25
-41.99781,-20.69893,61,37,0,-24
-41.99511,-20.69893,61,34,5,-27
-41.99219,-20.69893,54,34,0,-20
-41.98949,-20.69893,60,31,0,-29
-41.98657,-20.69893,61,34,0,-27
-41.98387,-20.69893,52,38,0,-14
-41.98118,-20.69893,65,43,5,-22
-41.97826,-20.69893,60,38,0,-22
-41.97556,-20.69893,58,45,0,-13
-41.97286,-20.69893,53,31,5,-22
-41.96994,-20.69893,51,36,0,-15
-42.1005,-20.69851,63,34,0,-29
-42.0978,-20.69851,64,36,0,-28
-42.09511,-20.69851,65,33,0,-32
-42.09219,-20.69851,65,41,5,-24
-42.08949,-20.69851,66,40,11,-26
-42.08657,-20.69851,58,37,0,-21
-42.08387,-20.69851,58,37,6,-21
-42.08118,-20.69851,59,34,5,-25
-42.07825,-20.69851,60,38,5,-22
-42.07556,-20.69851,60,36,6,-24
-42.07286,-20.69851,61,38,5,-23
-42.06994,-20.69851,61,40,5,-21
-42.06724,-20.69851,60,46,0,-14
-42.06455,-20.69851,58,42,6,-16
-42.06163,-20.69851,59,38,5,-21
-42.05893,-20.69851,67,40,5,-27
-42.05601,-20.69851,64,38,5,-26
-42.05331,-20.69851,67,38,5,-29
-42.05061,-20.69851,54,38,5,-16
-42.04769,-20.69851,64,34,5,-30
-42.045,-20.69851,66,40,0,-26
-42.0423,-20.69851,52,37,5,-15
-42.03938,-20.69851,25,42,5,17
-42.03668,-20.69851,30,41,5,11
-42.03399,-20.69851,39,39,5,0
-42.03106,-20.69851,47,52,0,5
-42.02837,-20.69851,47,48,0,1
-42.02545,-20.69851,33,37,2,4
-42.02275,-20.69851,35,40,0,5
-42.02005,-20.69851,51,39,5,-12
-42.01713,-20.69851,51,40,5,-11
-42.01444,-20.69851,46,44,0,-2
-42.01174,-20.69851,40,38,0,-2
-42.00882,-20.69851,44,36,0,-8
-42.00612,-20.69851,47,38,0,-9
-42.00342,-20.69851,59,38,0,-21
-42.0005,-20.69851,65,37,0,-28
-41.99781,-20.69851,61,36,0,-25
-41.99511,-20.69851,61,35,0,-26
-41.99219,-20.69851,54,33,0,-21
-41.98949,-20.69851,61,30,0,-31
-41.98657,-20.69851,62,34,0,-28
-41.98387,-20.69851,52,38,0,-14
-41.98118,-20.69851,66,34,5,-32
-41.97826,-20.69851,60,42,0,-18
-41.97556,-20.69851,58,37,5,-21
-41.97286,-20.69851,53,30,5,-23
-41.96994,-20.69851,52,40,0,-12
-42.10297,-20.6983,63,37,0,-26
-42.10275,-20.6983,67,37,0,-30
-42.10252,-20.6983,67,37,0,-30
-42.1023,-20.6983,67,37,0,-30
-42.10185,-20.6983,67,37,0,-30
-42.10163,-20.6983,63,37,0,-26
-42.1014,-20.6983,63,37,0,-26
-42.10118,-20.6983,63,36,0,-27
-42.10073,-20.6983,63,35,0,-28
-42.1005,-20.6983,63,35,0,-28
-42.10028,-20.6983,63,34,0,-29
-42.10005,-20.6983,63,33,0,-30
-42.09983,-20.6983,63,33,0,-30
-42.09938,-20.6983,63,32,0,-31
-42.09915,-20.6983,63,31,0,-32
-42.09893,-20.6983,64,32,0,-32
-42.0987,-20.6983,64,33,0,-31
-42.09825,-20.6983,64,34,0,-30
-42.09803,-20.6983,64,35,0,-29
-42.0978,-20.6983,64,35,0,-29
-42.09758,-20.6983,64,35,0,-29
-42.09713,-20.6983,64,35,0,-29
-42.09691,-20.6983,64,35,0,-29
-42.09668,-20.6983,64,35,0,-29
-42.09646,-20.6983,64,34,0,-30
-42.09601,-20.6983,64,34,0,-30
-42.09578,-20.6983,65,34,0,-31
-42.09556,-20.6983,65,33,0,-32
-42.09533,-20.6983,65,33,0,-32
-42.09511,-20.6983,65,33,0,-32
-42.09466,-20.6983,65,37,0,-28
-42.09443,-20.6983,64,37,0,-27
-42.09421,-20.6983,64,36,0,-28
-42.09398,-20.6983,64,36,0,-28
-42.09354,-20.6983,66,33,5,-33
-42.09331,-20.6983,65,32,5,-33
-42.09309,-20.6983,65,33,5,-32
-42.09286,-20.6983,65,33,5,-32
-42.09241,-20.6983,65,41,0,-24
-42.09219,-20.6983,65,41,0,-24
-42.09196,-20.6983,65,41,0,-24
-42.09174,-20.6983,65,41,0,-24
-42.09129,-20.6983,66,41,0,-25
-42.09106,-20.6983,66,41,0,-25
-42.09084,-20.6983,67,41,0,-26
-42.09061,-20.6983,69,41,0,-28
-42.09039,-20.6983,67,41,0,-26
-42.08994,-20.6983,69,40,0,-29
-42.08972,-20.6983,64,40,0,-24
-42.08949,-20.6983,63,40,11,-23
-42.08927,-20.6983,63,40,0,-23
-42.08882,-20.6983,57,39,0,-18
-42.08859,-20.6983,57,39,0,-18
-42.08837,-20.6983,57,39,0,-18
-42.08814,-20.6983,57,38,0,-19
-42.08769,-20.6983,57,37,0,-20
-42.08747,-20.6983,57,38,0,-19
-42.08724,-20.6983,57,38,0,-19
-42.08702,-20.6983,57,38,0,-19
-42.08657,-20.6983,58,39,0,-19
-42.08634,-20.6983,58,39,0,-19
-42.08612,-20.6983,58,39,0,-19
-42.08589,-20.6983,58,39,0,-19
-42.08545,-20.6983,58,38,0,-20
-42.08522,-20.6983,58,37,0,-21
-42.085,-20.6983,58,37,6,-21
-42.08477,-20.6983,58,38,6,-20
-42.08455,-20.6983,58,36,6,-22
-42.0841,-20.6983,58,39,5,-19
-42.08387,-20.6983,58,37,6,-21
-42.08365,-20.6983,59,36,5,-23
-42.08342,-20.6983,59,39,6,-20
-42.08297,-20.6983,59,34,5,-25
-42.08275,-20.6983,59,34,5,-25
-42.08252,-20.6983,59,37,5,-22
-42.0823,-20.6983,59,34,6,-25
-42.08185,-20.6983,59,34,5,-25
-42.08163,-20.6983,59,33,5,-26
-42.0814,-20.6983,59,33,5,-26
-42.08118,-20.6983,59,34,5,-25
-42.08073,-20.6983,59,34,5,-25
-42.0805,-20.6983,59,34,5,-25
-42.08028,-20.6983,59,33,5,-26
-42.08005,-20.6983,60,34,5,-26
-42.07983,-20.6983,60,34,5,-26
-42.07938,-20.6983,60,35,5,-25
-42.07915,-20.6983,60,36,5,-24
-42.07893,-20.6983,60,36,5,-24
-42.0787,-20.6983,60,36,5,-24
-42.07825,-20.6983,60,40,5,-20
-42.07803,-20.6983,60,43,5,-17
-42.07781,-20.6983,60,41,5,-19
-42.07758,-20.6983,60,38,5,-22
-42.07713,-20.6983,60,39,5,-21
-42.07691,-20.6983,60,38,5,-22
-42.07668,-20.6983,60,38,5,-22
-42.07646,-20.6983,60,37,5,-23
-42.07601,-20.6983,60,37,5,-23
-42.07578,-20.6983,60,37,5,-23
-42.07556,-20.6983,60,37,6,-23
-42.07533,-20.6983,60,36,5,-24
-42.07511,-20.6983,60,36,11,-24
-42.07466,-20.6983,60,34,5,-26
-42.07443,-20.6983,60,35,5,-25
-42.07421,-20.6983,60,36,5,-24
-42.07399,-20.6983,61,36,5,-25
-42.07354,-20.6983,61,36,5,-25
-42.07331,-20.6983,61,37,5,-24
-42.07309,-20.6983,61,38,5,-23
-42.07286,-20.6983,61,38,5,-23
-42.07241,-20.6983,61,40,5,-21
-42.07219,-20.6983,61,41,5,-20
-42.07196,-20.6983,61,41,5,-20
-42.07174,-20.6983,61,41,5,-20
-42.07129,-20.6983,61,45,5,-16
-42.07106,-20.6983,61,45,5,-16
-42.07084,-20.6983,61,45,5,-16
-42.07061,-20.6983,61,43,5,-18
-42.07039,-20.6983,61,40,5,-21
-42.06994,-20.6983,61,39,5,-22
-42.06972,-20.6983,61,40,5,-21
-42.06949,-20.6983,61,41,5,-20
-42.06927,-20.6983,61,40,5,-21
-42.06882,-20.6983,61,45,5,-16
-42.06859,-20.6983,61,47,5,-14
-42.06837,-20.6983,61,47,0,-14
-42.06814,-20.6983,61,47,0,-14
-42.06769,-20.6983,60,46,0,-14
-42.06747,-20.6983,60,46,0,-14
-42.06724,-20.6983,60,46,0,-14
-42.06702,-20.6983,60,45,0,-15
-42.06657,-20.6983,62,45,0,-17
-42.06634,-20.6983,60,45,0,-15
-42.06612,-20.6983,60,44,0,-16
-42.0659,-20.6983,62,44,0,-18
-42.06545,-20.6983,59,44,5,-15
-42.06522,-20.6983,59,44,11,-15
-42.065,-20.6983,59,44,5,-15
-42.06477,-20.6983,58,42,5,-16
-42.06455,-20.6983,58,42,6,-16
-42.0641,-20.6983,58,38,5,-20
-42.06387,-20.6983,58,38,5,-20
-42.06365,-20.6983,58,39,5,-19
-42.06342,-20.6983,58,39,5,-19
-42.06297,-20.6983,59,39,5,-20
-42.06275,-20.6983,59,39,5,-20
-42.06252,-20.6983,59,39,5,-20
-42.0623,-20.6983,59,39,5,-20
-42.06185,-20.6983,59,40,5,-19
-42.06163,-20.6983,60,39,5,-21
-42.0614,-20.6983,60,39,5,-21
-42.06118,-20.6983,69,40,5,-29
-42.06073,-20.6983,69,38,5,-31
-42.0605,-20.6983,69,38,5,-31
-42.06028,-20.6983,70,38,5,-32
-42.06005,-20.6983,70,38,5,-32
-42.05983,-20.6983,69,38,5,-31
-42.05938,-20.6983,68,39,5,-29
-42.05915,-20.6983,67,39,5,-28
-42.05893,-20.6983,66,39,5,-27
-42.0587,-20.6983,66,39,5,-27
-42.05826,-20.6983,66,39,5,-27
-42.05803,-20.6983,66,39,5,-27
-42.05781,-20.6983,65,39,5,-26
-42.05758,-20.6983,65,40,5,-25
-42.05713,-20.6983,69,38,5,-31
-42.05691,-20.6983,67,38,5,-29
-42.05668,-20.6983,61,39,5,-22
-42.05646,-20.6983,65,40,5,-25
-42.05601,-20.6983,64,38,5,-26
-42.05578,-20.6983,64,38,5,-26
-42.05556,-20.6983,64,38,5,-26
-42.05533,-20.6983,65,39,5,-26
-42.05511,-20.6983,66,38,5,-28
-42.05466,-20.6983,66,38,5,-28
-42.05443,-20.6983,67,39,5,-28
-42.05421,-20.6983,67,39,5,-28
-42.05399,-20.6983,66,38,5,-28
-42.05354,-20.6983,66,39,5,-27
-42.05331,-20.6983,65,39,5,-26
-42.05309,-20.6983,64,39,5,-25
-42.05286,-20.6983,64,39,5,-25
-42.05241,-20.6983,63,39,5,-24
-42.05219,-20.6983,54,39,5,-15
-42.05196,-20.6983,54,40,5,-14
-42.05174,-20.6983,54,39,5,-15
-42.05129,-20.6983,54,40,5,-14
-42.05106,-20.6983,54,39,5,-15
-42.05084,-20.6983,54,39,5,-15
-42.05061,-20.6983,54,39,5,-15
-42.05039,-20.6983,54,36,5,-18
-42.04994,-20.6983,54,36,5,-18
-42.04972,-20.6983,54,36,5,-18
-42.04949,-20.6983,54,36,5,-18
-42.04927,-20.6983,57,35,5,-22
-42.04882,-20.6983,63,33,5,-30
-42.04859,-20.6983,64,33,5,-31
-42.04837,-20.6983,64,33,5,-31
-42.04814,-20.6983,64,33,5,-31
-42.04769,-20.6983,65,33,5,-32
-42.04747,-20.6983,66,33,5,-33
-42.04724,-20.6983,67,35,5,-32
-42.04702,-20.6983,67,36,5,-31
-42.04657,-20.6983,67,36,5,-31
-42.04635,-20.6983,66,38,5,-28
-42.04612,-20.6983,68,38,0,-30
-42.0459,-20.6983,70,39,0,-31
-42.04545,-20.6983,68,40,0,-28
-42.04522,-20.6983,66,40,0,-26
-42.045,-20.6983,66,41,0,-25
-42.04477,-20.6983,66,41,0,-25
-42.04455,-20.6983,67,41,0,-26
-42.0441,-20.6983,67,42,0,-25
-42.04387,-20.6983,68,43,0,-25
-42.04365,-20.6983,68,44,0,-24
-42.04342,-20.6983,68,43,0,-25
-42.04297,-20.6983,56,43,5,-13
-42.04275,-20.6983,53,37,5,-16
-42.04253,-20.6983,52,37,5,-15
-42.0423,-20.6983,52,39,5,-13
-42.04185,-20.6983,51,37,5,-14
-42.04163,-20.6983,50,38,5,-12
-42.0414,-20.6983,49,43,5,-6
-42.04118,-20.6983,45,43,6,-2
-42.04073,-20.6983,38,38,11,0
-42.0405,-20.6983,31,38,5,7
-42.04028,-20.6983,26,38,5,12
-42.04005,-20.6983,24,39,5,15
-42.03983,-20.6983,31,40,5,9
-42.03938,-20.6983,33,40,5,7
-42.03915,-20.6983,37,39,5,2
-42.03893,-20.6983,40,40,5,0
-42.0387,-20.6983,31,40,5,9
-42.03826,-20.6983,27,40,5,13
-42.03803,-20.6983,24,41,5,17
-42.03781,-20.6983,25,41,5,16
-42.03758,-20.6983,30,40,5,10
-42.03713,-20.6983,30,40,5,10
-42.03691,-20.6983,25,40,5,15
-42.03668,-20.6983,24,40,5,16
-42.03646,-20.6983,22,38,5,16
-42.03601,-20.6983,28,40,5,12
-42.03578,-20.6983,37,41,5,4
-42.03556,-20.6983,40,41,5,1
-42.03533,-20.6983,42,40,5,-2
-42.03511,-20.6983,43,40,5,-3
-42.03466,-20.6983,44,45,5,1
-42.03444,-20.6983,43,42,5,-1
-42.03421,-20.6983,43,43,5,0
-42.03399,-20.6983,43,45,5,2
-42.03354,-20.6983,43,44,5,1
-42.03331,-20.6983,43,44,5,1
-42.03309,-20.6983,45,45,5,0
-42.03286,-20.6983,46,47,5,1
-42.03241,-20.6983,45,45,5,0
-42.03219,-20.6983,45,45,5,0
-42.03196,-20.6983,45,42,0,-3
-42.03174,-20.6983,46,52,0,6
-42.03129,-20.6983,47,47,0,0
-42.03106,-20.6983,47,47,0,0
-42.03084,-20.6983,47,47,0,0
-42.03062,-20.6983,47,47,0,0
-42.03017,-20.6983,47,52,2,5
-42.02994,-20.6983,47,40,2,-7
-42.02972,-20.6983,48,39,2,-9
-42.02949,-20.6983,47,39,2,-8
-42.02927,-20.6983,47,51,2,4
-42.02882,-20.6983,47,51,0,4
-42.02859,-20.6983,46,49,0,3
-42.02837,-20.6983,46,44,2,-2
-42.02814,-20.6983,46,50,2,4
-42.02769,-20.6983,45,41,2,-4
-42.02747,-20.6983,44,42,2,-2
-42.02724,-20.6983,43,37,2,-6
-42.02702,-20.6983,42,41,2,-1
-42.02657,-20.6983,41,41,11,0
-42.02635,-20.6983,39,40,2,1
-42.02612,-20.6983,37,37,2,0
-42.0259,-20.6983,37,37,11,0
-42.02545,-20.6983,38,37,0,-1
-42.02522,-20.6983,45,43,0,-2
-42.025,-20.6983,48,43,0,-5
-42.02477,-20.6983,49,44,0,-5
-42.02455,-20.6983,50,43,0,-7
-42.0241,-20.6983,48,41,0,-7
-42.02387,-20.6983,44,39,0,-5
-42.02365,-20.6983,40,39,11,-1
-42.02342,-20.6983,35,39,11,4
-42.02297,-20.6983,34,38,0,4
-42.02275,-20.6983,34,38,0,4
-42.02253,-20.6983,30,40,0,10
-42.0223,-20.6983,33,42,0,9
-42.02185,-20.6983,35,45,0,10
-42.02163,-20.6983,41,46,0,5
-42.0214,-20.6983,42,43,0,1
-42.02118,-20.6983,44,44,0,0
-42.02073,-20.6983,49,43,5,-6
-42.0205,-20.6983,51,40,5,-11
-42.02028,-20.6983,50,38,5,-12
-42.02005,-20.6983,53,39,11,-14
-42.01983,-20.6983,52,39,5,-13
-42.01938,-20.6983,52,39,5,-13
-42.01915,-20.6983,52,40,5,-12
-42.01893,-20.6983,52,41,5,-11
-42.01871,-20.6983,50,46,5,-4
-42.01826,-20.6983,50,47,5,-3
-42.01803,-20.6983,48,48,5,0
-42.01781,-20.6983,53,48,0,-5
-42.01758,-20.6983,52,48,0,-4
-42.01713,-20.6983,51,42,5,-9
-42.01691,-20.6983,51,41,5,-10
-42.01668,-20.6983,49,41,5,-8
-42.01646,-20.6983,48,40,5,-8
-42.01601,-20.6983,47,40,5,-7
-42.01578,-20.6983,46,41,5,-5
-42.01556,-20.6983,45,41,0,-4
-42.01533,-20.6983,45,43,0,-2
-42.01511,-20.6983,45,43,0,-2
-42.01466,-20.6983,46,43,0,-3
-42.01444,-20.6983,46,43,0,-3
-42.01421,-20.6983,46,43,5,-3
-42.01399,-20.6983,45,38,5,-7
-42.01354,-20.6983,45,36,5,-9
-42.01331,-20.6983,45,36,5,-9
-42.01309,-20.6983,44,36,5,-8
-42.01286,-20.6983,43,36,5,-7
-42.01241,-20.6983,42,36,5,-6
-42.01219,-20.6983,41,35,5,-6
-42.01196,-20.6983,40,36,5,-4
-42.01174,-20.6983,40,36,5,-4
-42.01129,-20.6983,40,36,0,-4
-42.01106,-20.6983,39,36,0,-3
-42.01084,-20.6983,40,36,0,-4
-42.01062,-20.6983,40,36,0,-4
-42.01017,-20.6983,40,36,0,-4
-42.00994,-20.6983,40,36,0,-4
-42.00972,-20.6983,40,36,0,-4
-42.00949,-20.6983,40,36,0,-4
-42.00927,-20.6983,41,36,0,-5
-42.00882,-20.6983,41,36,0,-5
-42.00859,-20.6983,41,36,0,-5
-42.00837,-20.6983,41,36,0,-5
-42.00814,-20.6983,51,37,0,-14
-42.00769,-20.6983,41,37,0,-4
-42.00747,-20.6983,41,37,0,-4
-42.00724,-20.6983,51,37,0,-14
-42.00702,-20.6983,41,37,0,-4
-42.00657,-20.6983,44,37,0,-7
-42.00635,-20.6983,56,38,0,-18
-42.00612,-20.6983,42,38,0,-4
-42.0059,-20.6983,42,38,0,-4
-42.00545,-20.6983,42,38,0,-4
-42.00522,-20.6983,42,38,0,-4
-42.005,-20.6983,47,38,0,-9
-42.00477,-20.6983,43,38,0,-5
-42.00455,-20.6983,47,38,0,-9
-42.0041,-20.6983,57,38,0,-19
-42.00387,-20.6983,56,38,0,-18
-42.00365,-20.6983,54,38,0,-16
-42.00342,-20.6983,59,38,0,-21
-42.00298,-20.6983,57,38,0,-19
-42.00275,-20.6983,58,38,0,-20
-42.00253,-20.6983,59,38,0,-21
-42.0023,-20.6983,60,38,0,-22
-42.00185,-20.6983,61,38,0,-23
-42.00163,-20.6983,63,39,0,-24
-42.0014,-20.6983,62,39,0,-23
-42.00118,-20.6983,63,38,0,-25
-42.00073,-20.6983,64,38,0,-26
-42.0005,-20.6983,64,36,0,-28
-42.00028,-20.6983,64,36,0,-28
-42.00005,-20.6983,64,37,0,-27
-41.99983,-20.6983,64,37,0,-27
-41.99938,-20.6983,63,37,0,-26
-41.99916,-20.6983,63,37,0,-26
-41.99893,-20.6983,62,37,0,-25
-41.99871,-20.6983,62,37,0,-25
-41.99826,-20.6983,61,36,0,-25
-41.99803,-20.6983,61,36,0,-25
-41.99781,-20.6983,61,36,0,-25
-41.99758,-20.6983,61,36,0,-25
-41.99713,-20.6983,60,36,0,-24
-41.99691,-20.6983,59,36,0,-23
-41.99668,-20.6983,59,36,0,-23
-41.99646,-20.6983,59,36,0,-23
-41.99601,-20.6983,59,35,0,-24
-41.99578,-20.6983,62,35,0,-27
-41.99556,-20.6983,61,35,0,-26
-41.99533,-20.6983,61,35,0,-26
-41.99511,-20.6983,61,35,0,-26
-41.99466,-20.6983,60,35,0,-25
-41.99444,-20.6983,59,34,0,-25
-41.99421,-20.6983,58,34,0,-24
-41.99399,-20.6983,57,34,0,-23
-41.99354,-20.6983,57,33,0,-24
-41.99331,-20.6983,56,33,0,-23
-41.99309,-20.6983,56,33,0,-23
-41.99286,-20.6983,56,33,0,-23
-41.99241,-20.6983,57,33,0,-24
-41.99219,-20.6983,55,32,0,-23
-41.99196,-20.6983,55,32,0,-23
-41.99174,-20.6983,60,32,0,-28
-41.99129,-20.6983,62,31,0,-31
-41.99107,-20.6983,61,31,0,-30
-41.99084,-20.6983,62,30,0,-32
-41.99062,-20.6983,65,30,0,-35
-41.99017,-20.6983,64,30,0,-34
-41.98994,-20.6983,63,29,0,-34
-41.98972,-20.6983,62,29,0,-33
-41.98949,-20.6983,63,29,0,-34
-41.98927,-20.6983,62,29,0,-33
-41.98882,-20.6983,61,32,0,-29
-41.98859,-20.6983,63,33,0,-30
-41.98837,-20.6983,65,33,0,-32
-41.98814,-20.6983,64,34,0,-30
-41.98769,-20.6983,63,35,0,-28
-41.98747,-20.6983,64,35,0,-29
-41.98725,-20.6983,64,35,0,-29
-41.98702,-20.6983,62,35,0,-27
-41.98657,-20.6983,61,34,0,-27
-41.98635,-20.6983,60,34,0,-26
-41.98612,-20.6983,59,34,0,-25
-41.9859,-20.6983,58,34,0,-24
-41.98545,-20.6983,56,33,0,-23
-41.98522,-20.6983,54,33,0,-21
-41.985,-20.6983,52,34,0,-18
-41.98477,-20.6983,52,35,0,-17
-41.98455,-20.6983,52,35,0,-17
-41.9841,-20.6983,52,37,0,-15
-41.98387,-20.6983,52,38,0,-14
-41.98365,-20.6983,60,39,0,-21
-41.98343,-20.6983,64,39,0,-25
-41.98298,-20.6983,66,40,0,-26
-41.98275,-20.6983,67,41,0,-26
-41.98253,-20.6983,67,42,0,-25
-41.9823,-20.6983,68,42,0,-26
-41.98185,-20.6983,67,43,5,-24
-41.98163,-20.6983,67,43,5,-24
-41.9814,-20.6983,67,43,5,-24
-41.98118,-20.6983,68,33,5,-35
-41.98073,-20.6983,66,33,5,-33
-41.9805,-20.6983,65,33,5,-32
-41.98028,-20.6983,64,34,5,-30
-41.98005,-20.6983,63,34,5,-29
-41.97983,-20.6983,62,33,5,-29
-41.97938,-20.6983,62,32,5,-30
-41.97916,-20.6983,61,38,0,-23
-41.97893,-20.6983,61,38,0,-23
-41.97871,-20.6983,60,42,0,-18
-41.97826,-20.6983,60,42,0,-18
-41.97803,-20.6983,60,42,0,-18
-41.97781,-20.6983,60,43,0,-17
-41.97758,-20.6983,60,43,0,-17
-41.97713,-20.6983,59,41,0,-18
-41.97691,-20.6983,59,41,5,-18
-41.97668,-20.6983,59,33,5,-26
-41.97646,-20.6983,59,31,5,-28
-41.97601,-20.6983,59,34,5,-25
-41.97578,-20.6983,59,34,5,-25
-41.97556,-20.6983,58,35,5,-23
-41.97534,-20.6983,58,45,5,-13
-41.97511,-20.6983,58,45,0,-13
-41.97466,-20.6983,57,45,5,-12
-41.97444,-20.6983,57,45,5,-12
-41.97421,-20.6983,57,45,5,-12
-41.97399,-20.6983,56,45,5,-11
-41.97354,-20.6983,56,46,5,-10
-41.97331,-20.6983,56,39,5,-17
-41.97309,-20.6983,55,35,5,-20
-41.97286,-20.6983,53,31,5,-22
-41.97241,-20.6983,53,30,5,-23
-41.97219,-20.6983,53,30,5,-23
-41.97196,-20.6983,53,30,5,-23
-41.97174,-20.6983,53,32,5,-21
-41.97129,-20.6983,53,32,0,-21
-41.97107,-20.6983,52,33,0,-19
-41.97084,-20.6983,52,33,0,-19
-41.97062,-20.6983,52,34,0,-18
-41.97017,-20.6983,52,37,0,-15
-41.96994,-20.6983,51,41,0,-10
-41.96972,-20.6983,51,45,0,-6
-41.96949,-20.6983,51,45,0,-6
-41.96927,-20.6983,58,46,0,-12
-42.1005,-20.69809,63,35,0,-28
-42.0978,-20.69809,64,35,0,-29
-42.09511,-20.69809,64,37,0,-27
-42.09219,-20.69809,65,41,0,-24
-42.08949,-20.69809,62,40,11,-22
-42.08657,-20.69809,57,40,0,-17
-42.08387,-20.69809,58,39,5,-19
-42.08118,-20.69809,59,34,5,-25
-42.07825,-20.69809,60,44,0,-16
-42.07556,-20.69809,60,37,6,-23
-42.07286,-20.69809,61,38,5,-23
-42.06994,-20.69809,61,39,5,-22
-42.06724,-20.69809,61,45,0,-16
-42.06455,-20.69809,58,42,6,-16
-42.06163,-20.69809,60,40,5,-20
-42.05893,-20.69809,66,39,5,-27
-42.05601,-20.69809,64,39,5,-25
-42.05331,-20.69809,63,39,5,-24
-42.05061,-20.69809,54,36,5,-18
-42.04769,-20.69809,65,33,5,-32
-42.045,-20.69809,66,41,0,-25
-42.0423,-20.69809,51,39,5,-12
-42.03938,-20.69809,39,39,5,0
-42.03668,-20.69809,19,38,5,19
-42.03399,-20.69809,42,41,5,-1
-42.03106,-20.69809,46,47,0,1
-42.02837,-20.69809,45,41,2,-4
-42.02545,-20.69809,47,45,0,-2
-42.02275,-20.69809,32,39,0,7
-42.02005,-20.69809,54,39,11,-15
-42.01713,-20.69809,51,45,0,-6
-42.01444,-20.69809,45,43,0,-2
-42.01174,-20.69809,40,36,5,-4
-42.00882,-20.69809,41,36,0,-5
-42.00612,-20.69809,50,37,0,-13
-42.00342,-20.69809,58,38,0,-20
-42.0005,-20.69809,63,36,5,-27
-41.99781,-20.69809,60,36,0,-24
-41.99511,-20.69809,59,35,0,-24
-41.99219,-20.69809,60,31,0,-29
-41.98949,-20.69809,62,29,0,-33
-41.98657,-20.69809,61,35,0,-26
-41.98387,-20.69809,52,38,0,-14
-41.98118,-20.69809,67,34,5,-33
-41.97826,-20.69809,60,38,0,-22
-41.97556,-20.69809,58,37,5,-21
-41.97286,-20.69809,53,31,5,-22
-41.96994,-20.69809,51,42,0,-9
-42.1005,-20.69788,63,37,0,-26
-42.0978,-20.69788,64,35,0,-29
-42.09511,-20.69788,63,37,0,-26
-42.09219,-20.69788,65,41,0,-24
-42.08949,-20.69788,63,41,0,-22
-42.08657,-20.69788,57,40,0,-17
-42.08387,-20.69788,59,37,5,-22
-42.08118,-20.69788,60,34,5,-26
-42.07825,-20.69788,60,44,0,-16
-42.07556,-20.69788,60,37,6,-23
-42.07286,-20.69788,61,38,5,-23
-42.06994,-20.69788,61,39,5,-22
-42.06724,-20.69788,62,45,0,-17
-42.06455,-20.69788,58,42,5,-16
-42.06163,-20.69788,59,39,5,-20
-42.05893,-20.69788,65,39,5,-26
-42.05601,-20.69788,63,39,5,-24
-42.05331,-20.69788,63,39,5,-24
-42.05061,-20.69788,54,36,5,-18
-42.04769,-20.69788,66,31,5,-35
-42.045,-20.69788,66,41,5,-25
-42.0423,-20.69788,49,39,5,-10
-42.03938,-20.69788,41,41,5,0
-42.03668,-20.69788,25,39,5,14
-42.03399,-20.69788,43,42,5,-1
-42.03106,-20.69788,46,46,0,0
-42.02837,-20.69788,45,39,2,-6
-42.02545,-20.69788,48,46,0,-2
-42.02275,-20.69788,44,43,0,-1
-42.02005,-20.69788,53,39,5,-14
-42.01713,-20.69788,50,45,0,-5
-42.01444,-20.69788,44,43,0,-1
-42.01174,-20.69788,40,36,5,-4
-42.00882,-20.69788,40,36,0,-4
-42.00612,-20.69788,54,37,0,-17
-42.00342,-20.69788,58,38,5,-20
-42.0005,-20.69788,62,36,5,-26
-41.99781,-20.69788,60,36,0,-24
-41.99511,-20.69788,60,35,0,-25
-41.99219,-20.69788,59,32,0,-27
-41.98949,-20.69788,59,29,0,-30
-41.98657,-20.69788,60,35,0,-25
-41.98387,-20.69788,52,38,0,-14
-41.98118,-20.69788,67,34,5,-33
-41.97826,-20.69788,60,38,0,-22
-41.97556,-20.69788,57,45,5,-12
-41.97286,-20.69788,53,32,5,-21
-41.96994,-20.69788,52,43,0,-9
-42.1005,-20.69745,62,37,0,-25
-42.0978,-20.69745,64,35,0,-29
-42.09511,-20.69745,64,37,0,-27
-42.09219,-20.69745,66,42,0,-24
-42.08949,-20.69745,57,42,0,-15
-42.08657,-20.69745,57,41,0,-16
-42.08387,-20.69745,59,37,5,-22
-42.08118,-20.69745,61,33,5,-28
-42.07825,-20.69745,60,43,0,-17
-42.07556,-20.69745,60,36,6,-24
-42.07286,-20.69745,61,38,5,-23
-42.06994,-20.69745,61,40,5,-21
-42.06724,-20.69745,63,45,0,-18
-42.06455,-20.69745,60,38,5,-22
-42.06163,-20.69745,59,38,5,-21
-42.05893,-20.69745,65,37,5,-28
-42.05601,-20.69745,59,39,5,-20
-42.05331,-20.69745,63,38,5,-25
-42.05061,-20.69745,54,36,5,-18
-42.04769,-20.69745,66,34,5,-32
-42.045,-20.69745,66,34,5,-32
-42.0423,-20.69745,49,38,5,-11
-42.03938,-20.69745,42,42,0,0
-42.03668,-20.69745,14,39,5,25
-42.03399,-20.69745,45,42,5,-3
-42.03106,-20.69745,46,51,5,5
-42.02837,-20.69745,44,44,11,0
-42.02545,-20.69745,52,47,0,-5
-42.02275,-20.69745,49,41,11,-8
-42.02005,-20.69745,53,40,5,-13
-42.01713,-20.69745,48,45,0,-3
-42.01444,-20.69745,44,43,0,-1
-42.01174,-20.69745,39,37,5,-2
-42.00882,-20.69745,40,37,0,-3
-42.00612,-20.69745,56,38,0,-18
-42.00342,-20.69745,57,34,5,-23
-42.0005,-20.69745,60,32,5,-28
-41.99781,-20.69745,60,37,0,-23
-41.99511,-20.69745,62,35,0,-27
-41.99219,-20.69745,57,33,0,-24
-41.98949,-20.69745,58,31,0,-27
-41.98657,-20.69745,59,34,0,-25
-41.98387,-20.69745,52,38,0,-14
-41.98118,-20.69745,67,43,5,-24
-41.97826,-20.69745,61,39,0,-22
-41.97556,-20.69745,56,45,0,-11
-41.97286,-20.69745,53,34,5,-19
-41.96994,-20.69745,52,40,5,-12
-42.1005,-20.69724,62,37,0,-25
-42.0978,-20.69724,64,34,0,-30
-42.09511,-20.69724,66,37,0,-29
-42.09219,-20.69724,66,42,0,-24
-42.08949,-20.69724,56,42,0,-14
-42.08657,-20.69724,57,41,0,-16
-42.08387,-20.69724,59,36,5,-23
-42.08118,-20.69724,60,33,5,-27
-42.07825,-20.69724,60,43,0,-17
-42.07556,-20.69724,60,36,6,-24
-42.07286,-20.69724,61,38,5,-23
-42.06994,-20.69724,61,45,5,-16
-42.06724,-20.69724,65,45,0,-20
-42.06455,-20.69724,62,40,5,-22
-42.06163,-20.69724,59,38,5,-21
-42.05893,-20.69724,67,36,5,-31
-42.05601,-20.69724,59,40,5,-19
-42.05331,-20.69724,58,38,5,-20
-42.05061,-20.69724,54,36,5,-18
-42.04769,-20.69724,66,34,5,-32
-42.045,-20.69724,65,34,5,-31
-42.0423,-20.69724,50,38,5,-12
-42.03938,-20.69724,46,46,0,0
-42.03668,-20.69724,14,38,5,24
-42.03399,-20.69724,45,40,5,-5
-42.03106,-20.69724,46,37,5,-9
-42.02837,-20.69724,43,44,11,1
-42.02545,-20.69724,51,48,0,-3
-42.02275,-20.69724,51,42,0,-9
-42.02005,-20.69724,52,42,11,-10
-42.01713,-20.69724,47,43,0,-4
-42.01444,-20.69724,43,43,0,0
-42.01174,-20.69724,39,37,5,-2
-42.00882,-20.69724,40,38,0,-2
-42.00612,-20.69724,59,38,0,-21
-42.00342,-20.69724,56,34,5,-22
-42.0005,-20.69724,62,32,5,-30
-41.99781,-20.69724,57,37,5,-20
-41.99511,-20.69724,62,36,0,-26
-41.99219,-20.69724,57,34,0,-23
-41.98949,-20.69724,57,32,0,-25
-41.98657,-20.69724,58,34,0,-24
-41.98387,-20.69724,58,37,0,-21
-41.98118,-20.69724,67,36,5,-31
-41.97826,-20.69724,61,37,0,-24
-41.97556,-20.69724,55,44,0,-11
-41.97286,-20.69724,53,32,5,-21
-41.96994,-20.69724,52,37,5,-15
-42.1005,-20.69703,62,37,0,-25
-42.0978,-20.69703,64,34,5,-30
-42.09511,-20.69703,66,37,0,-29
-42.09219,-20.69703,66,42,0,-24
-42.08949,-20.69703,56,42,0,-14
-42.08657,-20.69703,57,41,0,-16
-42.08387,-20.69703,59,34,5,-25
-42.08118,-20.69703,61,33,5,-28
-42.07825,-20.69703,60,42,0,-18
-42.07556,-20.69703,60,36,6,-24
-42.07286,-20.69703,61,38,5,-23
-42.06994,-20.69703,61,46,0,-15
-42.06724,-20.69703,66,44,0,-22
-42.06455,-20.69703,60,40,6,-20
-42.06163,-20.69703,59,37,5,-22
-42.05893,-20.69703,66,36,5,-30
-42.05601,-20.69703,64,41,5,-23
-42.05331,-20.69703,55,38,5,-17
-42.05061,-20.69703,54,36,5,-18
-42.04769,-20.69703,66,34,5,-32
-42.045,-20.69703,65,34,5,-31
-42.0423,-20.69703,51,38,5,-13
-42.03938,-20.69703,44,46,0,2
-42.03668,-20.69703,26,39,5,13
-42.03399,-20.69703,45,40,5,-5
-42.03106,-20.69703,45,35,5,-10
-42.02837,-20.69703,42,41,2,-1
-42.02545,-20.69703,51,49,0,-2
-42.02275,-20.69703,51,42,11,-9
-42.02005,-20.69703,52,43,11,-9
-42.01713,-20.69703,45,42,0,-3
-42.01444,-20.69703,43,43,0,0
-42.01174,-20.69703,38,39,5,1
-42.00882,-20.69703,50,40,0,-10
-42.00612,-20.69703,60,38,0,-22
-42.00342,-20.69703,59,35,5,-24
-42.0005,-20.69703,61,32,5,-29
-41.99781,-20.69703,56,32,5,-24
-41.99511,-20.69703,59,36,0,-23
-41.99219,-20.69703,56,35,0,-21
-41.98949,-20.69703,56,31,0,-25
-41.98657,-20.69703,57,34,0,-23
-41.98387,-20.69703,61,38,0,-23
-41.98118,-20.69703,67,38,5,-29
-41.97826,-20.69703,60,37,0,-23
-41.97556,-20.69703,53,44,0,-9
-41.97286,-20.69703,53,33,5,-20
-41.96994,-20.69703,52,39,5,-13
-42.1005,-20.69661,63,37,0,-26
-42.0978,-20.69661,63,33,5,-30
-42.09511,-20.69661,65,35,0,-30
-42.09219,-20.69661,67,37,0,-30
-42.08949,-20.69661,56,42,11,-14
-42.08657,-20.69661,57,40,6,-17
-42.08387,-20.69661,59,37,5,-22
-42.08118,-20.69661,60,37,6,-23
-42.07825,-20.69661,60,41,0,-19
-42.07556,-20.69661,61,36,11,-25
-42.07286,-20.69661,61,37,5,-24
-42.06994,-20.69661,61,46,0,-15
-42.06724,-20.69661,64,44,0,-20
-42.06455,-20.69661,63,40,5,-23
-42.06163,-20.69661,59,35,5,-24
-42.05893,-20.69661,60,36,5,-24
-42.05601,-20.69661,66,42,5,-24
-42.05331,-20.69661,55,39,5,-16
-42.05061,-20.69661,54,34,5,-20
-42.04769,-20.69661,66,34,5,-32
-42.045,-20.69661,62,34,5,-28
-42.0423,-20.69661,51,39,6,-12
-42.03938,-20.69661,42,41,0,-1
-42.03668,-20.69661,26,37,5,11
-42.03399,-20.69661,43,41,0,-2
-42.03106,-20.69661,44,33,5,-11
-42.02837,-20.69661,41,37,2,-4
-42.02545,-20.69661,50,49,0,-1
-42.02275,-20.69661,52,43,11,-9
-42.02005,-20.69661,53,43,11,-10
-42.01713,-20.69661,44,43,5,-1
-42.01444,-20.69661,42,42,0,0
-42.01174,-20.69661,38,36,5,-2
-42.00882,-20.69661,58,41,0,-17
-42.00612,-20.69661,60,39,0,-21
-42.00342,-20.69661,61,35,5,-26
-42.0005,-20.69661,61,35,5,-26
-41.99781,-20.69661,53,33,5,-20
-41.99511,-20.69661,58,41,0,-17
-41.99219,-20.69661,61,36,0,-25
-41.98949,-20.69661,55,29,5,-26
-41.98657,-20.69661,56,33,0,-23
-41.98387,-20.69661,61,38,0,-23
-41.98118,-20.69661,66,43,0,-23
-41.97826,-20.69661,59,36,0,-23
-41.97556,-20.69661,53,45,0,-8
-41.97286,-20.69661,53,33,5,-20
-41.96994,-20.69661,52,37,5,-15
-42.1005,-20.6964,63,37,0,-26
-42.0978,-20.6964,67,33,5,-34
-42.09511,-20.6964,64,35,0,-29
-42.09219,-20.6964,67,38,0,-29
-42.08949,-20.6964,60,42,11,-18
-42.08657,-20.6964,57,37,5,-20
-42.08387,-20.6964,58,37,5,-21
-42.08118,-20.6964,60,37,5,-23
-42.07825,-20.6964,60,41,0,-19
-42.07556,-20.6964,61,37,11,-24
-42.07286,-20.6964,61,37,5,-24
-42.06994,-20.6964,61,46,0,-15
-42.06724,-20.6964,64,44,0,-20
-42.06455,-20.6964,64,39,5,-25
-42.06163,-20.6964,58,37,5,-21
-42.05893,-20.6964,61,38,5,-23
-42.05601,-20.6964,63,41,5,-22
-42.05331,-20.6964,55,39,5,-16
-42.05061,-20.6964,54,34,5,-20
-42.04769,-20.6964,62,34,5,-28
-42.045,-20.6964,54,34,5,-20
-42.0423,-20.6964,52,39,5,-13
-42.03938,-20.6964,40,41,0,1
-42.03668,-20.6964,16,37,5,21
-42.03399,-20.6964,41,41,0,0
-42.03106,-20.6964,42,34,5,-8
-42.02837,-20.6964,41,37,2,-4
-42.02545,-20.6964,49,49,0,0
-42.02275,-20.6964,51,43,0,-8
-42.02005,-20.6964,53,42,11,-11
-42.01713,-20.6964,44,43,5,-1
-42.01444,-20.6964,41,42,0,1
-42.01174,-20.6964,38,36,5,-2
-42.00882,-20.6964,61,42,0,-19
-42.00612,-20.6964,63,40,0,-23
-42.00342,-20.6964,65,38,5,-27
-42.0005,-20.6964,59,35,5,-24
-41.99781,-20.6964,52,33,5,-19
-41.99511,-20.6964,59,41,0,-18
-41.99219,-20.6964,63,36,0,-27
-41.98949,-20.6964,55,29,5,-26
-41.98657,-20.6964,55,33,0,-22
-41.98387,-20.6964,67,37,0,-30
-41.98118,-20.6964,65,43,5,-22
-41.97826,-20.6964,58,36,0,-22
-41.97556,-20.6964,53,44,0,-9
-41.97286,-20.6964,53,32,5,-21
-41.96994,-20.6964,52,38,5,-14
-42.1005,-20.69618,63,37,0,-26
-42.0978,-20.69618,67,35,5,-32
-42.09511,-20.69618,63,35,0,-28
-42.09219,-20.69618,68,38,0,-30
-42.08949,-20.69618,58,42,0,-16
-42.08657,-20.69618,57,35,5,-22
-42.08387,-20.69618,59,35,5,-24
-42.08118,-20.69618,60,36,5,-24
-42.07825,-20.69618,60,40,5,-20
-42.07556,-20.69618,61,36,5,-25
-42.07286,-20.69618,61,37,5,-24
-42.06994,-20.69618,61,46,0,-15
-42.06724,-20.69618,64,44,0,-20
-42.06455,-20.69618,63,40,5,-23
-42.06163,-20.69618,58,36,5,-22
-42.05893,-20.69618,60,38,5,-22
-42.05601,-20.69618,63,40,5,-23
-42.05331,-20.69618,55,39,5,-16
-42.05061,-20.69618,54,32,5,-22
-42.04769,-20.69618,62,35,5,-27
-42.045,-20.69618,52,35,5,-17
-42.0423,-20.69618,51,40,5,-11
-42.03938,-20.69618,36,41,0,5
-42.03668,-20.69618,13,36,5,23
-42.03399,-20.69618,40,40,0,0
-42.03106,-20.69618,40,35,5,-5
-42.02837,-20.69618,41,37,2,-4
-42.02545,-20.69618,47,49,0,2
-42.02275,-20.69618,51,43,0,-8
-42.02005,-20.69618,52,44,5,-8
-42.01713,-20.69618,44,42,5,-2
-42.01444,-20.69618,41,42,0,1
-42.01174,-20.69618,37,37,5,0
-42.00882,-20.69618,59,43,0,-16
-42.00612,-20.69618,63,40,0,-23
-42.00342,-20.69618,66,38,5,-28
-42.0005,-20.69618,58,40,5,-18
-41.99781,-20.69618,50,35,5,-15
-41.99511,-20.69618,60,41,0,-19
-41.99219,-20.69618,65,36,0,-29
-41.98949,-20.69618,55,29,5,-26
-41.98657,-20.69618,55,33,0,-22
-41.98387,-20.69618,67,38,0,-29
-41.98118,-20.69618,63,43,5,-20
-41.97826,-20.69618,56,37,0,-19
-41.97556,-20.69618,53,44,0,-9
-41.97286,-20.69618,53,31,5,-22
-41.96994,-20.69618,52,39,5,-13
-42.1005,-20.69576,62,37,0,-25
-42.0978,-20.69576,67,35,5,-32
-42.09511,-20.69576,64,35,5,-29
-42.09219,-20.69576,68,38,0,-30
-42.08949,-20.69576,61,42,0,-19
-42.08657,-20.69576,57,35,5,-22
-42.08387,-20.69576,59,44,0,-15
-42.08118,-20.69576,60,33,5,-27
-42.07825,-20.69576,60,35,5,-25
-42.07556,-20.69576,61,37,5,-24
-42.07286,-20.69576,61,38,5,-23
-42.06994,-20.69576,61,46,0,-15
-42.06724,-20.69576,64,44,0,-20
-42.06455,-20.69576,61,39,5,-22
-42.06163,-20.69576,57,35,5,-22
-42.05893,-20.69576,68,36,5,-32
-42.05601,-20.69576,63,40,5,-23
-42.05331,-20.69576,55,36,5,-19
-42.05061,-20.69576,54,33,5,-21
-42.04769,-20.69576,60,36,5,-24
-42.045,-20.69576,53,38,6,-15
-42.0423,-20.69576,52,44,5,-8
-42.03938,-20.69576,33,41,0,8
-42.03668,-20.69576,26,35,5,9
-42.03399,-20.69576,36,36,0,0
-42.03106,-20.69576,35,35,5,0
-42.02837,-20.69576,45,43,0,-2
-42.02545,-20.69576,46,49,11,3
-42.02275,-20.69576,51,44,0,-7
-42.02005,-20.69576,52,44,5,-8
-42.01713,-20.69576,44,41,5,-3
-42.01444,-20.69576,41,41,11,0
-42.01174,-20.69576,37,40,0,3
-42.00882,-20.69576,59,44,0,-15
-42.00612,-20.69576,60,41,0,-19
-42.00342,-20.69576,63,38,5,-25
-42.0005,-20.69576,59,40,5,-19
-41.99781,-20.69576,48,34,5,-14
-41.99511,-20.69576,62,42,0,-20
-41.99219,-20.69576,64,37,0,-27
-41.98949,-20.69576,55,32,0,-23
-41.98657,-20.69576,55,34,0,-21
-41.98387,-20.69576,65,38,0,-27
-41.98118,-20.69576,62,43,5,-19
-41.97826,-20.69576,53,37,0,-16
-41.97556,-20.69576,53,44,5,-9
-41.97286,-20.69576,53,30,5,-23
-41.96994,-20.69576,52,42,0,-10
-42.10297,-20.69555,68,27,5,-41
-42.10275,-20.69555,68,27,5,-41
-42.10252,-20.69555,69,28,5,-41
-42.1023,-20.69555,69,33,5,-36
-42.10185,-20.69555,69,37,0,-32
-42.10163,-20.69555,70,37,0,-33
-42.1014,-20.69555,68,37,0,-31
-42.10118,-20.69555,67,37,0,-30
-42.10073,-20.69555,63,41,0,-22
-42.1005,-20.69555,62,41,0,-21
-42.10028,-20.69555,62,41,0,-21
-42.10005,-20.69555,62,41,0,-21
-42.09983,-20.69555,62,41,0,-21
-42.09938,-20.69555,62,41,0,-21
-42.09915,-20.69555,63,41,0,-22
-42.09893,-20.69555,63,41,0,-22
-42.0987,-20.69555,63,41,0,-22
-42.09825,-20.69555,67,40,0,-27
-42.09803,-20.69555,67,40,5,-27
-42.0978,-20.69555,67,35,5,-32
-42.09758,-20.69555,69,34,5,-35
-42.09713,-20.69555,67,38,5,-29
-42.09691,-20.69555,67,38,0,-29
-42.09668,-20.69555,69,38,0,-31
-42.09646,-20.69555,66,38,0,-28
-42.09601,-20.69555,67,38,5,-29
-42.09578,-20.69555,66,37,5,-29
-42.09556,-20.69555,63,36,5,-27
-42.09533,-20.69555,63,35,5,-28
-42.09511,-20.69555,64,35,6,-29
-42.09466,-20.69555,64,35,0,-29
-42.09443,-20.69555,65,35,0,-30
-42.09421,-20.69555,64,35,0,-29
-42.09398,-20.69555,64,35,0,-29
-42.09354,-20.69555,64,35,0,-29
-42.09331,-20.69555,64,35,0,-29
-42.09309,-20.69555,65,35,0,-30
-42.09286,-20.69555,64,36,0,-28
-42.09241,-20.69555,65,37,0,-28
-42.09219,-20.69555,67,38,0,-29
-42.09196,-20.69555,65,41,0,-24
-42.09174,-20.69555,64,43,0,-21
-42.09129,-20.69555,64,43,0,-21
-42.09106,-20.69555,63,43,0,-20
-42.09084,-20.69555,65,43,0,-22
-42.09061,-20.69555,63,43,0,-20
-42.09039,-20.69555,64,43,11,-21
-42.08994,-20.69555,65,42,0,-23
-42.08972,-20.69555,63,42,0,-21
-42.08949,-20.69555,61,42,0,-19
-42.08927,-20.69555,60,42,0,-18
-42.08882,-20.69555,59,42,0,-17
-42.08859,-20.69555,57,42,0,-15
-42.08837,-20.69555,56,42,0,-14
-42.08814,-20.69555,56,42,0,-14
-42.08769,-20.69555,57,40,5,-17
-42.08747,-20.69555,57,37,6,-20
-42.08724,-20.69555,57,37,5,-20
-42.08702,-20.69555,57,33,5,-24
-42.08657,-20.69555,57,33,5,-24
-42.08634,-20.69555,57,35,5,-22
-42.08612,-20.69555,57,36,5,-21
-42.08589,-20.69555,57,33,5,-24
-42.08545,-20.69555,58,33,5,-25
-42.08522,-20.69555,58,34,5,-24
-42.085,-20.69555,58,36,5,-22
-42.08477,-20.69555,58,41,5,-17
-42.08455,-20.69555,58,44,0,-14
-42.0841,-20.69555,58,44,0,-14
-42.08387,-20.69555,59,44,0,-15
-42.08365,-20.69555,59,44,0,-15
-42.08342,-20.69555,59,44,0,-15
-42.08297,-20.69555,59,44,0,-15
-42.08275,-20.69555,59,44,0,-15
-42.08252,-20.69555,59,43,0,-16
-42.0823,-20.69555,59,43,0,-16
-42.08185,-20.69555,59,42,5,-17
-42.08163,-20.69555,59,41,5,-18
-42.0814,-20.69555,60,39,5,-21
-42.08118,-20.69555,60,33,5,-27
-42.08073,-20.69555,60,35,5,-25
-42.0805,-20.69555,60,35,5,-25
-42.08028,-20.69555,60,35,5,-25
-42.08005,-20.69555,60,35,5,-25
-42.07983,-20.69555,60,35,6,-25
-42.07938,-20.69555,60,33,5,-27
-42.07915,-20.69555,60,34,5,-26
-42.07893,-20.69555,60,34,5,-26
-42.0787,-20.69555,60,34,5,-26
-42.07825,-20.69555,60,35,5,-25
-42.07803,-20.69555,60,35,5,-25
-42.07781,-20.69555,60,34,5,-26
-42.07758,-20.69555,61,36,5,-25
-42.07713,-20.69555,61,36,6,-25
-42.07691,-20.69555,61,36,5,-25
-42.07668,-20.69555,61,35,11,-26
-42.07646,-20.69555,61,34,5,-27
-42.07601,-20.69555,61,35,5,-26
-42.07578,-20.69555,61,35,5,-26
-42.07556,-20.69555,61,36,5,-25
-42.07533,-20.69555,61,37,5,-24
-42.07511,-20.69555,61,37,5,-24
-42.07466,-20.69555,61,37,5,-24
-42.07443,-20.69555,61,37,5,-24
-42.07421,-20.69555,61,37,5,-24
-42.07399,-20.69555,61,37,5,-24
-42.07354,-20.69555,61,36,5,-25
-42.07331,-20.69555,61,36,5,-25
-42.07309,-20.69555,61,36,5,-25
-42.07286,-20.69555,61,38,5,-23
-42.07241,-20.69555,61,39,5,-22
-42.07219,-20.69555,61,41,5,-20
-42.07196,-20.69555,61,43,5,-18
-42.07174,-20.69555,61,42,5,-19
-42.07129,-20.69555,61,42,5,-19
-42.07106,-20.69555,61,46,5,-15
-42.07084,-20.69555,61,46,0,-15
-42.07061,-20.69555,61,46,0,-15
-42.07039,-20.69555,61,46,0,-15
-42.06994,-20.69555,61,46,0,-15
-42.06972,-20.69555,61,45,0,-16
-42.06949,-20.69555,61,45,0,-16
-42.06927,-20.69555,61,45,0,-16
-42.06882,-20.69555,62,45,0,-17
-42.06859,-20.69555,62,45,0,-17
-42.06837,-20.69555,63,44,0,-19
-42.06814,-20.69555,63,44,0,-19
-42.06769,-20.69555,63,44,0,-19
-42.06747,-20.69555,63,44,0,-19
-42.06724,-20.69555,63,44,0,-19
-42.06702,-20.69555,62,44,0,-18
-42.06657,-20.69555,61,44,0,-17
-42.06634,-20.69555,61,44,0,-17
-42.06612,-20.69555,61,43,0,-18
-42.0659,-20.69555,61,43,0,-18
-42.06545,-20.69555,62,43,11,-19
-42.06522,-20.69555,61,43,5,-18
-42.065,-20.69555,61,41,5,-20
-42.06477,-20.69555,60,39,5,-21
-42.06455,-20.69555,60,39,5,-21
-42.0641,-20.69555,60,39,5,-21
-42.06387,-20.69555,60,39,5,-21
-42.06365,-20.69555,58,41,6,-17
-42.06342,-20.69555,58,38,5,-20
-42.06297,-20.69555,58,38,5,-20
-42.06275,-20.69555,58,36,5,-22
-42.06252,-20.69555,58,36,5,-22
-42.0623,-20.69555,57,36,5,-21
-42.06185,-20.69555,57,36,5,-21
-42.06163,-20.69555,57,36,5,-21
-42.0614,-20.69555,56,36,5,-20
-42.06118,-20.69555,56,36,5,-20
-42.06073,-20.69555,56,36,5,-20
-42.0605,-20.69555,58,36,5,-22
-42.06028,-20.69555,65,37,5,-28
-42.06005,-20.69555,65,37,5,-28
-42.05983,-20.69555,65,37,5,-28
-42.05938,-20.69555,65,37,5,-28
-42.05915,-20.69555,66,37,5,-29
-42.05893,-20.69555,66,37,5,-29
-42.0587,-20.69555,66,37,5,-29
-42.05826,-20.69555,67,38,5,-29
-42.05803,-20.69555,59,37,5,-22
-42.05781,-20.69555,59,37,5,-22
-42.05758,-20.69555,60,36,5,-24
-42.05713,-20.69555,63,36,5,-27
-42.05691,-20.69555,66,37,5,-29
-42.05668,-20.69555,64,38,5,-26
-42.05646,-20.69555,65,39,5,-26
-42.05601,-20.69555,64,38,5,-26
-42.05578,-20.69555,57,38,5,-19
-42.05556,-20.69555,56,38,5,-18
-42.05533,-20.69555,55,38,5,-17
-42.05511,-20.69555,55,38,5,-17
-42.05466,-20.69555,54,37,5,-17
-42.05443,-20.69555,55,37,5,-18
-42.05421,-20.69555,57,37,5,-20
-42.05399,-20.69555,55,38,5,-17
-42.05354,-20.69555,55,39,5,-16
-42.05331,-20.69555,55,39,5,-16
-42.05309,-20.69555,55,39,5,-16
-42.05286,-20.69555,55,39,5,-16
-42.05241,-20.69555,56,36,5,-20
-42.05219,-20.69555,56,36,5,-20
-42.05196,-20.69555,56,32,5,-24
-42.05174,-20.69555,55,32,5,-23
-42.05129,-20.69555,54,33,5,-21
-42.05106,-20.69555,54,33,5,-21
-42.05084,-20.69555,54,33,5,-21
-42.05061,-20.69555,54,33,5,-21
-42.05039,-20.69555,55,33,5,-22
-42.04994,-20.69555,55,32,5,-23
-42.04972,-20.69555,59,34,5,-25
-42.04949,-20.69555,65,36,5,-29
-42.04927,-20.69555,65,37,5,-28
-42.04882,-20.69555,66,34,5,-32
-42.04859,-20.69555,58,34,5,-24
-42.04837,-20.69555,58,37,5,-21
-42.04814,-20.69555,59,38,5,-21
-42.04769,-20.69555,59,38,6,-21
-42.04747,-20.69555,59,37,6,-22
-42.04724,-20.69555,57,37,6,-20
-42.04702,-20.69555,59,38,5,-21
-42.04657,-20.69555,62,38,5,-24
-42.04635,-20.69555,63,37,6,-26
-42.04612,-20.69555,63,38,6,-25
-42.0459,-20.69555,63,38,6,-25
-42.04545,-20.69555,63,38,6,-25
-42.04522,-20.69555,61,38,6,-23
-42.045,-20.69555,59,38,5,-21
-42.04477,-20.69555,58,38,5,-20
-42.04455,-20.69555,55,39,5,-16
-42.0441,-20.69555,55,38,5,-17
-42.04387,-20.69555,53,38,5,-15
-42.04365,-20.69555,52,38,5,-14
-42.04342,-20.69555,51,40,5,-11
-42.04297,-20.69555,50,38,5,-12
-42.04275,-20.69555,49,38,5,-11
-42.04253,-20.69555,53,39,5,-14
-42.0423,-20.69555,54,46,5,-8
-42.04185,-20.69555,54,46,5,-8
-42.04163,-20.69555,53,46,5,-7
-42.0414,-20.69555,52,47,11,-5
-42.04118,-20.69555,52,46,5,-6
-42.04073,-20.69555,48,40,5,-8
-42.0405,-20.69555,45,40,5,-5
-42.04028,-20.69555,45,40,5,-5
-42.04005,-20.69555,41,41,0,0
-42.03983,-20.69555,36,40,0,4
-42.03938,-20.69555,32,41,0,9
-42.03915,-20.69555,26,38,0,12
-42.03893,-20.69555,26,38,0,12
-42.0387,-20.69555,26,37,0,11
-42.03826,-20.69555,26,36,5,10
-42.03803,-20.69555,26,35,5,9
-42.03781,-20.69555,26,35,5,9
-42.03758,-20.69555,26,35,5,9
-42.03713,-20.69555,27,35,5,8
-42.03691,-20.69555,27,35,5,8
-42.03668,-20.69555,27,35,5,8
-42.03646,-20.69555,26,35,5,9
-42.03601,-20.69555,26,35,5,9
-42.03578,-20.69555,26,36,5,10
-42.03556,-20.69555,26,36,5,10
-42.03533,-20.69555,26,36,5,10
-42.03511,-20.69555,26,35,5,9
-42.03466,-20.69555,25,34,5,9
-42.03444,-20.69555,26,33,5,7
-42.03421,-20.69555,30,34,5,4
-42.03399,-20.69555,31,36,0,5
-42.03354,-20.69555,30,35,0,5
-42.03331,-20.69555,28,34,5,6
-42.03309,-20.69555,25,34,5,9
-42.03286,-20.69555,25,35,5,10
-42.03241,-20.69555,25,33,5,8
-42.03219,-20.69555,24,34,5,10
-42.03196,-20.69555,24,34,5,10
-42.03174,-20.69555,26,34,5,8
-42.03129,-20.69555,30,34,5,4
-42.03106,-20.69555,33,35,5,2
-42.03084,-20.69555,36,36,5,0
-42.03062,-20.69555,38,38,5,0
-42.03017,-20.69555,38,38,5,0
-42.02994,-20.69555,38,38,5,0
-42.02972,-20.69555,38,38,5,0
-42.02949,-20.69555,36,38,5,2
-42.02927,-20.69555,37,38,5,1
-42.02882,-20.69555,38,38,0,0
-42.02859,-20.69555,40,40,5,0
-42.02837,-20.69555,49,42,5,-7
-42.02814,-20.69555,48,42,5,-6
-42.02769,-20.69555,51,40,5,-11
-42.02747,-20.69555,52,39,5,-13
-42.02724,-20.69555,51,40,5,-11
-42.02702,-20.69555,48,42,5,-6
-42.02657,-20.69555,47,46,5,-1
-42.02635,-20.69555,45,46,5,1
-42.02612,-20.69555,44,43,0,-1
-42.0259,-20.69555,44,43,0,-1
-42.02545,-20.69555,45,45,0,0
-42.02522,-20.69555,45,45,11,0
-42.025,-20.69555,46,45,0,-1
-42.02477,-20.69555,46,42,0,-4
-42.02455,-20.69555,46,43,0,-3
-42.0241,-20.69555,46,46,0,0
-42.02387,-20.69555,47,47,0,0
-42.02365,-20.69555,49,47,0,-2
-42.02342,-20.69555,49,46,0,-3
-42.02297,-20.69555,50,45,0,-5
-42.02275,-20.69555,50,44,0,-6
-42.02253,-20.69555,51,45,0,-6
-42.0223,-20.69555,51,44,0,-7
-42.02185,-20.69555,51,44,5,-7
-42.02163,-20.69555,50,38,5,-12
-42.0214,-20.69555,51,41,5,-10
-42.02118,-20.69555,51,39,5,-12
-42.02073,-20.69555,51,39,5,-12
-42.0205,-20.69555,51,38,5,-13
-42.02028,-20.69555,51,38,5,-13
-42.02005,-20.69555,52,40,5,-12
-42.01983,-20.69555,51,45,5,-6
-42.01938,-20.69555,51,43,5,-8
-42.01915,-20.69555,50,45,5,-5
-42.01893,-20.69555,50,43,5,-7
-42.01871,-20.69555,49,42,5,-7
-42.01826,-20.69555,47,45,11,-2
-42.01803,-20.69555,46,46,5,0
-42.01781,-20.69555,45,41,5,-4
-42.01758,-20.69555,44,41,0,-3
-42.01713,-20.69555,43,43,0,0
-42.01691,-20.69555,43,43,0,0
-42.01668,-20.69555,43,43,0,0
-42.01646,-20.69555,43,44,0,1
-42.01601,-20.69555,43,45,5,2
-42.01578,-20.69555,43,40,11,-3
-42.01556,-20.69555,44,40,5,-4
-42.01533,-20.69555,43,40,5,-3
-42.01511,-20.69555,43,41,5,-2
-42.01466,-20.69555,42,42,0,0
-42.01444,-20.69555,40,41,0,1
-42.01421,-20.69555,40,42,0,2
-42.01399,-20.69555,39,42,0,3
-42.01354,-20.69555,38,40,0,2
-42.01331,-20.69555,36,40,0,4
-42.01309,-20.69555,34,38,0,4
-42.01286,-20.69555,35,37,0,2
-42.01241,-20.69555,35,39,11,4
-42.01219,-20.69555,35,40,0,5
-42.01196,-20.69555,36,40,0,4
-42.01174,-20.69555,37,40,0,3
-42.01129,-20.69555,48,42,0,-6
-42.01106,-20.69555,50,42,0,-8
-42.01084,-20.69555,55,43,0,-12
-42.01062,-20.69555,55,44,0,-11
-42.01017,-20.69555,55,45,0,-10
-42.00994,-20.69555,55,44,0,-11
-42.00972,-20.69555,55,44,0,-11
-42.00949,-20.69555,55,45,0,-10
-42.00927,-20.69555,56,45,0,-11
-42.00882,-20.69555,56,45,0,-11
-42.00859,-20.69555,58,45,0,-13
-42.00837,-20.69555,59,44,0,-15
-42.00814,-20.69555,59,44,0,-15
-42.00769,-20.69555,59,43,0,-16
-42.00747,-20.69555,58,43,0,-15
-42.00724,-20.69555,58,42,0,-16
-42.00702,-20.69555,60,42,0,-18
-42.00657,-20.69555,58,42,0,-16
-42.00635,-20.69555,61,42,0,-19
-42.00612,-20.69555,59,42,0,-17
-42.0059,-20.69555,60,41,0,-19
-42.00545,-20.69555,59,41,0,-18
-42.00522,-20.69555,59,41,0,-18
-42.005,-20.69555,58,41,0,-17
-42.00477,-20.69555,58,41,0,-17
-42.00455,-20.69555,57,41,0,-16
-42.0041,-20.69555,58,41,0,-17
-42.00387,-20.69555,58,40,5,-18
-42.00365,-20.69555,59,40,5,-19
-42.00342,-20.69555,60,36,5,-24
-42.00298,-20.69555,61,35,5,-26
-42.00275,-20.69555,62,34,5,-28
-42.00253,-20.69555,62,36,5,-26
-42.0023,-20.69555,63,36,5,-27
-42.00185,-20.69555,63,37,5,-26
-42.00163,-20.69555,64,39,5,-25
-42.0014,-20.69555,63,40,5,-23
-42.00118,-20.69555,63,37,5,-26
-42.00073,-20.69555,60,38,5,-22
-42.0005,-20.69555,56,38,5,-18
-42.00028,-20.69555,52,32,5,-20
-42.00005,-20.69555,49,35,5,-14
-41.99983,-20.69555,48,37,5,-11
-41.99938,-20.69555,48,37,5,-11
-41.99916,-20.69555,49,32,5,-17
-41.99893,-20.69555,48,38,5,-10
-41.99871,-20.69555,49,41,5,-8
-41.99826,-20.69555,47,36,5,-11
-41.99803,-20.69555,48,34,5,-14
-41.99781,-20.69555,53,33,5,-20
-41.99758,-20.69555,54,32,5,-22
-41.99713,-20.69555,60,38,5,-22
-41.99691,-20.69555,62,39,0,-23
-41.99668,-20.69555,63,41,0,-22
-41.99646,-20.69555,62,41,0,-21
-41.99601,-20.69555,63,41,0,-22
-41.99578,-20.69555,66,41,0,-25
-41.99556,-20.69555,64,42,0,-22
-41.99533,-20.69555,66,42,0,-24
-41.99511,-20.69555,64,42,0,-22
-41.99466,-20.69555,62,42,0,-20
-41.99444,-20.69555,59,42,0,-17
-41.99421,-20.69555,58,42,0,-16
-41.99399,-20.69555,58,42,0,-16
-41.99354,-20.69555,56,38,0,-18
-41.99331,-20.69555,54,38,0,-16
-41.99309,-20.69555,54,36,0,-18
-41.99286,-20.69555,60,37,0,-23
-41.99241,-20.69555,61,38,0,-23
-41.99219,-20.69555,62,38,0,-24
-41.99196,-20.69555,64,37,0,-27
-41.99174,-20.69555,63,37,0,-26
-41.99129,-20.69555,63,36,0,-27
-41.99107,-20.69555,62,36,0,-26
-41.99084,-20.69555,59,36,0,-23
-41.99062,-20.69555,56,36,5,-20
-41.99017,-20.69555,55,37,5,-18
-41.98994,-20.69555,56,35,5,-21
-41.98972,-20.69555,56,34,5,-22
-41.98949,-20.69555,55,33,0,-22
-41.98927,-20.69555,55,33,0,-22
-41.98882,-20.69555,55,33,0,-22
-41.98859,-20.69555,55,33,0,-22
-41.98837,-20.69555,55,32,0,-23
-41.98814,-20.69555,55,32,0,-23
-41.98769,-20.69555,55,31,0,-24
-41.98747,-20.69555,58,32,0,-26
-41.98725,-20.69555,58,33,0,-25
-41.98702,-20.69555,55,33,0,-22
-41.98657,-20.69555,54,34,0,-20
-41.98635,-20.69555,54,34,0,-20
-41.98612,-20.69555,54,35,0,-19
-41.9859,-20.69555,55,35,0,-20
-41.98545,-20.69555,55,35,0,-20
-41.98522,-20.69555,55,36,11,-19
-41.985,-20.69555,55,36,0,-19
-41.98477,-20.69555,58,37,0,-21
-41.98455,-20.69555,60,37,0,-23
-41.9841,-20.69555,63,38,0,-25
-41.98387,-20.69555,64,38,0,-26
-41.98365,-20.69555,63,38,0,-25
-41.98343,-20.69555,64,39,0,-25
-41.98298,-20.69555,64,39,0,-25
-41.98275,-20.69555,63,40,0,-23
-41.98253,-20.69555,63,40,0,-23
-41.9823,-20.69555,63,40,5,-23
-41.98185,-20.69555,62,41,5,-21
-41.98163,-20.69555,61,43,5,-18
-41.9814,-20.69555,61,43,5,-18
-41.98118,-20.69555,61,43,5,-18
-41.98073,-20.69555,61,44,5,-17
-41.9805,-20.69555,60,44,5,-16
-41.98028,-20.69555,59,44,5,-15
-41.98005,-20.69555,58,44,5,-14
-41.97983,-20.69555,57,34,5,-23
-41.97938,-20.69555,56,35,0,-21
-41.97916,-20.69555,55,35,0,-20
-41.97893,-20.69555,53,36,0,-17
-41.97871,-20.69555,52,36,0,-16
-41.97826,-20.69555,52,37,0,-15
-41.97803,-20.69555,52,37,0,-15
-41.97781,-20.69555,52,38,0,-14
-41.97758,-20.69555,52,40,0,-12
-41.97713,-20.69555,52,41,0,-11
-41.97691,-20.69555,52,41,0,-11
-41.97668,-20.69555,52,41,0,-11
-41.97646,-20.69555,52,44,0,-8
-41.97601,-20.69555,53,44,5,-9
-41.97578,-20.69555,54,44,5,-10
-41.97556,-20.69555,56,36,5,-20
-41.97534,-20.69555,58,35,5,-23
-41.97511,-20.69555,53,32,5,-21
-41.97466,-20.69555,53,33,5,-20
-41.97444,-20.69555,53,34,5,-19
-41.97421,-20.69555,53,45,5,-8
-41.97399,-20.69555,53,45,5,-8
-41.97354,-20.69555,52,37,5,-15
-41.97331,-20.69555,52,33,5,-19
-41.97309,-20.69555,52,32,5,-20
-41.97286,-20.69555,52,30,5,-22
-41.97241,-20.69555,52,29,5,-23
-41.97219,-20.69555,52,28,5,-24
-41.97196,-20.69555,62,28,5,-34
-41.97174,-20.69555,52,28,5,-24
-41.97129,-20.69555,52,34,0,-18
-41.97107,-20.69555,52,36,0,-16
-41.97084,-20.69555,52,37,0,-15
-41.97062,-20.69555,52,39,0,-13
-41.97017,-20.69555,52,39,5,-13
-41.96994,-20.69555,52,39,5,-13
-41.96972,-20.69555,52,42,5,-10
-41.96949,-20.69555,52,45,5,-7
-41.96927,-20.69555,52,45,5,-7
-42.1005,-20.69534,66,41,0,-25
-42.0978,-20.69534,67,39,5,-28
-42.09511,-20.69534,63,35,5,-28
-42.09219,-20.69534,67,39,0,-28
-42.08949,-20.69534,63,42,0,-21
-42.08657,-20.69534,57,33,5,-24
-42.08387,-20.69534,59,44,0,-15
-42.08118,-20.69534,59,39,5,-20
-42.07825,-20.69534,60,35,5,-25
-42.07556,-20.69534,61,36,5,-25
-42.07286,-20.69534,61,37,5,-24
-42.06994,-20.69534,61,45,0,-16
-42.06724,-20.69534,64,44,0,-20
-42.06455,-20.69534,59,39,5,-20
-42.06163,-20.69534,56,36,5,-20
-42.05893,-20.69534,66,36,5,-30
-42.05601,-20.69534,65,38,5,-27
-42.05331,-20.69534,55,36,5,-19
-42.05061,-20.69534,54,33,5,-21
-42.04769,-20.69534,58,37,5,-21
-42.045,-20.69534,62,40,5,-22
-42.0423,-20.69534,54,47,5,-7
-42.03938,-20.69534,25,38,0,13
-42.03668,-20.69534,26,36,5,10
-42.03399,-20.69534,23,34,5,11
-42.03106,-20.69534,32,35,5,3
-42.02837,-20.69534,49,42,5,-7
-42.02545,-20.69534,41,48,0,7
-42.02275,-20.69534,50,45,0,-5
-42.02005,-20.69534,51,45,0,-6
-42.01713,-20.69534,43,43,0,0
-42.01444,-20.69534,40,39,5,-1
-42.01174,-20.69534,36,40,0,4
-42.00882,-20.69534,55,45,0,-10
-42.00612,-20.69534,58,42,0,-16
-42.00342,-20.69534,58,40,5,-18
-42.0005,-20.69534,54,40,5,-14
-41.99781,-20.69534,57,32,5,-25
-41.99511,-20.69534,66,42,0,-24
-41.99219,-20.69534,64,38,0,-26
-41.98949,-20.69534,55,34,0,-21
-41.98657,-20.69534,54,34,0,-20
-41.98387,-20.69534,59,38,0,-21
-41.98118,-20.69534,59,43,5,-16
-41.97826,-20.69534,52,37,0,-15
-41.97556,-20.69534,53,36,5,-17
-41.97286,-20.69534,52,30,5,-22
-41.96994,-20.69534,52,34,5,-18
-42.1005,-20.69491,66,41,0,-25
-42.0978,-20.69491,68,40,0,-28
-42.09511,-20.69491,63,39,11,-24
-42.09219,-20.69491,64,40,0,-24
-42.08949,-20.69491,63,42,0,-21
-42.08657,-20.69491,57,33,5,-24
-42.08387,-20.69491,58,45,0,-13
-42.08118,-20.69491,59,40,0,-19
-42.07825,-20.69491,60,33,5,-27
-42.07556,-20.69491,61,38,5,-23
-42.07286,-20.69491,61,40,5,-21
-42.06994,-20.69491,61,45,0,-16
-42.06724,-20.69491,62,44,0,-18
-42.06455,-20.69491,58,39,5,-19
-42.06163,-20.69491,56,36,5,-20
-42.05893,-20.69491,65,37,5,-28
-42.05601,-20.69491,58,36,5,-22
-42.05331,-20.69491,55,36,5,-19
-42.05061,-20.69491,55,32,5,-23
-42.04769,-20.69491,60,35,5,-25
-42.045,-20.69491,64,41,5,-23
-42.0423,-20.69491,54,47,5,-7
-42.03938,-20.69491,20,36,0,16
-42.03668,-20.69491,35,37,5,2
-42.03399,-20.69491,17,35,5,18
-42.03106,-20.69491,30,40,5,10
-42.02837,-20.69491,47,39,5,-8
-42.02545,-20.69491,40,41,0,1
-42.02275,-20.69491,50,48,0,-2
-42.02005,-20.69491,51,45,5,-6
-42.01713,-20.69491,44,44,0,0
-42.01444,-20.69491,40,40,5,0
-42.01174,-20.69491,35,41,0,6
-42.00882,-20.69491,54,41,0,-13
-42.00612,-20.69491,58,42,0,-16
-42.00342,-20.69491,56,41,0,-15
-42.0005,-20.69491,51,40,5,-11
-41.99781,-20.69491,60,32,5,-28
-41.99511,-20.69491,67,41,0,-26
-41.99219,-20.69491,64,36,0,-28
-41.98949,-20.69491,55,36,0,-19
-41.98657,-20.69491,54,34,0,-20
-41.98387,-20.69491,56,38,0,-18
-41.98118,-20.69491,55,43,5,-12
-41.97826,-20.69491,52,35,0,-17
-41.97556,-20.69491,52,32,5,-20
-41.97286,-20.69491,52,29,5,-23
-41.96994,-20.69491,52,33,5,-19
-42.1005,-20.6947,64,41,0,-23
-42.0978,-20.6947,67,40,0,-27
-42.09511,-20.6947,63,40,0,-23
-42.09219,-20.6947,63,42,0,-21
-42.08949,-20.6947,63,42,0,-21
-42.08657,-20.6947,58,33,5,-25
-42.08387,-20.6947,58,45,0,-13
-42.08118,-20.6947,59,41,0,-18
-42.07825,-20.6947,60,33,5,-27
-42.07556,-20.6947,61,35,5,-26
-42.07286,-20.6947,61,40,5,-21
-42.06994,-20.6947,61,45,0,-16
-42.06724,-20.6947,61,44,0,-17
-42.06455,-20.6947,58,42,5,-16
-42.06163,-20.6947,55,36,5,-19
-42.05893,-20.6947,65,37,5,-28
-42.05601,-20.6947,58,36,5,-22
-42.05331,-20.6947,55,36,5,-19
-42.05061,-20.6947,55,38,5,-17
-42.04769,-20.6947,58,35,5,-23
-42.045,-20.6947,65,41,5,-24
-42.0423,-20.6947,54,48,5,-6
-42.03938,-20.6947,27,36,5,9
-42.03668,-20.6947,40,39,5,-1
-42.03399,-20.6947,26,35,5,9
-42.03106,-20.6947,29,40,5,11
-42.02837,-20.6947,45,37,5,-8
-42.02545,-20.6947,39,39,0,0
-42.02275,-20.6947,50,48,11,-2
-42.02005,-20.6947,51,43,5,-8
-42.01713,-20.6947,48,47,11,-1
-42.01444,-20.6947,40,40,5,0
-42.01174,-20.6947,35,42,0,7
-42.00882,-20.6947,54,40,0,-14
-42.00612,-20.6947,58,42,0,-16
-42.00342,-20.6947,55,41,0,-14
-42.0005,-20.6947,48,37,5,-11
-41.99781,-20.6947,60,31,5,-29
-41.99511,-20.6947,67,41,0,-26
-41.99219,-20.6947,64,35,0,-29
-41.98949,-20.6947,55,36,0,-19
-41.98657,-20.6947,54,34,0,-20
-41.98387,-20.6947,54,38,0,-16
-41.98118,-20.6947,54,44,5,-10
-41.97826,-20.6947,52,35,0,-17
-41.97556,-20.6947,52,32,5,-20
-41.97286,-20.6947,51,29,5,-22
-41.96994,-20.6947,52,34,5,-18
-42.1005,-20.69449,63,41,0,-22
-42.0978,-20.69449,67,40,0,-27
-42.09511,-20.69449,64,40,0,-24
-42.09219,-20.69449,62,42,0,-20
-42.08949,-20.69449,64,42,6,-22
-42.08657,-20.69449,61,33,5,-28
-42.08387,-20.69449,58,45,0,-13
-42.08118,-20.69449,59,41,0,-18
-42.07825,-20.69449,60,38,5,-22
-42.07556,-20.69449,61,35,5,-26
-42.07286,-20.69449,61,40,5,-21
-42.06994,-20.69449,61,45,0,-16
-42.06724,-20.69449,61,44,0,-17
-42.06455,-20.69449,60,42,0,-18
-42.06163,-20.69449,55,36,5,-19
-42.05893,-20.69449,57,37,5,-20
-42.05601,-20.69449,57,37,5,-20
-42.05331,-20.69449,55,36,5,-19
-42.05061,-20.69449,54,38,6,-16
-42.04769,-20.69449,58,36,5,-22
-42.045,-20.69449,66,44,5,-22
-42.0423,-20.69449,54,48,5,-6
-42.03938,-20.69449,27,36,5,9
-42.03668,-20.69449,44,40,5,-4
-42.03399,-20.69449,33,34,5,1
-42.03106,-20.69449,27,39,5,12
-42.02837,-20.69449,41,37,5,-4
-42.02545,-20.69449,45,40,0,-5
-42.02275,-20.69449,50,48,0,-2
-42.02005,-20.69449,50,41,5,-9
-42.01713,-20.69449,45,45,0,0
-42.01444,-20.69449,39,39,5,0
-42.01174,-20.69449,45,43,0,-2
-42.00882,-20.69449,54,40,0,-14
-42.00612,-20.69449,58,42,0,-16
-42.00342,-20.69449,53,41,0,-12
-42.0005,-20.69449,48,36,5,-12
-41.99781,-20.69449,62,31,5,-31
-41.99511,-20.69449,67,37,0,-30
-41.99219,-20.69449,62,34,11,-28
-41.98949,-20.69449,55,37,0,-18
-41.98657,-20.69449,54,35,0,-19
-41.98387,-20.69449,53,39,0,-14
-41.98118,-20.69449,52,43,5,-9
-41.97826,-20.69449,52,35,0,-17
-41.97556,-20.69449,52,35,5,-17
-41.97286,-20.69449,59,29,5,-30
-41.96994,-20.69449,61,34,5,-27
-42.1005,-20.69407,63,41,0,-22
-42.0978,-20.69407,67,41,0,-26
-42.09511,-20.69407,66,42,0,-24
-42.09219,-20.69407,62,42,0,-20
-42.08949,-20.69407,65,42,0,-23
-42.08657,-20.69407,66,32,5,-34
-42.08387,-20.69407,58,45,0,-13
-42.08118,-20.69407,59,41,5,-18
-42.07825,-20.69407,60,38,5,-22
-42.07556,-20.69407,61,35,5,-26
-42.07286,-20.69407,61,39,5,-22
-42.06994,-20.69407,61,45,0,-16
-42.06724,-20.69407,62,43,0,-19
-42.06455,-20.69407,62,42,11,-20
-42.06163,-20.69407,55,36,5,-19
-42.05893,-20.69407,55,37,5,-18
-42.05601,-20.69407,56,39,0,-17
-42.05331,-20.69407,55,38,5,-17
-42.05061,-20.69407,54,39,5,-15
-42.04769,-20.69407,59,39,5,-20
-42.045,-20.69407,71,46,5,-25
-42.0423,-20.69407,54,42,5,-12
-42.03938,-20.69407,30,38,5,8
-42.03668,-20.69407,52,38,5,-14
-42.03399,-20.69407,44,42,5,-2
-42.03106,-20.69407,26,38,5,12
-42.02837,-20.69407,43,37,5,-6
-42.02545,-20.69407,55,40,0,-15
-42.02275,-20.69407,50,48,0,-2
-42.02005,-20.69407,50,41,5,-9
-42.01713,-20.69407,54,49,0,-5
-42.01444,-20.69407,40,40,0,0
-42.01174,-20.69407,41,43,0,2
-42.00882,-20.69407,54,38,0,-16
-42.00612,-20.69407,57,42,0,-15
-42.00342,-20.69407,53,40,0,-13
-42.0005,-20.69407,49,34,5,-15
-41.99781,-20.69407,66,32,5,-34
-41.99511,-20.69407,67,35,0,-32
-41.99219,-20.69407,58,34,0,-24
-41.98949,-20.69407,56,37,0,-19
-41.98657,-20.69407,54,36,0,-18
-41.98387,-20.69407,53,38,0,-15
-41.98118,-20.69407,54,44,5,-10
-41.97826,-20.69407,52,35,0,-17
-41.97556,-20.69407,52,39,5,-13
-41.97286,-20.69407,51,30,5,-21
-41.96994,-20.69407,52,31,5,-21
-42.1005,-20.69386,63,38,0,-25
-42.0978,-20.69386,67,41,0,-26
-42.09511,-20.69386,66,42,0,-24
-42.09219,-20.69386,62,42,0,-20
-42.08949,-20.69386,66,42,0,-24
-42.08657,-20.69386,66,32,5,-34
-42.08387,-20.69386,59,45,0,-14
-42.08118,-20.69386,59,36,5,-23
-42.07825,-20.69386,60,38,11,-22
-42.07556,-20.69386,61,34,5,-27
-42.07286,-20.69386,61,39,5,-22
-42.06994,-20.69386,61,44,0,-17
-42.06724,-20.69386,62,43,0,-19
-42.06455,-20.69386,64,42,0,-22
-42.06163,-20.69386,55,36,5,-19
-42.05893,-20.69386,55,36,5,-19
-42.05601,-20.69386,55,40,0,-15
-42.05331,-20.69386,55,37,5,-18
-42.05061,-20.69386,54,38,5,-16
-42.04769,-20.69386,60,39,5,-21
-42.045,-20.69386,70,46,5,-24
-42.0423,-20.69386,53,41,5,-12
-42.03938,-20.69386,41,41,11,0
-42.03668,-20.69386,50,38,5,-12
-42.03399,-20.69386,50,48,5,-2
-42.03106,-20.69386,29,38,5,9
-42.02837,-20.69386,46,35,5,-11
-42.02545,-20.69386,55,40,0,-15
-42.02275,-20.69386,50,48,0,-2
-42.02005,-20.69386,50,40,5,-10
-42.01713,-20.69386,57,49,0,-8
-42.01444,-20.69386,48,44,0,-4
-42.01174,-20.69386,45,44,0,-1
-42.00882,-20.69386,54,38,0,-16
-42.00612,-20.69386,57,42,0,-15
-42.00342,-20.69386,52,39,0,-13
-42.0005,-20.69386,53,33,5,-20
-41.99781,-20.69386,66,33,5,-33
-41.99511,-20.69386,68,35,0,-33
-41.99219,-20.69386,58,34,0,-24
-41.98949,-20.69386,56,38,0,-18
-41.98657,-20.69386,54,36,0,-18
-41.98387,-20.69386,53,38,0,-15
-41.98118,-20.69386,52,44,5,-8
-41.97826,-20.69386,52,35,0,-17
-41.97556,-20.69386,51,32,5,-19
-41.97286,-20.69386,51,28,5,-23
-41.96994,-20.69386,59,31,5,-28
-42.1005,-20.69365,63,38,0,-25
-42.0978,-20.69365,68,41,0,-27
-42.09511,-20.69365,67,42,0,-25
-42.09219,-20.69365,62,41,5,-21
-42.08949,-20.69365,65,42,0,-23
-42.08657,-20.69365,65,32,5,-33
-42.08387,-20.69365,59,45,0,-14
-42.08118,-20.69365,59,33,5,-26
-42.07825,-20.69365,60,38,5,-22
-42.07556,-20.69365,61,35,5,-26
-42.07286,-20.69365,61,43,5,-18
-42.06994,-20.69365,60,44,0,-16
-42.06724,-20.69365,62,43,0,-19
-42.06455,-20.69365,64,42,0,-22
-42.06163,-20.69365,57,35,5,-22
-42.05893,-20.69365,55,36,5,-19
-42.05601,-20.69365,55,40,5,-15
-42.05331,-20.69365,54,37,5,-17
-42.05061,-20.69365,54,36,5,-18
-42.04769,-20.69365,62,41,5,-21
-42.045,-20.69365,70,47,5,-23
-42.0423,-20.69365,53,48,5,-5
-42.03938,-20.69365,46,45,5,-1
-42.03668,-20.69365,49,38,5,-11
-42.03399,-20.69365,50,48,5,-2
-42.03106,-20.69365,39,39,5,0
-42.02837,-20.69365,51,35,5,-16
-42.02545,-20.69365,55,40,0,-15
-42.02275,-20.69365,49,48,0,-1
-42.02005,-20.69365,50,43,5,-7
-42.01713,-20.69365,52,49,0,-3
-42.01444,-20.69365,50,45,0,-5
-42.01174,-20.69365,45,44,0,-1
-42.00882,-20.69365,53,39,0,-14
-42.00612,-20.69365,56,42,0,-14
-42.00342,-20.69365,52,37,5,-15
-42.0005,-20.69365,56,32,5,-24
-41.99781,-20.69365,66,33,0,-33
-41.99511,-20.69365,69,35,11,-34
-41.99219,-20.69365,58,34,0,-24
-41.98949,-20.69365,57,35,0,-22
-41.98657,-20.69365,53,36,0,-17
-41.98387,-20.69365,53,38,0,-15
-41.98118,-20.69365,52,44,5,-8
-41.97826,-20.69365,52,34,0,-18
-41.97556,-20.69365,51,33,5,-18
-41.97286,-20.69365,53,28,5,-25
-41.96994,-20.69365,66,30,5,-36
-42.1005,-20.69343,62,37,0,-25
-42.0978,-20.69343,68,42,0,-26
-42.09511,-20.69343,64,42,0,-22
-42.09219,-20.69343,62,42,11,-20
-42.08949,-20.69343,64,42,0,-22
-42.08657,-20.69343,62,32,5,-30
-42.08387,-20.69343,62,45,0,-17
-42.08118,-20.69343,59,33,5,-26
-42.07825,-20.69343,60,39,5,-21
-42.07556,-20.69343,61,35,5,-26
-42.07286,-20.69343,61,39,5,-22
-42.06994,-20.69343,60,44,0,-16
-42.06724,-20.69343,65,43,0,-22
-42.06455,-20.69343,65,42,0,-23
-42.06163,-20.69343,60,34,5,-26
-42.05893,-20.69343,55,36,5,-19
-42.05601,-20.69343,55,40,5,-15
-42.05331,-20.69343,54,36,5,-18
-42.05061,-20.69343,54,36,5,-18
-42.04769,-20.69343,63,42,5,-21
-42.045,-20.69343,70,50,5,-20
-42.0423,-20.69343,53,45,5,-8
-42.03938,-20.69343,47,46,5,-1
-42.03668,-20.69343,48,37,5,-11
-42.03399,-20.69343,51,48,5,-3
-42.03106,-20.69343,44,41,5,-3
-42.02837,-20.69343,54,35,0,-19
-42.02545,-20.69343,55,40,0,-15
-42.02275,-20.69343,51,48,0,-3
-42.02005,-20.69343,50,44,5,-6
-42.01713,-20.69343,50,49,0,-1
-42.01444,-20.69343,54,46,0,-8
-42.01174,-20.69343,47,44,0,-3
-42.00882,-20.69343,56,40,0,-16
-42.00612,-20.69343,55,41,0,-14
-42.00342,-20.69343,52,33,5,-19
-42.0005,-20.69343,59,31,5,-28
-41.99781,-20.69343,67,33,0,-34
-41.99511,-20.69343,68,34,0,-34
-41.99219,-20.69343,56,35,0,-21
-41.98949,-20.69343,56,34,0,-22
-41.98657,-20.69343,51,35,0,-16
-41.98387,-20.69343,53,38,5,-15
-41.98118,-20.69343,52,44,5,-8
-41.97826,-20.69343,52,33,5,-19
-41.97556,-20.69343,51,32,5,-19
-41.97286,-20.69343,50,29,5,-21
-41.96994,-20.69343,65,30,5,-35
-42.1005,-20.69301,62,33,0,-29
-42.0978,-20.69301,67,42,0,-25
-42.09511,-20.69301,65,42,0,-23
-42.09219,-20.69301,63,36,5,-27
-42.08949,-20.69301,65,42,5,-23
-42.08657,-20.69301,65,33,5,-32
-42.08387,-20.69301,67,45,0,-22
-42.08118,-20.69301,59,33,5,-26
-42.07825,-20.69301,60,40,5,-20
-42.07556,-20.69301,61,34,5,-27
-42.07286,-20.69301,61,39,5,-22
-42.06994,-20.69301,61,44,0,-17
-42.06724,-20.69301,65,43,0,-22
-42.06455,-20.69301,66,42,0,-24
-42.06163,-20.69301,60,34,5,-26
-42.05893,-20.69301,55,36,5,-19
-42.05601,-20.69301,55,38,5,-17
-42.05331,-20.69301,54,41,5,-13
-42.05061,-20.69301,55,37,5,-18
-42.04769,-20.69301,68,45,5,-23
-42.045,-20.69301,68,38,5,-30
-42.0423,-20.69301,52,41,5,-11
-42.03938,-20.69301,50,38,5,-12
-42.03668,-20.69301,47,35,5,-12
-42.03399,-20.69301,52,48,5,-4
-42.03106,-20.69301,50,47,5,-3
-42.02837,-20.69301,58,37,0,-21
-42.02545,-20.69301,55,40,0,-15
-42.02275,-20.69301,51,48,0,-3
-42.02005,-20.69301,50,40,5,-10
-42.01713,-20.69301,48,41,0,-7
-42.01444,-20.69301,57,46,5,-11
-42.01174,-20.69301,53,44,0,-9
-42.00882,-20.69301,58,41,0,-17
-42.00612,-20.69301,55,37,0,-18
-42.00342,-20.69301,53,31,5,-22
-42.0005,-20.69301,64,33,5,-31
-41.99781,-20.69301,68,34,0,-34
-41.99511,-20.69301,68,31,5,-37
-41.99219,-20.69301,55,34,5,-21
-41.98949,-20.69301,55,33,0,-22
-41.98657,-20.69301,49,35,0,-14
-41.98387,-20.69301,57,30,5,-27
-41.98118,-20.69301,52,44,5,-8
-41.97826,-20.69301,64,30,5,-34
-41.97556,-20.69301,51,30,5,-21
-41.97286,-20.69301,50,31,5,-19
-41.96994,-20.69301,63,29,5,-34
-42.10297,-20.6928,61,34,5,-27
-42.10275,-20.6928,63,34,0,-29
-42.10252,-20.6928,61,34,0,-27
-42.1023,-20.6928,61,33,0,-28
-42.10185,-20.6928,61,33,0,-28
-42.10163,-20.6928,61,34,0,-27
-42.1014,-20.6928,61,34,0,-27
-42.10118,-20.6928,62,34,0,-28
-42.10073,-20.6928,62,34,0,-28
-42.1005,-20.6928,62,33,0,-29
-42.10028,-20.6928,62,33,0,-29
-42.10005,-20.6928,63,33,0,-30
-42.09983,-20.6928,63,34,0,-29
-42.09938,-20.6928,63,34,0,-29
-42.09915,-20.6928,64,35,0,-29
-42.09893,-20.6928,65,35,0,-30
-42.0987,-20.6928,67,40,0,-27
-42.09825,-20.6928,67,42,0,-25
-42.09803,-20.6928,68,42,0,-26
-42.0978,-20.6928,67,42,0,-25
-42.09758,-20.6928,67,42,0,-25
-42.09713,-20.6928,67,42,0,-25
-42.09691,-20.6928,68,39,0,-29
-42.09668,-20.6928,68,36,6,-32
-42.09646,-20.6928,69,36,0,-33
-42.09601,-20.6928,70,35,0,-35
-42.09578,-20.6928,73,35,0,-38
-42.09556,-20.6928,71,37,0,-34
-42.09533,-20.6928,69,42,0,-27
-42.09511,-20.6928,66,42,0,-24
-42.09466,-20.6928,65,42,0,-23
-42.09443,-20.6928,65,42,0,-23
-42.09421,-20.6928,67,42,0,-25
-42.09398,-20.6928,67,42,5,-25
-42.09354,-20.6928,65,38,5,-27
-42.09331,-20.6928,64,38,5,-26
-42.09309,-20.6928,61,38,6,-23
-42.09286,-20.6928,62,38,5,-24
-42.09241,-20.6928,63,36,5,-27
-42.09219,-20.6928,63,38,5,-25
-42.09196,-20.6928,63,36,6,-27
-42.09174,-20.6928,64,36,5,-28
-42.09129,-20.6928,64,32,5,-32
-42.09106,-20.6928,64,32,5,-32
-42.09084,-20.6928,64,32,5,-32
-42.09061,-20.6928,64,33,5,-31
-42.09039,-20.6928,64,32,5,-32
-42.08994,-20.6928,65,36,5,-29
-42.08972,-20.6928,64,35,5,-29
-42.08949,-20.6928,64,37,5,-27
-42.08927,-20.6928,64,42,5,-22
-42.08882,-20.6928,65,42,0,-23
-42.08859,-20.6928,65,41,0,-24
-42.08837,-20.6928,66,40,0,-26
-42.08814,-20.6928,64,38,5,-26
-42.08769,-20.6928,64,33,5,-31
-42.08747,-20.6928,63,33,5,-30
-42.08724,-20.6928,62,33,5,-29
-42.08702,-20.6928,63,33,5,-30
-42.08657,-20.6928,65,33,5,-32
-42.08634,-20.6928,66,33,5,-33
-42.08612,-20.6928,67,32,5,-35
-42.08589,-20.6928,66,33,5,-33
-42.08545,-20.6928,64,33,5,-31
-42.08522,-20.6928,62,33,5,-29
-42.085,-20.6928,62,34,5,-28
-42.08477,-20.6928,64,38,5,-26
-42.08455,-20.6928,67,45,5,-22
-42.0841,-20.6928,67,45,0,-22
-42.08387,-20.6928,66,45,0,-21
-42.08365,-20.6928,67,44,0,-23
-42.08342,-20.6928,66,44,0,-22
-42.08297,-20.6928,65,39,5,-26
-42.08275,-20.6928,59,37,5,-22
-42.08252,-20.6928,59,36,5,-23
-42.0823,-20.6928,59,36,5,-23
-42.08185,-20.6928,59,36,5,-23
-42.08163,-20.6928,59,35,5,-24
-42.0814,-20.6928,59,35,5,-24
-42.08118,-20.6928,59,33,5,-26
-42.08073,-20.6928,59,33,5,-26
-42.0805,-20.6928,60,34,5,-26
-42.08028,-20.6928,60,34,11,-26
-42.08005,-20.6928,60,34,5,-26
-42.07983,-20.6928,60,34,5,-26
-42.07938,-20.6928,60,37,5,-23
-42.07915,-20.6928,60,39,5,-21
-42.07893,-20.6928,60,39,5,-21
-42.0787,-20.6928,60,40,5,-20
-42.07825,-20.6928,60,39,5,-21
-42.07803,-20.6928,60,38,5,-22
-42.07781,-20.6928,60,38,5,-22
-42.07758,-20.6928,60,34,5,-26
-42.07713,-20.6928,61,33,5,-28
-42.07691,-20.6928,61,33,5,-28
-42.07668,-20.6928,61,34,5,-27
-42.07646,-20.6928,61,34,5,-27
-42.07601,-20.6928,61,34,5,-27
-42.07578,-20.6928,61,34,5,-27
-42.07556,-20.6928,61,34,5,-27
-42.07533,-20.6928,61,35,5,-26
-42.07511,-20.6928,61,35,5,-26
-42.07466,-20.6928,61,35,5,-26
-42.07443,-20.6928,61,36,5,-25
-42.07421,-20.6928,61,36,5,-25
-42.07399,-20.6928,61,36,5,-25
-42.07354,-20.6928,61,36,5,-25
-42.07331,-20.6928,61,37,5,-24
-42.07309,-20.6928,61,39,5,-22
-42.07286,-20.6928,61,39,5,-22
-42.07241,-20.6928,60,44,5,-16
-42.07219,-20.6928,60,46,5,-14
-42.07196,-20.6928,60,44,5,-16
-42.07174,-20.6928,60,44,5,-16
-42.07129,-20.6928,60,45,5,-15
-42.07106,-20.6928,60,45,0,-15
-42.07084,-20.6928,60,45,0,-15
-42.07061,-20.6928,60,44,0,-16
-42.07039,-20.6928,61,44,0,-17
-42.06994,-20.6928,61,44,0,-17
-42.06972,-20.6928,61,44,0,-17
-42.06949,-20.6928,61,44,0,-17
-42.06927,-20.6928,61,44,0,-17
-42.06882,-20.6928,60,43,0,-17
-42.06859,-20.6928,60,43,0,-17
-42.06837,-20.6928,61,43,0,-18
-42.06814,-20.6928,63,43,0,-20
-42.06769,-20.6928,63,43,0,-20
-42.06747,-20.6928,64,43,0,-21
-42.06724,-20.6928,64,43,0,-21
-42.06702,-20.6928,64,43,0,-21
-42.06657,-20.6928,66,43,0,-23
-42.06634,-20.6928,64,43,0,-21
-42.06612,-20.6928,63,43,0,-20
-42.0659,-20.6928,63,43,0,-20
-42.06545,-20.6928,64,42,0,-22
-42.06522,-20.6928,66,42,0,-24
-42.065,-20.6928,67,42,0,-25
-42.06477,-20.6928,65,42,0,-23
-42.06455,-20.6928,66,42,0,-24
-42.0641,-20.6928,66,41,5,-25
-42.06387,-20.6928,64,41,11,-23
-42.06365,-20.6928,64,40,5,-24
-42.06342,-20.6928,63,41,5,-22
-42.06297,-20.6928,62,41,5,-21
-42.06275,-20.6928,64,41,5,-23
-42.06252,-20.6928,62,41,5,-21
-42.0623,-20.6928,63,40,5,-23
-42.06185,-20.6928,62,39,5,-23
-42.06163,-20.6928,61,35,5,-26
-42.0614,-20.6928,62,35,5,-27
-42.06118,-20.6928,61,35,5,-26
-42.06073,-20.6928,58,37,5,-21
-42.0605,-20.6928,57,40,5,-17
-42.06028,-20.6928,55,36,5,-19
-42.06005,-20.6928,54,35,5,-19
-42.05983,-20.6928,55,35,5,-20
-42.05938,-20.6928,55,36,5,-19
-42.05915,-20.6928,55,36,5,-19
-42.05893,-20.6928,55,36,5,-19
-42.0587,-20.6928,55,36,5,-19
-42.05826,-20.6928,55,36,5,-19
-42.05803,-20.6928,55,36,5,-19
-42.05781,-20.6928,55,37,5,-18
-42.05758,-20.6928,55,37,5,-18
-42.05713,-20.6928,55,36,5,-19
-42.05691,-20.6928,55,37,5,-18
-42.05668,-20.6928,55,38,5,-17
-42.05646,-20.6928,55,38,5,-17
-42.05601,-20.6928,55,38,5,-17
-42.05578,-20.6928,55,38,5,-17
-42.05556,-20.6928,55,46,5,-9
-42.05533,-20.6928,55,46,0,-9
-42.05511,-20.6928,55,46,0,-9
-42.05466,-20.6928,55,46,5,-9
-42.05443,-20.6928,54,46,5,-8
-42.05421,-20.6928,54,40,5,-14
-42.05399,-20.6928,54,37,5,-17
-42.05354,-20.6928,54,40,5,-14
-42.05331,-20.6928,54,41,6,-13
-42.05309,-20.6928,54,41,5,-13
-42.05286,-20.6928,54,41,5,-13
-42.05241,-20.6928,54,37,5,-17
-42.05219,-20.6928,55,38,5,-17
-42.05196,-20.6928,54,38,5,-16
-42.05174,-20.6928,54,39,5,-15
-42.05129,-20.6928,54,40,5,-14
-42.05106,-20.6928,54,37,5,-17
-42.05084,-20.6928,54,37,5,-17
-42.05061,-20.6928,55,35,5,-20
-42.05039,-20.6928,56,35,5,-21
-42.04994,-20.6928,63,36,5,-27
-42.04972,-20.6928,67,36,5,-31
-42.04949,-20.6928,68,39,5,-29
-42.04927,-20.6928,67,40,5,-27
-42.04882,-20.6928,67,41,5,-26
-42.04859,-20.6928,67,41,5,-26
-42.04837,-20.6928,60,43,5,-17
-42.04814,-20.6928,61,44,5,-17
-42.04769,-20.6928,63,44,5,-19
-42.04747,-20.6928,62,45,5,-17
-42.04724,-20.6928,69,46,5,-23
-42.04702,-20.6928,68,40,5,-28
-42.04657,-20.6928,69,39,5,-30
-42.04635,-20.6928,71,39,5,-32
-42.04612,-20.6928,70,39,5,-31
-42.0459,-20.6928,69,38,5,-31
-42.04545,-20.6928,69,38,5,-31
-42.04522,-20.6928,67,37,5,-30
-42.045,-20.6928,67,37,5,-30
-42.04477,-20.6928,64,38,5,-26
-42.04455,-20.6928,59,38,5,-21
-42.0441,-20.6928,57,38,5,-19
-42.04387,-20.6928,55,39,5,-16
-42.04365,-20.6928,55,40,5,-15
-42.04342,-20.6928,56,40,5,-16
-42.04297,-20.6928,56,41,5,-15
-42.04275,-20.6928,54,41,5,-13
-42.04253,-20.6928,53,40,5,-13
-42.0423,-20.6928,52,39,5,-13
-42.04185,-20.6928,55,39,5,-16
-42.04163,-20.6928,57,38,5,-19
-42.0414,-20.6928,57,38,5,-19
-42.04118,-20.6928,54,37,5,-17
-42.04073,-20.6928,54,38,5,-16
-42.0405,-20.6928,53,36,5,-17
-42.04028,-20.6928,53,39,5,-14
-42.04005,-20.6928,50,39,5,-11
-42.03983,-20.6928,49,39,5,-10
-42.03938,-20.6928,53,37,5,-16
-42.03915,-20.6928,54,46,5,-8
-42.03893,-20.6928,56,46,11,-10
-42.0387,-20.6928,54,46,5,-8
-42.03826,-20.6928,52,36,5,-16
-42.03803,-20.6928,51,35,5,-16
-42.03781,-20.6928,51,38,5,-13
-42.03758,-20.6928,48,39,0,-9
-42.03713,-20.6928,46,36,5,-10
-42.03691,-20.6928,47,36,5,-11
-42.03668,-20.6928,48,35,5,-13
-42.03646,-20.6928,48,36,5,-12
-42.03601,-20.6928,49,36,5,-13
-42.03578,-20.6928,48,37,5,-11
-42.03556,-20.6928,47,37,5,-10
-42.03533,-20.6928,47,37,5,-10
-42.03511,-20.6928,48,36,5,-12
-42.03466,-20.6928,48,38,5,-10
-42.03444,-20.6928,49,45,5,-4
-42.03421,-20.6928,50,43,5,-7
-42.03399,-20.6928,51,43,5,-8
-42.03354,-20.6928,51,44,5,-7
-42.03331,-20.6928,52,60,5,8
-42.03309,-20.6928,52,61,5,9
-42.03286,-20.6928,52,47,5,-5
-42.03241,-20.6928,50,44,5,-6
-42.03219,-20.6928,50,42,5,-8
-42.03196,-20.6928,50,40,5,-10
-42.03174,-20.6928,51,40,5,-11
-42.03129,-20.6928,50,47,5,-3
-42.03106,-20.6928,49,43,5,-6
-42.03084,-20.6928,50,41,5,-9
-42.03062,-20.6928,51,38,5,-13
-42.03017,-20.6928,52,37,5,-15
-42.02994,-20.6928,54,35,5,-19
-42.02972,-20.6928,54,35,5,-19
-42.02949,-20.6928,55,35,5,-20
-42.02927,-20.6928,57,34,5,-23
-42.02882,-20.6928,56,36,0,-20
-42.02859,-20.6928,59,37,5,-22
-42.02837,-20.6928,57,37,5,-20
-42.02814,-20.6928,55,37,5,-18
-42.02769,-20.6928,56,38,5,-18
-42.02747,-20.6928,55,38,0,-17
-42.02724,-20.6928,55,38,0,-17
-42.02702,-20.6928,55,38,0,-17
-42.02657,-20.6928,55,38,0,-17
-42.02635,-20.6928,55,39,0,-16
-42.02612,-20.6928,55,38,0,-17
-42.0259,-20.6928,55,39,0,-16
-42.02545,-20.6928,55,40,0,-15
-42.02522,-20.6928,54,41,0,-13
-42.025,-20.6928,54,42,0,-12
-42.02477,-20.6928,55,43,0,-12
-42.02455,-20.6928,54,45,0,-9
-42.0241,-20.6928,55,46,5,-9
-42.02387,-20.6928,56,47,5,-9
-42.02365,-20.6928,55,48,5,-7
-42.02342,-20.6928,54,48,11,-6
-42.02297,-20.6928,53,48,5,-5
-42.02275,-20.6928,52,48,5,-4
-42.02253,-20.6928,51,48,5,-3
-42.0223,-20.6928,50,48,5,-2
-42.02185,-20.6928,50,42,5,-8
-42.02163,-20.6928,50,40,5,-10
-42.0214,-20.6928,50,40,5,-10
-42.02118,-20.6928,50,42,5,-8
-42.02073,-20.6928,49,42,5,-7
-42.0205,-20.6928,49,44,5,-5
-42.02028,-20.6928,49,41,5,-8
-42.02005,-20.6928,49,38,5,-11
-42.01983,-20.6928,50,38,5,-12
-42.01938,-20.6928,50,40,5,-10
-42.01915,-20.6928,49,38,5,-11
-42.01893,-20.6928,50,36,5,-14
-42.01871,-20.6928,50,38,5,-12
-42.01826,-20.6928,49,42,0,-7
-42.01803,-20.6928,49,41,0,-8
-42.01781,-20.6928,49,41,0,-8
-42.01758,-20.6928,49,40,0,-9
-42.01713,-20.6928,48,40,0,-8
-42.01691,-20.6928,48,40,0,-8
-42.01668,-20.6928,51,40,0,-11
-42.01646,-20.6928,53,41,0,-12
-42.01601,-20.6928,53,46,0,-7
-42.01578,-20.6928,53,46,0,-7
-42.01556,-20.6928,54,46,0,-8
-42.01533,-20.6928,53,46,0,-7
-42.01511,-20.6928,53,46,11,-7
-42.01466,-20.6928,52,42,5,-10
-42.01444,-20.6928,53,40,5,-13
-42.01421,-20.6928,53,41,5,-12
-42.01399,-20.6928,54,45,5,-9
-42.01354,-20.6928,54,45,0,-9
-42.01331,-20.6928,54,45,0,-9
-42.01309,-20.6928,53,45,0,-8
-42.01286,-20.6928,55,44,0,-11
-42.01241,-20.6928,56,44,0,-12
-42.01219,-20.6928,55,44,0,-11
-42.01196,-20.6928,56,44,0,-12
-42.01174,-20.6928,55,44,11,-11
-42.01129,-20.6928,57,44,0,-13
-42.01106,-20.6928,56,44,0,-12
-42.01084,-20.6928,58,43,0,-15
-42.01062,-20.6928,57,43,0,-14
-42.01017,-20.6928,59,43,0,-16
-42.00994,-20.6928,61,43,0,-18
-42.00972,-20.6928,59,43,0,-16
-42.00949,-20.6928,61,43,0,-18
-42.00927,-20.6928,59,42,0,-17
-42.00882,-20.6928,60,41,0,-19
-42.00859,-20.6928,61,42,0,-19
-42.00837,-20.6928,60,41,0,-19
-42.00814,-20.6928,60,41,0,-19
-42.00769,-20.6928,59,41,0,-18
-42.00747,-20.6928,59,41,0,-18
-42.00724,-20.6928,58,41,0,-17
-42.00702,-20.6928,57,39,0,-18
-42.00657,-20.6928,54,38,0,-16
-42.00635,-20.6928,54,36,0,-18
-42.00612,-20.6928,54,36,0,-18
-42.0059,-20.6928,54,37,0,-17
-42.00545,-20.6928,55,35,0,-20
-42.00522,-20.6928,54,34,0,-20
-42.005,-20.6928,54,34,0,-20
-42.00477,-20.6928,54,34,0,-20
-42.00455,-20.6928,53,34,0,-19
-42.0041,-20.6928,53,33,0,-20
-42.00387,-20.6928,53,33,5,-20
-42.00365,-20.6928,53,32,5,-21
-42.00342,-20.6928,53,30,5,-23
-42.00298,-20.6928,58,32,5,-26
-42.00275,-20.6928,60,32,0,-28
-42.00253,-20.6928,62,32,0,-30
-42.0023,-20.6928,64,32,0,-32
-42.00185,-20.6928,64,32,0,-32
-42.00163,-20.6928,67,32,5,-35
-42.0014,-20.6928,68,31,5,-37
-42.00118,-20.6928,69,32,5,-37
-42.00073,-20.6928,66,33,11,-33
-42.0005,-20.6928,67,33,11,-34
-42.00028,-20.6928,68,33,5,-35
-42.00005,-20.6928,67,33,5,-34
-41.99983,-20.6928,68,34,5,-34
-41.99938,-20.6928,70,34,11,-36
-41.99916,-20.6928,70,34,11,-36
-41.99893,-20.6928,69,36,11,-33
-41.99871,-20.6928,69,34,11,-35
-41.99826,-20.6928,69,34,0,-35
-41.99803,-20.6928,69,34,0,-35
-41.99781,-20.6928,68,34,0,-34
-41.99758,-20.6928,68,34,0,-34
-41.99713,-20.6928,67,33,0,-34
-41.99691,-20.6928,66,33,11,-33
-41.99668,-20.6928,66,33,11,-33
-41.99646,-20.6928,66,33,5,-33
-41.99601,-20.6928,67,33,5,-34
-41.99578,-20.6928,66,33,5,-33
-41.99556,-20.6928,67,33,5,-34
-41.99533,-20.6928,68,31,5,-37
-41.99511,-20.6928,67,31,5,-36
-41.99466,-20.6928,68,35,0,-33
-41.99444,-20.6928,68,36,11,-32
-41.99421,-20.6928,68,36,11,-32
-41.99399,-20.6928,68,37,0,-31
-41.99354,-20.6928,65,39,0,-26
-41.99331,-20.6928,64,39,0,-25
-41.99309,-20.6928,63,39,0,-24
-41.99286,-20.6928,61,36,0,-25
-41.99241,-20.6928,59,34,11,-25
-41.99219,-20.6928,55,32,5,-23
-41.99196,-20.6928,54,32,5,-22
-41.99174,-20.6928,54,32,5,-22
-41.99129,-20.6928,54,35,0,-19
-41.99107,-20.6928,54,35,0,-19
-41.99084,-20.6928,54,34,0,-20
-41.99062,-20.6928,66,34,0,-32
-41.99017,-20.6928,59,34,0,-25
-41.98994,-20.6928,56,33,0,-23
-41.98972,-20.6928,56,33,0,-23
-41.98949,-20.6928,55,33,0,-22
-41.98927,-20.6928,54,35,0,-19
-41.98882,-20.6928,53,36,0,-17
-41.98859,-20.6928,53,33,0,-20
-41.98837,-20.6928,53,33,0,-20
-41.98814,-20.6928,52,36,0,-16
-41.98769,-20.6928,51,36,0,-15
-41.98747,-20.6928,51,37,0,-14
-41.98725,-20.6928,49,37,0,-12
-41.98702,-20.6928,49,37,0,-12
-41.98657,-20.6928,49,36,0,-13
-41.98635,-20.6928,49,36,0,-13
-41.98612,-20.6928,52,37,11,-15
-41.9859,-20.6928,50,36,0,-14
-41.98545,-20.6928,50,36,5,-14
-41.98522,-20.6928,65,34,5,-31
-41.985,-20.6928,56,29,5,-27
-41.98477,-20.6928,53,29,5,-24
-41.98455,-20.6928,63,29,5,-34
-41.9841,-20.6928,53,30,5,-23
-41.98387,-20.6928,57,30,5,-27
-41.98365,-20.6928,58,30,5,-28
-41.98343,-20.6928,53,31,5,-22
-41.98298,-20.6928,53,39,5,-14
-41.98275,-20.6928,53,41,5,-12
-41.98253,-20.6928,53,41,0,-12
-41.9823,-20.6928,53,42,0,-11
-41.98185,-20.6928,51,44,0,-7
-41.98163,-20.6928,52,44,0,-8
-41.9814,-20.6928,52,44,0,-8
-41.98118,-20.6928,52,44,0,-8
-41.98073,-20.6928,52,44,0,-8
-41.9805,-20.6928,52,44,5,-8
-41.98028,-20.6928,52,44,5,-8
-41.98005,-20.6928,52,39,5,-13
-41.97983,-20.6928,59,34,5,-25
-41.97938,-20.6928,52,32,5,-20
-41.97916,-20.6928,52,30,5,-22
-41.97893,-20.6928,52,30,5,-22
-41.97871,-20.6928,52,30,5,-22
-41.97826,-20.6928,62,30,5,-32
-41.97803,-20.6928,62,30,5,-32
-41.97781,-20.6928,65,31,5,-34
-41.97758,-20.6928,65,31,5,-34
-41.97713,-20.6928,54,32,5,-22
-41.97691,-20.6928,54,31,5,-23
-41.97668,-20.6928,52,31,5,-21
-41.97646,-20.6928,51,31,5,-20
-41.97601,-20.6928,51,31,5,-20
-41.97578,-20.6928,51,29,5,-22
-41.97556,-20.6928,51,29,5,-22
-41.97534,-20.6928,51,29,5,-22
-41.97511,-20.6928,50,30,5,-20
-41.97466,-20.6928,50,29,5,-21
-41.97444,-20.6928,50,29,5,-21
-41.97421,-20.6928,50,28,5,-22
-41.97399,-20.6928,50,29,5,-21
-41.97354,-20.6928,50,29,5,-21
-41.97331,-20.6928,50,31,0,-19
-41.97309,-20.6928,55,31,0,-24
-41.97286,-20.6928,57,31,5,-26
-41.97241,-20.6928,60,31,5,-29
-41.97219,-20.6928,61,33,5,-28
-41.97196,-20.6928,63,33,5,-30
-41.97174,-20.6928,63,36,5,-27
-41.97129,-20.6928,62,35,5,-27
-41.97107,-20.6928,62,36,5,-26
-41.97084,-20.6928,63,33,5,-30
-41.97062,-20.6928,62,31,5,-31
-41.97017,-20.6928,67,30,5,-37
-41.96994,-20.6928,65,29,5,-36
-41.96972,-20.6928,65,29,5,-36
-41.96949,-20.6928,70,31,5,-39
-41.96927,-20.6928,67,32,5,-35
-42.1005,-20.69259,62,33,0,-29
-42.0978,-20.69259,67,42,0,-25
-42.09511,-20.69259,65,42,0,-23
-42.09219,-20.69259,63,38,6,-25
-42.08949,-20.69259,64,42,5,-22
-42.08657,-20.69259,64,34,5,-30
-42.08387,-20.69259,66,44,5,-22
-42.08118,-20.69259,59,33,5,-26
-42.07825,-20.69259,60,40,5,-20
-42.07556,-20.69259,61,35,5,-26
-42.07286,-20.69259,61,43,5,-18
-42.06994,-20.69259,61,44,0,-17
-42.06724,-20.69259,64,43,0,-21
-42.06455,-20.69259,66,42,5,-24
-42.06163,-20.69259,63,39,5,-24
-42.05893,-20.69259,54,36,5,-18
-42.05601,-20.69259,54,38,5,-16
-42.05331,-20.69259,54,40,5,-14
-42.05061,-20.69259,56,35,5,-21
-42.04769,-20.69259,62,39,5,-23
-42.045,-20.69259,66,40,5,-26
-42.0423,-20.69259,52,38,5,-14
-42.03938,-20.69259,52,40,5,-12
-42.03668,-20.69259,48,36,5,-12
-42.03399,-20.69259,51,60,5,9
-42.03106,-20.69259,49,39,5,-10
-42.02837,-20.69259,56,37,5,-19
-42.02545,-20.69259,55,41,0,-14
-42.02275,-20.69259,52,48,5,-4
-42.02005,-20.69259,49,43,5,-6
-42.01713,-20.69259,49,39,0,-10
-42.01444,-20.69259,51,36,5,-15
-42.01174,-20.69259,55,44,0,-11
-42.00882,-20.69259,60,42,0,-18
-42.00612,-20.69259,53,37,0,-16
-42.00342,-20.69259,55,32,0,-23
-42.0005,-20.69259,64,33,5,-31
-41.99781,-20.69259,67,34,11,-33
-41.99511,-20.69259,67,31,5,-36
-41.99219,-20.69259,57,34,5,-23
-41.98949,-20.69259,55,35,0,-20
-41.98657,-20.69259,49,38,0,-11
-41.98387,-20.69259,58,30,5,-28
-41.98118,-20.69259,52,44,5,-8
-41.97826,-20.69259,57,30,5,-27
-41.97556,-20.69259,51,29,5,-22
-41.97286,-20.69259,63,31,5,-32
-41.96994,-20.69259,65,30,5,-35
-42.1005,-20.69217,62,34,0,-28
-42.0978,-20.69217,68,42,0,-26
-42.09511,-20.69217,65,37,0,-28
-42.09219,-20.69217,63,41,6,-22
-42.08949,-20.69217,63,37,5,-26
-42.08657,-20.69217,63,35,5,-28
-42.08387,-20.69217,66,44,5,-22
-42.08118,-20.69217,59,33,5,-26
-42.07825,-20.69217,60,40,5,-20
-42.07556,-20.69217,61,36,5,-25
-42.07286,-20.69217,63,40,5,-23
-42.06994,-20.69217,60,44,0,-16
-42.06724,-20.69217,64,43,0,-21
-42.06455,-20.69217,65,36,5,-29
-42.06163,-20.69217,62,39,5,-23
-42.05893,-20.69217,54,36,5,-18
-42.05601,-20.69217,54,36,5,-18
-42.05331,-20.69217,54,36,5,-18
-42.05061,-20.69217,55,35,5,-20
-42.04769,-20.69217,60,35,5,-25
-42.045,-20.69217,63,44,0,-19
-42.0423,-20.69217,51,38,5,-13
-42.03938,-20.69217,52,40,5,-12
-42.03668,-20.69217,48,40,0,-8
-42.03399,-20.69217,50,36,5,-14
-42.03106,-20.69217,50,39,5,-11
-42.02837,-20.69217,55,36,5,-19
-42.02545,-20.69217,55,41,0,-14
-42.02275,-20.69217,51,43,5,-8
-42.02005,-20.69217,49,46,0,-3
-42.01713,-20.69217,48,39,0,-9
-42.01444,-20.69217,51,39,5,-12
-42.01174,-20.69217,57,44,0,-13
-42.00882,-20.69217,60,42,11,-18
-42.00612,-20.69217,52,36,0,-16
-42.00342,-20.69217,60,31,5,-29
-42.0005,-20.69217,63,31,5,-32
-41.99781,-20.69217,65,31,5,-34
-41.99511,-20.69217,66,31,5,-35
-41.99219,-20.69217,60,29,5,-31
-41.98949,-20.69217,55,38,0,-17
-41.98657,-20.69217,49,40,0,-9
-41.98387,-20.69217,64,30,5,-34
-41.98118,-20.69217,52,44,5,-8
-41.97826,-20.69217,65,29,5,-36
-41.97556,-20.69217,51,28,5,-23
-41.97286,-20.69217,64,31,5,-33
-41.96994,-20.69217,66,32,5,-34
-42.1005,-20.69195,62,34,0,-28
-42.0978,-20.69195,69,40,0,-29
-42.09511,-20.69195,68,37,0,-31
-42.09219,-20.69195,63,40,5,-23
-42.08949,-20.69195,62,37,5,-25
-42.08657,-20.69195,62,35,5,-27
-42.08387,-20.69195,68,43,5,-25
-42.08118,-20.69195,59,32,5,-27
-42.07825,-20.69195,60,39,5,-21
-42.07556,-20.69195,61,35,5,-26
-42.07286,-20.69195,65,40,5,-25
-42.06994,-20.69195,60,44,0,-16
-42.06724,-20.69195,65,43,0,-22
-42.06455,-20.69195,65,36,5,-29
-42.06163,-20.69195,66,39,5,-27
-42.05893,-20.69195,54,36,5,-18
-42.05601,-20.69195,54,36,5,-18
-42.05331,-20.69195,54,36,5,-18
-42.05061,-20.69195,57,35,5,-22
-42.04769,-20.69195,62,35,5,-27
-42.045,-20.69195,57,49,0,-8
-42.0423,-20.69195,54,36,5,-18
-42.03938,-20.69195,55,41,5,-14
-42.03668,-20.69195,55,40,0,-15
-42.03399,-20.69195,49,37,5,-12
-42.03106,-20.69195,50,36,5,-14
-42.02837,-20.69195,54,35,5,-19
-42.02545,-20.69195,56,41,0,-15
-42.02275,-20.69195,51,41,5,-10
-42.02005,-20.69195,49,48,0,-1
-42.01713,-20.69195,48,40,0,-8
-42.01444,-20.69195,55,44,5,-11
-42.01174,-20.69195,58,45,0,-13
-42.00882,-20.69195,59,42,0,-17
-42.00612,-20.69195,51,38,0,-13
-42.00342,-20.69195,62,33,5,-29
-42.0005,-20.69195,61,32,5,-29
-41.99781,-20.69195,62,34,5,-28
-41.99511,-20.69195,66,31,5,-35
-41.99219,-20.69195,61,31,5,-30
-41.98949,-20.69195,54,38,0,-16
-41.98657,-20.69195,49,40,0,-9
-41.98387,-20.69195,62,39,5,-23
-41.98118,-20.69195,51,44,5,-7
-41.97826,-20.69195,66,30,5,-36
-41.97556,-20.69195,51,28,5,-23
-41.97286,-20.69195,67,32,5,-35
-41.96994,-20.69195,68,33,0,-35
-42.1005,-20.69174,62,34,6,-28
-42.0978,-20.69174,69,40,0,-29
-42.09511,-20.69174,68,34,11,-34
-42.09219,-20.69174,63,35,5,-28
-42.08949,-20.69174,62,37,5,-25
-42.08657,-20.69174,62,38,5,-24
-42.08387,-20.69174,66,43,5,-23
-42.08118,-20.69174,59,32,5,-27
-42.07825,-20.69174,60,39,5,-21
-42.07556,-20.69174,61,36,5,-25
-42.07286,-20.69174,64,41,5,-23
-42.06994,-20.69174,60,44,0,-16
-42.06724,-20.69174,63,44,0,-19
-42.06455,-20.69174,66,38,5,-28
-42.06163,-20.69174,65,37,5,-28
-42.05893,-20.69174,54,35,5,-19
-42.05601,-20.69174,54,36,5,-18
-42.05331,-20.69174,54,38,5,-16
-42.05061,-20.69174,56,35,5,-21
-42.04769,-20.69174,64,38,5,-26
-42.045,-20.69174,54,47,0,-7
-42.0423,-20.69174,55,35,5,-20
-42.03938,-20.69174,55,49,0,-6
-42.03668,-20.69174,54,41,0,-13
-42.03399,-20.69174,49,37,5,-12
-42.03106,-20.69174,50,35,5,-15
-42.02837,-20.69174,53,36,5,-17
-42.02545,-20.69174,55,41,0,-14
-42.02275,-20.69174,51,40,5,-11
-42.02005,-20.69174,49,48,0,-1
-42.01713,-20.69174,47,40,0,-7
-42.01444,-20.69174,51,42,5,-9
-42.01174,-20.69174,56,45,0,-11
-42.00882,-20.69174,59,43,0,-16
-42.00612,-20.69174,49,39,0,-10
-42.00342,-20.69174,62,36,5,-26
-42.0005,-20.69174,60,33,5,-27
-41.99781,-20.69174,59,35,5,-24
-41.99511,-20.69174,65,31,5,-34
-41.99219,-20.69174,62,34,5,-28
-41.98949,-20.69174,54,40,0,-14
-41.98657,-20.69174,49,41,0,-8
-41.98387,-20.69174,63,40,0,-23
-41.98118,-20.69174,52,35,5,-17
-41.97826,-20.69174,52,32,5,-20
-41.97556,-20.69174,51,28,5,-23
-41.97286,-20.69174,65,31,5,-34
-41.96994,-20.69174,66,34,0,-32
-42.1005,-20.69132,63,37,6,-26
-42.0978,-20.69132,68,35,0,-33
-42.09511,-20.69132,70,34,11,-36
-42.09219,-20.69132,63,39,5,-24
-42.08949,-20.69132,60,35,5,-25
-42.08657,-20.69132,62,39,5,-23
-42.08387,-20.69132,67,44,5,-23
-42.08118,-20.69132,60,32,5,-28
-42.07825,-20.69132,60,39,5,-21
-42.07556,-20.69132,61,36,5,-25
-42.07286,-20.69132,62,38,5,-24
-42.06994,-20.69132,60,44,0,-16
-42.06724,-20.69132,63,44,0,-19
-42.06455,-20.69132,64,42,0,-22
-42.06163,-20.69132,64,42,0,-22
-42.05893,-20.69132,60,39,5,-21
-42.05601,-20.69132,54,36,5,-18
-42.05331,-20.69132,54,42,5,-12
-42.05061,-20.69132,56,35,5,-21
-42.04769,-20.69132,61,38,0,-23
-42.045,-20.69132,54,38,0,-16
-42.0423,-20.69132,55,37,5,-18
-42.03938,-20.69132,55,50,0,-5
-42.03668,-20.69132,54,41,0,-13
-42.03399,-20.69132,48,37,5,-11
-42.03106,-20.69132,50,34,5,-16
-42.02837,-20.69132,53,38,0,-15
-42.02545,-20.69132,55,42,0,-13
-42.02275,-20.69132,51,40,5,-11
-42.02005,-20.69132,49,44,0,-5
-42.01713,-20.69132,46,39,5,-7
-42.01444,-20.69132,50,47,11,-3
-42.01174,-20.69132,55,45,0,-10
-42.00882,-20.69132,58,44,0,-14
-42.00612,-20.69132,49,40,0,-9
-42.00342,-20.69132,64,39,5,-25
-42.0005,-20.69132,58,35,5,-23
-41.99781,-20.69132,57,40,5,-17
-41.99511,-20.69132,64,32,5,-32
-41.99219,-20.69132,63,40,0,-23
-41.98949,-20.69132,63,40,0,-23
-41.98657,-20.69132,48,41,0,-7
-41.98387,-20.69132,65,41,0,-24
-41.98118,-20.69132,52,35,5,-17
-41.97826,-20.69132,52,31,5,-21
-41.97556,-20.69132,51,28,5,-23
-41.97286,-20.69132,66,31,5,-35
-41.96994,-20.69132,66,33,5,-33
-42.1005,-20.69111,64,39,6,-25
-42.0978,-20.69111,68,38,5,-30
-42.09511,-20.69111,72,34,0,-38
-42.09219,-20.69111,62,36,5,-26
-42.08949,-20.69111,60,35,5,-25
-42.08657,-20.69111,62,38,5,-24
-42.08387,-20.69111,67,43,5,-24
-42.08118,-20.69111,60,32,5,-28
-42.07825,-20.69111,60,37,5,-23
-42.07556,-20.69111,61,35,5,-26
-42.07286,-20.69111,61,38,5,-23
-42.06994,-20.69111,60,44,0,-16
-42.06724,-20.69111,63,43,0,-20
-42.06455,-20.69111,64,42,0,-22
-42.06163,-20.69111,64,43,11,-21
-42.05893,-20.69111,63,39,6,-24
-42.05601,-20.69111,54,36,5,-18
-42.05331,-20.69111,54,42,5,-12
-42.05061,-20.69111,55,36,5,-19
-42.04769,-20.69111,60,39,0,-21
-42.045,-20.69111,54,39,0,-15
-42.0423,-20.69111,57,38,0,-19
-42.03938,-20.69111,55,49,0,-6
-42.03668,-20.69111,55,41,0,-14
-42.03399,-20.69111,48,35,5,-13
-42.03106,-20.69111,50,34,5,-16
-42.02837,-20.69111,53,38,0,-15
-42.02545,-20.69111,55,41,0,-14
-42.02275,-20.69111,50,48,5,-2
-42.02005,-20.69111,49,42,0,-7
-42.01713,-20.69111,45,39,5,-6
-42.01444,-20.69111,49,43,0,-6
-42.01174,-20.69111,54,45,0,-9
-42.00882,-20.69111,57,44,0,-13
-42.00612,-20.69111,52,41,0,-11
-42.00342,-20.69111,63,40,5,-23
-42.0005,-20.69111,55,35,5,-20
-41.99781,-20.69111,55,40,5,-15
-41.99511,-20.69111,66,33,5,-33
-41.99219,-20.69111,63,40,0,-23
-41.98949,-20.69111,67,40,0,-27
-41.98657,-20.69111,48,41,0,-7
-41.98387,-20.69111,64,41,0,-23
-41.98118,-20.69111,52,42,5,-10
-41.97826,-20.69111,52,37,5,-15
-41.97556,-20.69111,51,28,5,-23
-41.97286,-20.69111,66,31,5,-35
-41.96994,-20.69111,66,33,5,-33
-42.1005,-20.6909,64,39,6,-25
-42.0978,-20.6909,68,36,6,-32
-42.09511,-20.6909,73,34,0,-39
-42.09219,-20.6909,62,36,5,-26
-42.08949,-20.6909,59,35,5,-24
-42.08657,-20.6909,62,36,5,-26
-42.08387,-20.6909,67,43,5,-24
-42.08118,-20.6909,60,31,5,-29
-42.07825,-20.6909,60,36,5,-24
-42.07556,-20.6909,61,36,5,-25
-42.07286,-20.6909,60,38,5,-22
-42.06994,-20.6909,60,44,0,-16
-42.06724,-20.6909,65,43,0,-22
-42.06455,-20.6909,67,42,0,-25
-42.06163,-20.6909,66,43,0,-23
-42.05893,-20.6909,63,39,5,-24
-42.05601,-20.6909,60,35,5,-25
-42.05331,-20.6909,54,41,5,-13
-42.05061,-20.6909,56,36,5,-20
-42.04769,-20.6909,68,39,0,-29
-42.045,-20.6909,53,39,0,-14
-42.0423,-20.6909,58,39,0,-19
-42.03938,-20.6909,55,50,0,-5
-42.03668,-20.6909,54,41,0,-13
-42.03399,-20.6909,46,35,5,-11
-42.03106,-20.6909,50,36,5,-14
-42.02837,-20.6909,57,38,5,-19
-42.02545,-20.6909,55,41,0,-14
-42.02275,-20.6909,50,48,0,-2
-42.02005,-20.6909,49,47,0,-2
-42.01713,-20.6909,44,38,5,-6
-42.01444,-20.6909,48,44,0,-4
-42.01174,-20.6909,53,45,5,-8
-42.00882,-20.6909,57,44,11,-13
-42.00612,-20.6909,62,40,5,-22
-42.00342,-20.6909,60,39,5,-21
-42.0005,-20.6909,54,33,5,-21
-41.99781,-20.6909,56,38,5,-18
-41.99511,-20.6909,70,34,5,-36
-41.99219,-20.6909,63,40,0,-23
-41.98949,-20.6909,65,40,11,-25
-41.98657,-20.6909,48,41,11,-7
-41.98387,-20.6909,65,41,0,-24
-41.98118,-20.6909,57,42,0,-15
-41.97826,-20.6909,52,38,5,-14
-41.97556,-20.6909,51,31,5,-20
-41.97286,-20.6909,65,30,5,-35
-41.96994,-20.6909,66,33,5,-33
-42.1005,-20.69047,64,40,5,-24
-42.0978,-20.69047,68,38,5,-30
-42.09511,-20.69047,70,34,0,-36
-42.09219,-20.69047,61,36,5,-25
-42.08949,-20.69047,59,36,5,-23
-42.08657,-20.69047,61,38,5,-23
-42.08387,-20.69047,67,43,5,-24
-42.08118,-20.69047,60,34,5,-26
-42.07825,-20.69047,60,33,5,-27
-42.07556,-20.69047,61,38,5,-23
-42.07286,-20.69047,60,38,5,-22
-42.06994,-20.69047,60,44,0,-16
-42.06724,-20.69047,63,43,0,-20
-42.06455,-20.69047,68,43,0,-25
-42.06163,-20.69047,65,43,5,-22
-42.05893,-20.69047,63,37,5,-26
-42.05601,-20.69047,60,42,5,-18
-42.05331,-20.69047,56,43,5,-13
-42.05061,-20.69047,58,36,5,-22
-42.04769,-20.69047,62,36,0,-26
-42.045,-20.69047,54,38,0,-16
-42.0423,-20.69047,59,38,0,-21
-42.03938,-20.69047,55,50,0,-5
-42.03668,-20.69047,54,41,0,-13
-42.03399,-20.69047,44,35,5,-9
-42.03106,-20.69047,48,37,5,-11
-42.02837,-20.69047,54,35,5,-19
-42.02545,-20.69047,54,42,0,-12
-42.02275,-20.69047,51,48,0,-3
-42.02005,-20.69047,49,48,0,-1
-42.01713,-20.69047,43,43,5,0
-42.01444,-20.69047,46,46,0,0
-42.01174,-20.69047,51,38,5,-13
-42.00882,-20.69047,56,46,0,-10
-42.00612,-20.69047,60,39,5,-21
-42.00342,-20.69047,60,38,5,-22
-42.0005,-20.69047,52,32,5,-20
-41.99781,-20.69047,63,37,5,-26
-41.99511,-20.69047,70,36,5,-34
-41.99219,-20.69047,62,40,0,-22
-41.98949,-20.69047,65,37,0,-28
-41.98657,-20.69047,48,41,0,-7
-41.98387,-20.69047,64,41,0,-23
-41.98118,-20.69047,57,42,0,-15
-41.97826,-20.69047,51,34,5,-17
-41.97556,-20.69047,51,32,5,-19
-41.97286,-20.69047,64,28,5,-36
-41.96994,-20.69047,66,33,0,-33
-42.1005,-20.69026,65,39,5,-26
-42.0978,-20.69026,67,38,11,-29
-42.09511,-20.69026,70,35,0,-35
-42.09219,-20.69026,60,35,5,-25
-42.08949,-20.69026,60,36,5,-24
-42.08657,-20.69026,61,37,5,-24
-42.08387,-20.69026,67,38,5,-29
-42.08118,-20.69026,61,32,5,-29
-42.07825,-20.69026,60,32,5,-28
-42.07556,-20.69026,61,37,5,-24
-42.07286,-20.69026,60,38,5,-22
-42.06994,-20.69026,60,44,0,-16
-42.06724,-20.69026,63,43,0,-20
-42.06455,-20.69026,66,43,0,-23
-42.06163,-20.69026,65,43,5,-22
-42.05893,-20.69026,64,37,5,-27
-42.05601,-20.69026,60,42,6,-18
-42.05331,-20.69026,54,43,5,-11
-42.05061,-20.69026,57,35,5,-22
-42.04769,-20.69026,63,36,0,-27
-42.045,-20.69026,56,38,0,-18
-42.0423,-20.69026,58,38,0,-20
-42.03938,-20.69026,55,50,0,-5
-42.03668,-20.69026,54,41,0,-13
-42.03399,-20.69026,44,36,5,-8
-42.03106,-20.69026,47,37,5,-10
-42.02837,-20.69026,53,34,5,-19
-42.02545,-20.69026,54,42,0,-12
-42.02275,-20.69026,51,48,0,-3
-42.02005,-20.69026,49,47,0,-2
-42.01713,-20.69026,42,42,5,0
-42.01444,-20.69026,45,45,0,0
-42.01174,-20.69026,52,38,5,-14
-42.00882,-20.69026,55,46,0,-9
-42.00612,-20.69026,61,37,5,-24
-42.00342,-20.69026,60,35,5,-25
-42.0005,-20.69026,52,32,5,-20
-41.99781,-20.69026,63,36,5,-27
-41.99511,-20.69026,71,35,5,-36
-41.99219,-20.69026,60,40,0,-20
-41.98949,-20.69026,64,34,0,-30
-41.98657,-20.69026,47,41,0,-6
-41.98387,-20.69026,64,41,0,-23
-41.98118,-20.69026,56,43,0,-13
-41.97826,-20.69026,51,37,5,-14
-41.97556,-20.69026,51,32,5,-19
-41.97286,-20.69026,64,27,5,-37
-41.96994,-20.69026,66,34,0,-32
-42.10297,-20.69005,62,41,0,-21
-42.10275,-20.69005,62,41,0,-21
-42.10252,-20.69005,63,41,0,-22
-42.1023,-20.69005,63,41,0,-22
-42.10185,-20.69005,66,41,0,-25
-42.10163,-20.69005,67,41,0,-26
-42.1014,-20.69005,64,41,5,-23
-42.10118,-20.69005,64,35,5,-29
-42.10073,-20.69005,65,37,6,-28
-42.1005,-20.69005,65,35,5,-30
-42.10028,-20.69005,65,39,5,-26
-42.10005,-20.69005,66,39,5,-27
-42.09983,-20.69005,66,38,5,-28
-42.09938,-20.69005,66,38,11,-28
-42.09915,-20.69005,67,39,5,-28
-42.09893,-20.69005,68,39,11,-29
-42.0987,-20.69005,68,39,11,-29
-42.09825,-20.69005,68,39,11,-29
-42.09803,-20.69005,67,39,5,-28
-42.0978,-20.69005,66,38,5,-28
-42.09758,-20.69005,68,38,5,-30
-42.09713,-20.69005,66,38,11,-28
-42.09691,-20.69005,66,37,11,-29
-42.09668,-20.69005,66,35,11,-31
-42.09646,-20.69005,66,35,0,-31
-42.09601,-20.69005,67,34,1,-33
-42.09578,-20.69005,68,34,1,-34
-42.09556,-20.69005,68,34,11,-34
-42.09533,-20.69005,69,34,0,-35
-42.09511,-20.69005,69,34,0,-35
-42.09466,-20.69005,70,36,0,-34
-42.09443,-20.69005,71,38,0,-33
-42.09421,-20.69005,71,38,0,-33
-42.09398,-20.69005,67,38,0,-29
-42.09354,-20.69005,62,40,0,-22
-42.09331,-20.69005,62,40,0,-22
-42.09309,-20.69005,67,37,0,-30
-42.09286,-20.69005,60,36,5,-24
-42.09241,-20.69005,59,34,5,-25
-42.09219,-20.69005,59,35,5,-24
-42.09196,-20.69005,59,32,5,-27
-42.09174,-20.69005,59,32,5,-27
-42.09129,-20.69005,59,32,5,-27
-42.09106,-20.69005,59,33,5,-26
-42.09084,-20.69005,59,33,5,-26
-42.09061,-20.69005,59,33,5,-26
-42.09039,-20.69005,63,33,5,-30
-42.08994,-20.69005,63,33,5,-30
-42.08972,-20.69005,60,34,5,-26
-42.08949,-20.69005,60,36,5,-24
-42.08927,-20.69005,60,36,5,-24
-42.08882,-20.69005,60,37,5,-23
-42.08859,-20.69005,61,36,5,-25
-42.08837,-20.69005,61,37,5,-24
-42.08814,-20.69005,61,36,5,-25
-42.08769,-20.69005,62,36,5,-26
-42.08747,-20.69005,63,34,5,-29
-42.08724,-20.69005,65,34,5,-31
-42.08702,-20.69005,65,36,5,-29
-42.08657,-20.69005,61,35,5,-26
-42.08634,-20.69005,62,38,5,-24
-42.08612,-20.69005,62,38,5,-24
-42.08589,-20.69005,62,37,5,-25
-42.08545,-20.69005,63,38,5,-25
-42.08522,-20.69005,63,39,5,-24
-42.085,-20.69005,64,40,5,-24
-42.08477,-20.69005,65,37,5,-28
-42.08455,-20.69005,66,37,5,-29
-42.0841,-20.69005,66,37,5,-29
-42.08387,-20.69005,67,38,5,-29
-42.08365,-20.69005,68,40,5,-28
-42.08342,-20.69005,68,41,5,-27
-42.08297,-20.69005,69,42,5,-27
-42.08275,-20.69005,69,42,5,-27
-42.08252,-20.69005,71,41,5,-30
-42.0823,-20.69005,68,41,5,-27
-42.08185,-20.69005,66,40,5,-26
-42.08163,-20.69005,67,38,5,-29
-42.0814,-20.69005,68,36,5,-32
-42.08118,-20.69005,66,32,5,-34
-42.08073,-20.69005,60,31,5,-29
-42.0805,-20.69005,60,32,5,-28
-42.08028,-20.69005,60,32,5,-28
-42.08005,-20.69005,60,34,5,-26
-42.07983,-20.69005,60,34,5,-26
-42.07938,-20.69005,60,35,11,-25
-42.07915,-20.69005,60,34,5,-26
-42.07893,-20.69005,60,33,5,-27
-42.0787,-20.69005,60,33,5,-27
-42.07825,-20.69005,60,32,5,-28
-42.07803,-20.69005,60,34,5,-26
-42.07781,-20.69005,60,34,5,-26
-42.07758,-20.69005,60,34,5,-26
-42.07713,-20.69005,60,36,5,-24
-42.07691,-20.69005,60,36,5,-24
-42.07668,-20.69005,60,37,5,-23
-42.07646,-20.69005,60,37,5,-23
-42.07601,-20.69005,60,37,5,-23
-42.07578,-20.69005,60,38,5,-22
-42.07556,-20.69005,60,38,5,-22
-42.07533,-20.69005,60,37,5,-23
-42.07511,-20.69005,60,39,5,-21
-42.07466,-20.69005,60,37,5,-23
-42.07443,-20.69005,60,36,5,-24
-42.07421,-20.69005,60,37,5,-23
-42.07399,-20.69005,60,37,5,-23
-42.07354,-20.69005,60,38,5,-22
-42.07331,-20.69005,60,38,5,-22
-42.07309,-20.69005,60,39,5,-21
-42.07286,-20.69005,60,38,5,-22
-42.07241,-20.69005,60,39,5,-21
-42.07219,-20.69005,60,39,5,-21
-42.07196,-20.69005,60,39,5,-21
-42.07174,-20.69005,60,37,5,-23
-42.07129,-20.69005,60,38,5,-22
-42.07106,-20.69005,60,38,5,-22
-42.07084,-20.69005,60,37,5,-23
-42.07061,-20.69005,60,40,5,-20
-42.07039,-20.69005,60,43,5,-17
-42.06994,-20.69005,60,44,0,-16
-42.06972,-20.69005,60,44,0,-16
-42.06949,-20.69005,60,43,0,-17
-42.06927,-20.69005,60,44,0,-16
-42.06882,-20.69005,61,44,0,-17
-42.06859,-20.69005,61,44,0,-17
-42.06837,-20.69005,62,44,0,-18
-42.06814,-20.69005,62,44,5,-18
-42.06769,-20.69005,63,42,5,-21
-42.06747,-20.69005,63,43,5,-20
-42.06724,-20.69005,66,43,5,-23
-42.06702,-20.69005,67,43,0,-24
-42.06657,-20.69005,70,43,0,-27
-42.06634,-20.69005,71,43,0,-28
-42.06612,-20.69005,70,43,0,-27
-42.0659,-20.69005,70,43,0,-27
-42.06545,-20.69005,69,43,0,-26
-42.06522,-20.69005,69,43,0,-26
-42.065,-20.69005,69,43,0,-26
-42.06477,-20.69005,69,43,0,-26
-42.06455,-20.69005,66,43,0,-23
-42.0641,-20.69005,67,43,0,-24
-42.06387,-20.69005,67,43,0,-24
-42.06365,-20.69005,67,43,0,-24
-42.06342,-20.69005,66,43,0,-23
-42.06297,-20.69005,66,43,0,-23
-42.06275,-20.69005,64,44,0,-20
-42.06252,-20.69005,63,43,0,-20
-42.0623,-20.69005,64,43,5,-21
-42.06185,-20.69005,66,42,5,-24
-42.06163,-20.69005,65,44,11,-21
-42.0614,-20.69005,65,44,5,-21
-42.06118,-20.69005,64,44,0,-20
-42.06073,-20.69005,63,45,0,-18
-42.0605,-20.69005,64,44,0,-20
-42.06028,-20.69005,64,44,0,-20
-42.06005,-20.69005,64,44,5,-20
-42.05983,-20.69005,63,38,5,-25
-42.05938,-20.69005,63,38,5,-25
-42.05915,-20.69005,63,37,5,-26
-42.05893,-20.69005,64,37,5,-27
-42.0587,-20.69005,63,38,5,-25
-42.05826,-20.69005,64,38,5,-26
-42.05803,-20.69005,64,38,5,-26
-42.05781,-20.69005,64,38,5,-26
-42.05758,-20.69005,61,39,5,-22
-42.05713,-20.69005,56,39,6,-17
-42.05691,-20.69005,54,39,6,-15
-42.05668,-20.69005,56,39,6,-17
-42.05646,-20.69005,60,41,6,-19
-42.05601,-20.69005,60,42,5,-18
-42.05578,-20.69005,62,42,5,-20
-42.05556,-20.69005,63,41,5,-22
-42.05533,-20.69005,63,41,5,-22
-42.05511,-20.69005,64,41,5,-23
-42.05466,-20.69005,64,34,5,-30
-42.05443,-20.69005,63,35,5,-28
-42.05421,-20.69005,60,35,5,-25
-42.05399,-20.69005,61,37,5,-24
-42.05354,-20.69005,60,34,5,-26
-42.05331,-20.69005,62,35,5,-27
-42.05309,-20.69005,62,35,5,-27
-42.05286,-20.69005,62,36,5,-26
-42.05241,-20.69005,62,43,0,-19
-42.05219,-20.69005,62,43,0,-19
-42.05196,-20.69005,63,38,5,-25
-42.05174,-20.69005,62,36,5,-26
-42.05129,-20.69005,55,35,5,-20
-42.05106,-20.69005,61,35,5,-26
-42.05084,-20.69005,55,35,5,-20
-42.05061,-20.69005,57,34,5,-23
-42.05039,-20.69005,57,35,5,-22
-42.04994,-20.69005,57,35,5,-22
-42.04972,-20.69005,57,34,5,-23
-42.04949,-20.69005,56,39,5,-17
-42.04927,-20.69005,56,41,0,-15
-42.04882,-20.69005,58,40,0,-18
-42.04859,-20.69005,63,39,0,-24
-42.04837,-20.69005,61,38,0,-23
-42.04814,-20.69005,63,38,0,-25
-42.04769,-20.69005,63,37,0,-26
-42.04747,-20.69005,64,37,0,-27
-42.04724,-20.69005,64,37,0,-27
-42.04702,-20.69005,65,38,0,-27
-42.04657,-20.69005,64,38,0,-26
-42.04635,-20.69005,64,38,0,-26
-42.04612,-20.69005,63,38,0,-25
-42.0459,-20.69005,61,38,0,-23
-42.04545,-20.69005,62,38,0,-24
-42.04522,-20.69005,61,38,0,-23
-42.045,-20.69005,59,38,0,-21
-42.04477,-20.69005,57,38,0,-19
-42.04455,-20.69005,59,39,0,-20
-42.0441,-20.69005,62,38,0,-24
-42.04387,-20.69005,63,38,0,-25
-42.04365,-20.69005,62,37,0,-25
-42.04342,-20.69005,61,38,0,-23
-42.04297,-20.69005,59,38,0,-21
-42.04275,-20.69005,58,38,0,-20
-42.04253,-20.69005,58,38,0,-20
-42.0423,-20.69005,58,38,0,-20
-42.04185,-20.69005,58,40,0,-18
-42.04163,-20.69005,58,40,0,-18
-42.0414,-20.69005,59,40,0,-19
-42.04118,-20.69005,60,40,0,-20
-42.04073,-20.69005,60,41,0,-19
-42.0405,-20.69005,61,42,0,-19
-42.04028,-20.69005,59,45,0,-14
-42.04005,-20.69005,58,45,0,-13
-42.03983,-20.69005,55,46,0,-9
-42.03938,-20.69005,55,50,0,-5
-42.03915,-20.69005,56,49,0,-7
-42.03893,-20.69005,56,49,0,-7
-42.0387,-20.69005,56,49,0,-7
-42.03826,-20.69005,56,48,11,-8
-42.03803,-20.69005,59,47,0,-12
-42.03781,-20.69005,58,44,0,-14
-42.03758,-20.69005,58,42,0,-16
-42.03713,-20.69005,59,42,0,-17
-42.03691,-20.69005,59,41,0,-18
-42.03668,-20.69005,58,41,0,-17
-42.03646,-20.69005,58,40,5,-18
-42.03601,-20.69005,59,39,5,-20
-42.03578,-20.69005,60,37,5,-23
-42.03556,-20.69005,59,38,5,-21
-42.03533,-20.69005,56,36,5,-20
-42.03511,-20.69005,55,37,5,-18
-42.03466,-20.69005,53,35,5,-18
-42.03444,-20.69005,44,37,5,-7
-42.03421,-20.69005,43,36,5,-7
-42.03399,-20.69005,43,36,5,-7
-42.03354,-20.69005,44,37,5,-7
-42.03331,-20.69005,45,38,5,-7
-42.03309,-20.69005,46,40,5,-6
-42.03286,-20.69005,46,40,5,-6
-42.03241,-20.69005,46,38,5,-8
-42.03219,-20.69005,46,39,5,-7
-42.03196,-20.69005,46,39,5,-7
-42.03174,-20.69005,47,39,5,-8
-42.03129,-20.69005,47,36,5,-11
-42.03106,-20.69005,46,36,5,-10
-42.03084,-20.69005,45,36,5,-9
-42.03062,-20.69005,45,35,5,-10
-42.03017,-20.69005,47,37,5,-10
-42.02994,-20.69005,48,36,5,-12
-42.02972,-20.69005,49,36,5,-13
-42.02949,-20.69005,50,35,5,-15
-42.02927,-20.69005,51,35,5,-16
-42.02882,-20.69005,52,35,5,-17
-42.02859,-20.69005,52,34,5,-18
-42.02837,-20.69005,52,34,5,-18
-42.02814,-20.69005,53,39,5,-14
-42.02769,-20.69005,54,36,5,-18
-42.02747,-20.69005,54,39,0,-15
-42.02724,-20.69005,54,41,0,-13
-42.02702,-20.69005,54,42,0,-12
-42.02657,-20.69005,54,43,0,-11
-42.02635,-20.69005,54,43,0,-11
-42.02612,-20.69005,54,41,0,-13
-42.0259,-20.69005,54,42,0,-12
-42.02545,-20.69005,54,42,0,-12
-42.02522,-20.69005,53,42,0,-11
-42.025,-20.69005,53,41,0,-12
-42.02477,-20.69005,53,43,0,-10
-42.02455,-20.69005,52,44,0,-8
-42.0241,-20.69005,52,47,0,-5
-42.02387,-20.69005,51,47,0,-4
-42.02365,-20.69005,51,47,0,-4
-42.02342,-20.69005,51,46,0,-5
-42.02297,-20.69005,51,48,0,-3
-42.02275,-20.69005,51,48,0,-3
-42.02253,-20.69005,51,48,0,-3
-42.0223,-20.69005,50,48,0,-2
-42.02185,-20.69005,49,43,0,-6
-42.02163,-20.69005,49,42,0,-7
-42.0214,-20.69005,50,44,0,-6
-42.02118,-20.69005,49,43,0,-6
-42.02073,-20.69005,49,42,0,-7
-42.0205,-20.69005,49,44,0,-5
-42.02028,-20.69005,49,45,0,-4
-42.02005,-20.69005,49,47,0,-2
-42.01983,-20.69005,48,45,0,-3
-42.01938,-20.69005,48,44,0,-4
-42.01915,-20.69005,47,44,0,-3
-42.01893,-20.69005,46,41,5,-5
-42.01871,-20.69005,45,35,5,-10
-42.01826,-20.69005,44,34,5,-10
-42.01803,-20.69005,42,34,5,-8
-42.01781,-20.69005,41,38,5,-3
-42.01758,-20.69005,41,41,5,0
-42.01713,-20.69005,42,41,5,-1
-42.01691,-20.69005,42,42,5,0
-42.01668,-20.69005,43,43,5,0
-42.01646,-20.69005,43,43,5,0
-42.01601,-20.69005,49,43,5,-6
-42.01578,-20.69005,47,43,5,-4
-42.01556,-20.69005,46,42,0,-4
-42.01533,-20.69005,46,45,0,-1
-42.01511,-20.69005,46,46,0,0
-42.01466,-20.69005,46,44,0,-2
-42.01444,-20.69005,45,44,0,-1
-42.01421,-20.69005,45,45,0,0
-42.01399,-20.69005,44,44,0,0
-42.01354,-20.69005,44,44,0,0
-42.01331,-20.69005,44,45,0,1
-42.01309,-20.69005,43,46,0,3
-42.01286,-20.69005,43,44,0,1
-42.01241,-20.69005,43,40,5,-3
-42.01219,-20.69005,43,37,5,-6
-42.01196,-20.69005,50,38,5,-12
-42.01174,-20.69005,56,38,5,-18
-42.01129,-20.69005,53,38,5,-15
-42.01106,-20.69005,53,38,5,-15
-42.01084,-20.69005,54,39,5,-15
-42.01062,-20.69005,54,42,5,-12
-42.01017,-20.69005,54,40,5,-14
-42.00994,-20.69005,54,38,5,-16
-42.00972,-20.69005,55,37,5,-18
-42.00949,-20.69005,55,39,5,-16
-42.00927,-20.69005,55,40,5,-15
-42.00882,-20.69005,54,46,0,-8
-42.00859,-20.69005,54,47,0,-7
-42.00837,-20.69005,54,46,0,-8
-42.00814,-20.69005,57,46,0,-11
-42.00769,-20.69005,59,45,0,-14
-42.00747,-20.69005,60,45,0,-15
-42.00724,-20.69005,62,44,0,-18
-42.00702,-20.69005,59,44,0,-15
-42.00657,-20.69005,58,44,5,-14
-42.00635,-20.69005,64,40,5,-24
-42.00612,-20.69005,62,39,5,-23
-42.0059,-20.69005,61,38,5,-23
-42.00545,-20.69005,63,40,11,-23
-42.00522,-20.69005,61,40,11,-21
-42.005,-20.69005,61,43,5,-18
-42.00477,-20.69005,60,38,5,-22
-42.00455,-20.69005,60,38,5,-22
-42.0041,-20.69005,61,37,5,-24
-42.00387,-20.69005,62,36,5,-26
-42.00365,-20.69005,59,36,5,-23
-42.00342,-20.69005,58,35,5,-23
-42.00298,-20.69005,58,32,5,-26
-42.00275,-20.69005,56,31,5,-25
-42.00253,-20.69005,53,31,5,-22
-42.0023,-20.69005,53,31,5,-22
-42.00185,-20.69005,53,30,5,-23
-42.00163,-20.69005,52,30,5,-22
-42.0014,-20.69005,52,29,5,-23
-42.00118,-20.69005,52,30,5,-22
-42.00073,-20.69005,52,30,5,-22
-42.0005,-20.69005,52,32,5,-20
-42.00028,-20.69005,54,33,5,-21
-42.00005,-20.69005,54,33,5,-21
-41.99983,-20.69005,58,35,5,-23
-41.99938,-20.69005,58,37,5,-21
-41.99916,-20.69005,56,39,5,-17
-41.99893,-20.69005,59,37,5,-22
-41.99871,-20.69005,58,36,5,-22
-41.99826,-20.69005,59,37,5,-22
-41.99803,-20.69005,60,37,5,-23
-41.99781,-20.69005,59,37,5,-22
-41.99758,-20.69005,60,40,5,-20
-41.99713,-20.69005,61,40,5,-21
-41.99691,-20.69005,62,40,5,-22
-41.99668,-20.69005,65,38,5,-27
-41.99646,-20.69005,65,39,5,-26
-41.99601,-20.69005,67,39,5,-28
-41.99578,-20.69005,68,34,5,-34
-41.99556,-20.69005,69,34,5,-35
-41.99533,-20.69005,69,35,5,-34
-41.99511,-20.69005,68,35,5,-33
-41.99466,-20.69005,69,35,5,-34
-41.99444,-20.69005,68,34,5,-34
-41.99421,-20.69005,69,36,5,-33
-41.99399,-20.69005,69,40,5,-29
-41.99354,-20.69005,68,40,0,-28
-41.99331,-20.69005,67,40,0,-27
-41.99309,-20.69005,66,40,0,-26
-41.99286,-20.69005,65,40,0,-25
-41.99241,-20.69005,63,40,0,-23
-41.99219,-20.69005,59,40,0,-19
-41.99196,-20.69005,57,40,0,-17
-41.99174,-20.69005,56,40,0,-16
-41.99129,-20.69005,56,40,0,-16
-41.99107,-20.69005,64,40,0,-24
-41.99084,-20.69005,67,34,0,-33
-41.99062,-20.69005,67,34,0,-33
-41.99017,-20.69005,65,34,0,-31
-41.98994,-20.69005,64,33,0,-31
-41.98972,-20.69005,65,34,0,-31
-41.98949,-20.69005,63,34,0,-29
-41.98927,-20.69005,58,34,0,-24
-41.98882,-20.69005,54,38,0,-16
-41.98859,-20.69005,52,40,0,-12
-41.98837,-20.69005,51,40,0,-11
-41.98814,-20.69005,50,40,0,-10
-41.98769,-20.69005,49,40,0,-9
-41.98747,-20.69005,47,40,0,-7
-41.98725,-20.69005,47,40,0,-7
-41.98702,-20.69005,47,40,0,-7
-41.98657,-20.69005,47,41,0,-6
-41.98635,-20.69005,47,41,0,-6
-41.98612,-20.69005,47,41,0,-6
-41.9859,-20.69005,57,42,0,-15
-41.98545,-20.69005,61,42,0,-19
-41.98522,-20.69005,61,42,0,-19
-41.985,-20.69005,59,42,0,-17
-41.98477,-20.69005,59,42,0,-17
-41.98455,-20.69005,64,42,0,-22
-41.9841,-20.69005,65,42,0,-23
-41.98387,-20.69005,63,40,0,-23
-41.98365,-20.69005,63,41,0,-22
-41.98343,-20.69005,64,41,0,-23
-41.98298,-20.69005,66,41,0,-25
-41.98275,-20.69005,64,41,0,-23
-41.98253,-20.69005,63,42,0,-21
-41.9823,-20.69005,63,42,0,-21
-41.98185,-20.69005,60,42,0,-18
-41.98163,-20.69005,57,42,0,-15
-41.9814,-20.69005,57,43,0,-14
-41.98118,-20.69005,55,43,0,-12
-41.98073,-20.69005,58,43,0,-15
-41.9805,-20.69005,51,43,0,-8
-41.98028,-20.69005,51,43,0,-8
-41.98005,-20.69005,65,43,0,-22
-41.97983,-20.69005,56,42,0,-14
-41.97938,-20.69005,52,42,0,-10
-41.97916,-20.69005,51,41,0,-10
-41.97893,-20.69005,51,43,0,-8
-41.97871,-20.69005,51,43,0,-8
-41.97826,-20.69005,51,41,5,-10
-41.97803,-20.69005,51,38,5,-13
-41.97781,-20.69005,51,36,5,-15
-41.97758,-20.69005,51,36,5,-15
-41.97713,-20.69005,51,31,5,-20
-41.97691,-20.69005,51,31,5,-20
-41.97668,-20.69005,51,29,5,-22
-41.97646,-20.69005,51,28,5,-23
-41.97601,-20.69005,52,29,5,-23
-41.97578,-20.69005,51,32,5,-19
-41.97556,-20.69005,51,34,5,-17
-41.97534,-20.69005,50,34,5,-16
-41.97511,-20.69005,49,34,5,-15
-41.97466,-20.69005,49,34,5,-15
-41.97444,-20.69005,50,33,5,-17
-41.97421,-20.69005,56,32,5,-24
-41.97399,-20.69005,49,31,5,-18
-41.97354,-20.69005,49,29,5,-20
-41.97331,-20.69005,49,29,5,-20
-41.97309,-20.69005,50,27,5,-23
-41.97286,-20.69005,56,32,5,-24
-41.97241,-20.69005,68,32,0,-36
-41.97219,-20.69005,64,32,0,-32
-41.97196,-20.69005,64,32,0,-32
-41.97174,-20.69005,65,32,0,-33
-41.97129,-20.69005,65,32,0,-33
-41.97107,-20.69005,71,32,0,-39
-41.97084,-20.69005,70,33,0,-37
-41.97062,-20.69005,68,34,0,-34
-41.97017,-20.69005,67,34,0,-33
-41.96994,-20.69005,66,35,0,-31
-41.96972,-20.69005,66,36,0,-30
-41.96949,-20.69005,66,38,5,-28
-41.96927,-20.69005,68,33,5,-35
-42.1005,-20.68963,65,39,0,-26
-42.0978,-20.68963,66,37,5,-29
-42.09511,-20.68963,70,34,0,-36
-42.09219,-20.68963,59,34,5,-25
-42.08949,-20.68963,60,34,5,-26
-42.08657,-20.68963,64,37,5,-27
-42.08387,-20.68963,67,39,5,-28
-42.08118,-20.68963,66,38,5,-28
-42.07825,-20.68963,60,34,5,-26
-42.07556,-20.68963,60,38,5,-22
-42.07286,-20.68963,60,40,5,-20
-42.06994,-20.68963,60,44,0,-16
-42.06724,-20.68963,67,40,5,-27
-42.06455,-20.68963,69,44,0,-25
-42.06163,-20.68963,65,44,5,-21
-42.05893,-20.68963,64,37,5,-27
-42.05601,-20.68963,60,38,5,-22
-42.05331,-20.68963,64,34,5,-30
-42.05061,-20.68963,56,36,5,-20
-42.04769,-20.68963,64,38,0,-26
-42.045,-20.68963,57,39,0,-18
-42.0423,-20.68963,57,39,0,-18
-42.03938,-20.68963,56,49,0,-7
-42.03668,-20.68963,59,41,0,-18
-42.03399,-20.68963,43,36,5,-7
-42.03106,-20.68963,45,35,5,-10
-42.02837,-20.68963,52,37,0,-15
-42.02545,-20.68963,54,43,0,-11
-42.02275,-20.68963,51,48,0,-3
-42.02005,-20.68963,49,47,0,-2
-42.01713,-20.68963,41,41,5,0
-42.01444,-20.68963,45,40,0,-5
-42.01174,-20.68963,50,38,5,-12
-42.00882,-20.68963,54,46,5,-8
-42.00612,-20.68963,62,44,11,-18
-42.00342,-20.68963,57,35,5,-22
-42.0005,-20.68963,52,35,5,-17
-41.99781,-20.68963,55,35,5,-20
-41.99511,-20.68963,68,35,5,-33
-41.99219,-20.68963,61,41,0,-20
-41.98949,-20.68963,58,36,0,-22
-41.98657,-20.68963,47,41,0,-6
-41.98387,-20.68963,64,35,0,-29
-41.98118,-20.68963,55,42,0,-13
-41.97826,-20.68963,51,43,5,-8
-41.97556,-20.68963,51,35,5,-16
-41.97286,-20.68963,50,27,5,-23
-41.96994,-20.68963,67,35,5,-32
-42.1005,-20.68942,65,39,0,-26
-42.0978,-20.68942,65,36,5,-29
-42.09511,-20.68942,68,34,0,-34
-42.09219,-20.68942,59,31,5,-28
-42.08949,-20.68942,60,34,5,-26
-42.08657,-20.68942,62,35,5,-27
-42.08387,-20.68942,67,39,5,-28
-42.08118,-20.68942,66,39,5,-27
-42.07825,-20.68942,60,34,5,-26
-42.07556,-20.68942,60,37,5,-23
-42.07286,-20.68942,60,41,5,-19
-42.06994,-20.68942,60,44,0,-16
-42.06724,-20.68942,68,38,5,-30
-42.06455,-20.68942,71,44,0,-27
-42.06163,-20.68942,63,44,5,-19
-42.05893,-20.68942,64,36,5,-28
-42.05601,-20.68942,60,38,5,-22
-42.05331,-20.68942,60,34,5,-26
-42.05061,-20.68942,55,36,5,-19
-42.04769,-20.68942,64,38,0,-26
-42.045,-20.68942,60,39,0,-21
-42.0423,-20.68942,57,39,0,-18
-42.03938,-20.68942,57,46,0,-11
-42.03668,-20.68942,58,41,5,-17
-42.03399,-20.68942,43,40,5,-3
-42.03106,-20.68942,44,34,5,-10
-42.02837,-20.68942,52,45,0,-7
-42.02545,-20.68942,53,43,0,-10
-42.02275,-20.68942,51,48,0,-3
-42.02005,-20.68942,48,43,0,-5
-42.01713,-20.68942,41,41,5,0
-42.01444,-20.68942,45,39,0,-6
-42.01174,-20.68942,45,39,5,-6
-42.00882,-20.68942,54,44,5,-10
-42.00612,-20.68942,61,44,0,-17
-42.00342,-20.68942,57,43,5,-14
-42.0005,-20.68942,52,36,5,-16
-41.99781,-20.68942,53,35,5,-18
-41.99511,-20.68942,68,36,5,-32
-41.99219,-20.68942,61,41,0,-20
-41.98949,-20.68942,56,38,0,-18
-41.98657,-20.68942,47,41,0,-6
-41.98387,-20.68942,62,35,0,-27
-41.98118,-20.68942,56,42,0,-14
-41.97826,-20.68942,51,36,5,-15
-41.97556,-20.68942,51,35,0,-16
-41.97286,-20.68942,62,27,5,-35
-41.96994,-20.68942,67,33,5,-34
-42.1005,-20.68921,65,38,0,-27
-42.0978,-20.68921,66,36,5,-30
-42.09511,-20.68921,68,35,11,-33
-42.09219,-20.68921,59,32,5,-27
-42.08949,-20.68921,60,35,5,-25
-42.08657,-20.68921,63,35,5,-28
-42.08387,-20.68921,67,38,5,-29
-42.08118,-20.68921,67,40,0,-27
-42.07825,-20.68921,60,36,5,-24
-42.07556,-20.68921,60,36,5,-24
-42.07286,-20.68921,60,43,5,-17
-42.06994,-20.68921,60,44,0,-16
-42.06724,-20.68921,68,38,5,-30
-42.06455,-20.68921,71,44,0,-27
-42.06163,-20.68921,63,42,5,-21
-42.05893,-20.68921,64,40,5,-24
-42.05601,-20.68921,59,38,5,-21
-42.05331,-20.68921,59,35,5,-24
-42.05061,-20.68921,55,35,5,-20
-42.04769,-20.68921,66,39,0,-27
-42.045,-20.68921,63,39,5,-24
-42.0423,-20.68921,57,39,0,-18
-42.03938,-20.68921,57,46,0,-11
-42.03668,-20.68921,58,41,5,-17
-42.03399,-20.68921,42,40,5,-2
-42.03106,-20.68921,45,34,5,-11
-42.02837,-20.68921,52,43,0,-9
-42.02545,-20.68921,52,43,0,-9
-42.02275,-20.68921,51,48,11,-3
-42.02005,-20.68921,48,41,0,-7
-42.01713,-20.68921,39,38,5,-1
-42.01444,-20.68921,44,40,0,-4
-42.01174,-20.68921,43,39,5,-4
-42.00882,-20.68921,53,42,5,-11
-42.00612,-20.68921,60,44,0,-16
-42.00342,-20.68921,56,43,11,-13
-42.0005,-20.68921,52,35,5,-17
-41.99781,-20.68921,55,35,5,-20
-41.99511,-20.68921,70,35,5,-35
-41.99219,-20.68921,63,41,0,-22
-41.98949,-20.68921,55,38,0,-17
-41.98657,-20.68921,59,41,0,-18
-41.98387,-20.68921,59,35,0,-24
-41.98118,-20.68921,52,42,0,-10
-41.97826,-20.68921,51,35,5,-16
-41.97556,-20.68921,50,35,0,-15
-41.97286,-20.68921,52,27,5,-25
-41.96994,-20.68921,66,33,5,-33
-42.1005,-20.68899,65,34,5,-31
-42.0978,-20.68899,65,36,5,-29
-42.09511,-20.68899,68,35,11,-33
-42.09219,-20.68899,59,33,5,-26
-42.08949,-20.68899,60,36,5,-24
-42.08657,-20.68899,63,37,5,-26
-42.08387,-20.68899,67,38,5,-29
-42.08118,-20.68899,69,40,5,-29
-42.07825,-20.68899,60,36,5,-24
-42.07556,-20.68899,60,36,5,-24
-42.07286,-20.68899,60,39,5,-21
-42.06994,-20.68899,59,44,5,-15
-42.06724,-20.68899,71,37,5,-34
-42.06455,-20.68899,71,44,0,-27
-42.06163,-20.68899,66,40,5,-26
-42.05893,-20.68899,65,40,5,-25
-42.05601,-20.68899,59,37,5,-22
-42.05331,-20.68899,60,35,5,-25
-42.05061,-20.68899,55,34,5,-21
-42.04769,-20.68899,68,39,0,-29
-42.045,-20.68899,66,38,5,-28
-42.0423,-20.68899,57,39,0,-18
-42.03938,-20.68899,62,46,0,-16
-42.03668,-20.68899,60,36,5,-24
-42.03399,-20.68899,41,40,5,-1
-42.03106,-20.68899,43,34,5,-9
-42.02837,-20.68899,51,45,0,-6
-42.02545,-20.68899,51,43,0,-8
-42.02275,-20.68899,51,48,11,-3
-42.02005,-20.68899,48,41,0,-7
-42.01713,-20.68899,39,35,5,-4
-42.01444,-20.68899,44,38,0,-6
-42.01174,-20.68899,53,40,5,-13
-42.00882,-20.68899,59,42,5,-17
-42.00612,-20.68899,60,45,0,-15
-42.00342,-20.68899,56,44,5,-12
-42.0005,-20.68899,52,35,5,-17
-41.99781,-20.68899,51,36,5,-15
-41.99511,-20.68899,71,35,5,-36
-41.99219,-20.68899,65,41,0,-24
-41.98949,-20.68899,55,38,0,-17
-41.98657,-20.68899,65,41,0,-24
-41.98387,-20.68899,57,35,0,-22
-41.98118,-20.68899,49,42,0,-7
-41.97826,-20.68899,51,31,5,-20
-41.97556,-20.68899,50,34,5,-16
-41.97286,-20.68899,61,26,5,-35
-41.96994,-20.68899,66,33,5,-33
-42.1005,-20.68857,65,33,5,-32
-42.0978,-20.68857,65,37,5,-28
-42.09511,-20.68857,66,38,5,-28
-42.09219,-20.68857,59,32,5,-27
-42.08949,-20.68857,60,34,5,-26
-42.08657,-20.68857,63,36,5,-27
-42.08387,-20.68857,67,38,5,-29
-42.08118,-20.68857,69,38,5,-31
-42.07825,-20.68857,60,35,5,-25
-42.07556,-20.68857,60,34,5,-26
-42.07286,-20.68857,62,41,5,-21
-42.06994,-20.68857,59,38,5,-21
-42.06724,-20.68857,72,41,5,-31
-42.06455,-20.68857,72,44,0,-28
-42.06163,-20.68857,67,45,0,-22
-42.05893,-20.68857,65,35,5,-30
-42.05601,-20.68857,58,39,5,-19
-42.05331,-20.68857,59,40,0,-19
-42.05061,-20.68857,54,43,0,-11
-42.04769,-20.68857,70,40,0,-30
-42.045,-20.68857,67,37,5,-30
-42.0423,-20.68857,57,40,0,-17
-42.03938,-20.68857,59,40,0,-19
-42.03668,-20.68857,58,36,5,-22
-42.03399,-20.68857,41,38,5,-3
-42.03106,-20.68857,43,32,5,-11
-42.02837,-20.68857,50,39,0,-11
-42.02545,-20.68857,51,44,0,-7
-42.02275,-20.68857,50,45,0,-5
-42.02005,-20.68857,48,33,5,-15
-42.01713,-20.68857,39,37,0,-2
-42.01444,-20.68857,44,38,5,-6
-42.01174,-20.68857,57,47,5,-10
-42.00882,-20.68857,60,40,5,-20
-42.00612,-20.68857,60,45,0,-15
-42.00342,-20.68857,56,44,0,-12
-42.0005,-20.68857,52,34,5,-18
-41.99781,-20.68857,51,38,5,-13
-41.99511,-20.68857,70,37,5,-33
-41.99219,-20.68857,71,42,0,-29
-41.98949,-20.68857,55,34,0,-21
-41.98657,-20.68857,63,41,0,-22
-41.98387,-20.68857,60,34,0,-26
-41.98118,-20.68857,49,42,0,-7
-41.97826,-20.68857,51,32,5,-19
-41.97556,-20.68857,50,32,5,-18
-41.97286,-20.68857,61,27,5,-34
-41.96994,-20.68857,69,33,5,-36
-42.1005,-20.68836,65,33,6,-32
-42.0978,-20.68836,67,37,5,-30
-42.09511,-20.68836,66,37,5,-29
-42.09219,-20.68836,61,31,5,-30
-42.08949,-20.68836,62,34,5,-28
-42.08657,-20.68836,63,36,5,-27
-42.08387,-20.68836,67,39,5,-28
-42.08118,-20.68836,66,40,5,-26
-42.07825,-20.68836,60,35,5,-25
-42.07556,-20.68836,60,34,5,-26
-42.07286,-20.68836,64,41,5,-23
-42.06994,-20.68836,59,37,5,-22
-42.06724,-20.68836,70,42,0,-28
-42.06455,-20.68836,74,44,0,-30
-42.06163,-20.68836,63,45,0,-18
-42.05893,-20.68836,64,36,5,-28
-42.05601,-20.68836,57,39,5,-18
-42.05331,-20.68836,57,40,5,-17
-42.05061,-20.68836,54,44,0,-10
-42.04769,-20.68836,74,40,0,-34
-42.045,-20.68836,66,37,5,-29
-42.0423,-20.68836,57,40,0,-17
-42.03938,-20.68836,59,41,0,-18
-42.03668,-20.68836,58,36,5,-22
-42.03399,-20.68836,41,37,5,-4
-42.03106,-20.68836,43,32,5,-11
-42.02837,-20.68836,48,37,0,-11
-42.02545,-20.68836,50,44,0,-6
-42.02275,-20.68836,50,45,0,-5
-42.02005,-20.68836,48,34,5,-14
-42.01713,-20.68836,48,39,0,-9
-42.01444,-20.68836,55,39,5,-16
-42.01174,-20.68836,59,47,5,-12
-42.00882,-20.68836,58,38,5,-20
-42.00612,-20.68836,59,45,5,-14
-42.00342,-20.68836,56,42,0,-14
-42.0005,-20.68836,58,35,5,-23
-41.99781,-20.68836,61,37,5,-24
-41.99511,-20.68836,70,36,5,-34
-41.99219,-20.68836,69,42,0,-27
-41.98949,-20.68836,56,33,0,-23
-41.98657,-20.68836,61,40,0,-21
-41.98387,-20.68836,57,34,0,-23
-41.98118,-20.68836,49,42,0,-7
-41.97826,-20.68836,50,33,5,-17
-41.97556,-20.68836,50,31,5,-19
-41.97286,-20.68836,49,27,5,-22
-41.96994,-20.68836,69,32,5,-37
-42.1005,-20.68815,65,33,5,-32
-42.0978,-20.68815,66,34,5,-32
-42.09511,-20.68815,65,39,5,-26
-42.09219,-20.68815,60,31,5,-29
-42.08949,-20.68815,63,32,5,-31
-42.08657,-20.68815,63,35,5,-28
-42.08387,-20.68815,67,39,5,-28
-42.08118,-20.68815,65,38,5,-27
-42.07825,-20.68815,60,36,5,-24
-42.07556,-20.68815,60,34,5,-26
-42.07286,-20.68815,64,40,5,-24
-42.06994,-20.68815,59,41,5,-18
-42.06724,-20.68815,70,43,0,-27
-42.06455,-20.68815,76,44,0,-32
-42.06163,-20.68815,63,45,0,-18
-42.05893,-20.68815,64,37,5,-27
-42.05601,-20.68815,57,36,5,-21
-42.05331,-20.68815,57,35,5,-22
-42.05061,-20.68815,54,44,0,-10
-42.04769,-20.68815,78,41,0,-37
-42.045,-20.68815,65,36,5,-29
-42.0423,-20.68815,57,41,0,-16
-42.03938,-20.68815,58,43,11,-15
-42.03668,-20.68815,58,35,5,-23
-42.03399,-20.68815,45,37,5,-8
-42.03106,-20.68815,43,32,5,-11
-42.02837,-20.68815,47,34,0,-13
-42.02545,-20.68815,49,44,0,-5
-42.02275,-20.68815,50,47,0,-3
-42.02005,-20.68815,48,34,5,-14
-42.01713,-20.68815,51,41,0,-10
-42.01444,-20.68815,58,39,5,-19
-42.01174,-20.68815,59,48,5,-11
-42.00882,-20.68815,59,36,5,-23
-42.00612,-20.68815,58,39,5,-19
-42.00342,-20.68815,57,41,0,-16
-42.0005,-20.68815,62,34,5,-28
-41.99781,-20.68815,62,41,5,-21
-41.99511,-20.68815,70,36,5,-34
-41.99219,-20.68815,66,42,0,-24
-41.98949,-20.68815,65,33,0,-32
-41.98657,-20.68815,59,40,0,-19
-41.98387,-20.68815,58,33,5,-25
-41.98118,-20.68815,48,42,0,-6
-41.97826,-20.68815,50,33,5,-17
-41.97556,-20.68815,50,32,5,-18
-41.97286,-20.68815,53,27,5,-26
-41.96994,-20.68815,68,31,5,-37
-42.1005,-20.68773,65,30,5,-35
-42.0978,-20.68773,66,35,5,-31
-42.09511,-20.68773,65,39,5,-26
-42.09219,-20.68773,60,35,5,-25
-42.08949,-20.68773,64,32,5,-32
-42.08657,-20.68773,63,34,5,-29
-42.08387,-20.68773,68,39,5,-29
-42.08118,-20.68773,63,39,5,-24
-42.07825,-20.68773,60,37,5,-23
-42.07556,-20.68773,60,34,5,-26
-42.07286,-20.68773,66,44,0,-22
-42.06994,-20.68773,59,44,0,-15
-42.06724,-20.68773,67,44,0,-23
-42.06455,-20.68773,78,44,0,-34
-42.06163,-20.68773,63,45,0,-18
-42.05893,-20.68773,64,37,5,-27
-42.05601,-20.68773,59,33,5,-26
-42.05331,-20.68773,61,39,5,-22
-42.05061,-20.68773,54,45,0,-9
-42.04769,-20.68773,80,42,0,-38
-42.045,-20.68773,64,39,5,-25
-42.0423,-20.68773,56,42,0,-14
-42.03938,-20.68773,58,44,0,-14
-42.03668,-20.68773,59,34,5,-25
-42.03399,-20.68773,44,33,5,-11
-42.03106,-20.68773,45,32,5,-13
-42.02837,-20.68773,46,34,0,-12
-42.02545,-20.68773,49,41,0,-8
-42.02275,-20.68773,50,47,5,-3
-42.02005,-20.68773,47,32,5,-15
-42.01713,-20.68773,53,47,0,-6
-42.01444,-20.68773,61,39,5,-22
-42.01174,-20.68773,59,48,5,-11
-42.00882,-20.68773,60,38,5,-22
-42.00612,-20.68773,59,38,5,-21
-42.00342,-20.68773,60,38,0,-22
-42.0005,-20.68773,63,35,5,-28
-41.99781,-20.68773,60,41,5,-19
-41.99511,-20.68773,70,41,0,-29
-41.99219,-20.68773,66,42,0,-24
-41.98949,-20.68773,68,33,0,-35
-41.98657,-20.68773,58,40,0,-18
-41.98387,-20.68773,67,34,5,-33
-41.98118,-20.68773,48,42,0,-6
-41.97826,-20.68773,49,31,5,-18
-41.97556,-20.68773,49,33,5,-16
-41.97286,-20.68773,49,28,5,-21
-41.96994,-20.68773,67,30,5,-37
-42.1005,-20.68751,65,33,5,-32
-42.0978,-20.68751,69,34,5,-35
-42.09511,-20.68751,67,35,5,-32
-42.09219,-20.68751,60,35,5,-25
-42.08949,-20.68751,64,32,5,-32
-42.08657,-20.68751,63,34,5,-29
-42.08387,-20.68751,67,40,5,-27
-42.08118,-20.68751,62,39,5,-23
-42.07825,-20.68751,60,36,5,-24
-42.07556,-20.68751,60,34,5,-26
-42.07286,-20.68751,64,44,0,-20
-42.06994,-20.68751,68,43,0,-25
-42.06724,-20.68751,68,44,0,-24
-42.06455,-20.68751,77,45,0,-32
-42.06163,-20.68751,63,45,0,-18
-42.05893,-20.68751,63,36,5,-27
-42.05601,-20.68751,63,33,5,-30
-42.05331,-20.68751,61,39,5,-22
-42.05061,-20.68751,54,45,0,-9
-42.04769,-20.68751,78,41,5,-37
-42.045,-20.68751,64,44,0,-20
-42.0423,-20.68751,57,42,0,-15
-42.03938,-20.68751,60,45,0,-15
-42.03668,-20.68751,58,34,5,-24
-42.03399,-20.68751,44,38,5,-6
-42.03106,-20.68751,43,32,5,-11
-42.02837,-20.68751,46,33,0,-13
-42.02545,-20.68751,48,36,0,-12
-42.02275,-20.68751,49,47,5,-2
-42.02005,-20.68751,47,31,5,-16
-42.01713,-20.68751,51,47,0,-4
-42.01444,-20.68751,61,39,0,-22
-42.01174,-20.68751,59,48,5,-11
-42.00882,-20.68751,58,37,5,-21
-42.00612,-20.68751,60,36,5,-24
-42.00342,-20.68751,58,36,5,-22
-42.0005,-20.68751,63,34,5,-29
-41.99781,-20.68751,61,41,5,-20
-41.99511,-20.68751,68,41,0,-27
-41.99219,-20.68751,64,42,5,-22
-41.98949,-20.68751,67,33,0,-34
-41.98657,-20.68751,61,40,0,-21
-41.98387,-20.68751,67,33,5,-34
-41.98118,-20.68751,53,42,0,-11
-41.97826,-20.68751,49,29,5,-20
-41.97556,-20.68751,60,32,5,-28
-41.97286,-20.68751,49,27,5,-22
-41.96994,-20.68751,67,32,5,-35
-42.10297,-20.6873,63,38,0,-25
-42.10275,-20.6873,63,38,6,-25
-42.10252,-20.6873,63,35,6,-28
-42.1023,-20.6873,64,33,5,-31
-42.10185,-20.6873,64,30,5,-34
-42.10163,-20.6873,64,33,5,-31
-42.1014,-20.6873,65,34,5,-31
-42.10118,-20.6873,65,34,6,-31
-42.10073,-20.6873,65,33,11,-32
-42.1005,-20.6873,66,33,11,-33
-42.10028,-20.6873,67,33,5,-34
-42.10005,-20.6873,67,29,5,-38
-42.09983,-20.6873,68,30,5,-38
-42.09938,-20.6873,69,29,5,-40
-42.09915,-20.6873,69,30,5,-39
-42.09893,-20.6873,68,31,5,-37
-42.0987,-20.6873,68,30,5,-38
-42.09825,-20.6873,68,31,5,-37
-42.09803,-20.6873,68,32,5,-36
-42.0978,-20.6873,68,34,5,-34
-42.09758,-20.6873,67,36,5,-31
-42.09713,-20.6873,68,38,5,-30
-42.09691,-20.6873,69,39,5,-30
-42.09668,-20.6873,68,43,5,-25
-42.09646,-20.6873,67,38,5,-29
-42.09601,-20.6873,67,38,5,-29
-42.09578,-20.6873,68,35,5,-33
-42.09556,-20.6873,68,34,5,-34
-42.09533,-20.6873,67,35,5,-32
-42.09511,-20.6873,67,32,5,-35
-42.09466,-20.6873,68,31,5,-37
-42.09443,-20.6873,68,31,5,-37
-42.09421,-20.6873,66,35,5,-31
-42.09398,-20.6873,65,34,5,-31
-42.09354,-20.6873,63,36,5,-27
-42.09331,-20.6873,60,39,5,-21
-42.09309,-20.6873,60,39,5,-21
-42.09286,-20.6873,60,39,5,-21
-42.09241,-20.6873,60,39,5,-21
-42.09219,-20.6873,60,36,5,-24
-42.09196,-20.6873,60,35,5,-25
-42.09174,-20.6873,60,33,5,-27
-42.09129,-20.6873,60,34,5,-26
-42.09106,-20.6873,60,34,5,-26
-42.09084,-20.6873,60,31,5,-29
-42.09061,-20.6873,61,31,5,-30
-42.09039,-20.6873,61,31,5,-30
-42.08994,-20.6873,63,31,5,-32
-42.08972,-20.6873,64,31,5,-33
-42.08949,-20.6873,65,31,5,-34
-42.08927,-20.6873,66,32,5,-34
-42.08882,-20.6873,66,33,5,-33
-42.08859,-20.6873,66,33,5,-33
-42.08837,-20.6873,65,33,5,-32
-42.08814,-20.6873,63,33,5,-30
-42.08769,-20.6873,62,33,5,-29
-42.08747,-20.6873,62,33,5,-29
-42.08724,-20.6873,62,33,5,-29
-42.08702,-20.6873,63,33,5,-30
-42.08657,-20.6873,63,34,5,-29
-42.08634,-20.6873,64,34,5,-30
-42.08612,-20.6873,64,34,5,-30
-42.08589,-20.6873,65,35,5,-30
-42.08545,-20.6873,65,35,5,-30
-42.08522,-20.6873,66,36,5,-30
-42.085,-20.6873,66,36,5,-30
-42.08477,-20.6873,66,39,5,-27
-42.08455,-20.6873,67,44,5,-23
-42.0841,-20.6873,67,44,5,-23
-42.08387,-20.6873,67,40,5,-27
-42.08365,-20.6873,68,37,5,-31
-42.08342,-20.6873,69,42,5,-27
-42.08297,-20.6873,70,42,0,-28
-42.08275,-20.6873,70,42,0,-28
-42.08252,-20.6873,69,42,0,-27
-42.0823,-20.6873,68,41,5,-27
-42.08185,-20.6873,68,40,5,-28
-42.08163,-20.6873,67,40,5,-27
-42.0814,-20.6873,64,39,5,-25
-42.08118,-20.6873,65,35,5,-30
-42.08073,-20.6873,62,31,5,-31
-42.0805,-20.6873,63,32,5,-31
-42.08028,-20.6873,64,34,5,-30
-42.08005,-20.6873,62,35,5,-27
-42.07983,-20.6873,60,36,11,-24
-42.07938,-20.6873,60,35,5,-25
-42.07915,-20.6873,60,36,5,-24
-42.07893,-20.6873,60,37,5,-23
-42.0787,-20.6873,60,36,5,-24
-42.07825,-20.6873,60,35,5,-25
-42.07803,-20.6873,60,36,5,-24
-42.07781,-20.6873,60,36,5,-24
-42.07758,-20.6873,60,37,5,-23
-42.07713,-20.6873,60,37,5,-23
-42.07691,-20.6873,60,35,5,-25
-42.07668,-20.6873,60,34,5,-26
-42.07646,-20.6873,60,34,5,-26
-42.07601,-20.6873,60,34,5,-26
-42.07578,-20.6873,60,34,5,-26
-42.07556,-20.6873,60,34,5,-26
-42.07533,-20.6873,60,35,5,-25
-42.07511,-20.6873,62,34,5,-28
-42.07466,-20.6873,63,35,5,-28
-42.07443,-20.6873,63,35,5,-28
-42.07421,-20.6873,63,35,5,-28
-42.07399,-20.6873,64,37,5,-27
-42.07354,-20.6873,65,44,5,-21
-42.07331,-20.6873,64,44,5,-20
-42.07309,-20.6873,62,44,0,-18
-42.07286,-20.6873,61,44,0,-17
-42.07241,-20.6873,62,44,0,-18
-42.07219,-20.6873,64,44,0,-20
-42.07196,-20.6873,65,44,0,-21
-42.07174,-20.6873,65,44,0,-21
-42.07129,-20.6873,66,44,0,-22
-42.07106,-20.6873,67,44,0,-23
-42.07084,-20.6873,67,44,0,-23
-42.07061,-20.6873,67,44,0,-23
-42.07039,-20.6873,68,44,0,-24
-42.06994,-20.6873,63,44,0,-19
-42.06972,-20.6873,59,43,0,-16
-42.06949,-20.6873,59,42,0,-17
-42.06927,-20.6873,59,43,0,-16
-42.06882,-20.6873,59,43,0,-16
-42.06859,-20.6873,60,43,0,-17
-42.06837,-20.6873,61,40,5,-21
-42.06814,-20.6873,62,35,5,-27
-42.06769,-20.6873,62,38,5,-24
-42.06747,-20.6873,63,44,5,-19
-42.06724,-20.6873,65,44,0,-21
-42.06702,-20.6873,65,44,0,-21
-42.06657,-20.6873,66,44,0,-22
-42.06634,-20.6873,67,44,0,-23
-42.06612,-20.6873,68,44,0,-24
-42.0659,-20.6873,68,44,0,-24
-42.06545,-20.6873,69,45,0,-24
-42.06522,-20.6873,71,45,0,-26
-42.065,-20.6873,71,45,0,-26
-42.06477,-20.6873,73,45,0,-28
-42.06455,-20.6873,75,45,0,-30
-42.0641,-20.6873,71,45,0,-26
-42.06387,-20.6873,71,45,5,-26
-42.06365,-20.6873,69,36,5,-33
-42.06342,-20.6873,66,36,5,-30
-42.06297,-20.6873,66,35,5,-31
-42.06275,-20.6873,64,44,5,-20
-42.06252,-20.6873,65,44,11,-21
-42.0623,-20.6873,66,45,11,-21
-42.06185,-20.6873,67,45,0,-22
-42.06163,-20.6873,64,45,0,-19
-42.0614,-20.6873,64,45,0,-19
-42.06118,-20.6873,64,45,5,-19
-42.06073,-20.6873,65,38,5,-27
-42.0605,-20.6873,66,37,5,-29
-42.06028,-20.6873,66,35,5,-31
-42.06005,-20.6873,66,37,5,-29
-42.05983,-20.6873,65,36,5,-29
-42.05938,-20.6873,63,36,5,-27
-42.05915,-20.6873,62,36,5,-26
-42.05893,-20.6873,62,36,5,-26
-42.0587,-20.6873,62,36,5,-26
-42.05826,-20.6873,61,37,5,-24
-42.05803,-20.6873,61,38,5,-23
-42.05781,-20.6873,62,38,5,-24
-42.05758,-20.6873,62,37,5,-25
-42.05713,-20.6873,61,37,5,-24
-42.05691,-20.6873,61,36,5,-25
-42.05668,-20.6873,61,36,5,-25
-42.05646,-20.6873,61,35,5,-26
-42.05601,-20.6873,60,33,5,-27
-42.05578,-20.6873,61,33,5,-28
-42.05556,-20.6873,60,37,5,-23
-42.05533,-20.6873,58,37,5,-21
-42.05511,-20.6873,59,37,5,-22
-42.05466,-20.6873,59,34,5,-25
-42.05443,-20.6873,59,37,5,-22
-42.05421,-20.6873,58,42,0,-16
-42.05399,-20.6873,58,42,0,-16
-42.05354,-20.6873,61,41,0,-20
-42.05331,-20.6873,63,39,0,-24
-42.05309,-20.6873,63,38,0,-25
-42.05286,-20.6873,62,35,5,-27
-42.05241,-20.6873,62,34,5,-28
-42.05219,-20.6873,62,34,5,-28
-42.05196,-20.6873,63,35,5,-28
-42.05174,-20.6873,62,36,5,-26
-42.05129,-20.6873,62,37,5,-25
-42.05106,-20.6873,60,41,5,-19
-42.05084,-20.6873,56,45,5,-11
-42.05061,-20.6873,54,46,5,-8
-42.05039,-20.6873,53,45,5,-8
-42.04994,-20.6873,53,45,5,-8
-42.04972,-20.6873,54,45,5,-9
-42.04949,-20.6873,55,45,5,-10
-42.04927,-20.6873,58,45,5,-13
-42.04882,-20.6873,70,44,0,-26
-42.04859,-20.6873,72,43,0,-29
-42.04837,-20.6873,73,43,0,-30
-42.04814,-20.6873,76,43,5,-33
-42.04769,-20.6873,77,37,5,-40
-42.04747,-20.6873,77,40,5,-37
-42.04724,-20.6873,78,40,5,-38
-42.04702,-20.6873,78,41,5,-37
-42.04657,-20.6873,74,37,5,-37
-42.04635,-20.6873,71,38,5,-33
-42.04612,-20.6873,66,40,5,-26
-42.0459,-20.6873,65,37,5,-28
-42.04545,-20.6873,63,37,5,-26
-42.04522,-20.6873,62,44,5,-18
-42.045,-20.6873,62,46,0,-16
-42.04477,-20.6873,60,47,0,-13
-42.04455,-20.6873,65,47,0,-18
-42.0441,-20.6873,63,47,0,-16
-42.04387,-20.6873,58,47,0,-11
-42.04365,-20.6873,55,46,0,-9
-42.04342,-20.6873,54,45,0,-9
-42.04297,-20.6873,54,44,0,-10
-42.04275,-20.6873,55,43,0,-12
-42.04253,-20.6873,56,42,0,-14
-42.0423,-20.6873,57,42,0,-15
-42.04185,-20.6873,57,41,0,-16
-42.04163,-20.6873,57,41,0,-16
-42.0414,-20.6873,57,41,0,-16
-42.04118,-20.6873,58,41,5,-17
-42.04073,-20.6873,58,38,11,-20
-42.0405,-20.6873,58,39,5,-19
-42.04028,-20.6873,58,38,5,-20
-42.04005,-20.6873,58,35,5,-23
-42.03983,-20.6873,58,35,5,-23
-42.03938,-20.6873,59,48,0,-11
-42.03915,-20.6873,58,47,0,-11
-42.03893,-20.6873,58,48,0,-10
-42.0387,-20.6873,59,48,0,-11
-42.03826,-20.6873,59,48,0,-11
-42.03803,-20.6873,59,47,0,-12
-42.03781,-20.6873,59,39,0,-20
-42.03758,-20.6873,59,37,5,-22
-42.03713,-20.6873,59,34,5,-25
-42.03691,-20.6873,59,33,5,-26
-42.03668,-20.6873,58,34,5,-24
-42.03646,-20.6873,58,34,5,-24
-42.03601,-20.6873,57,34,5,-23
-42.03578,-20.6873,57,34,5,-23
-42.03556,-20.6873,56,34,5,-22
-42.03533,-20.6873,55,34,5,-21
-42.03511,-20.6873,55,34,5,-21
-42.03466,-20.6873,54,34,5,-20
-42.03444,-20.6873,51,39,5,-12
-42.03421,-20.6873,50,38,5,-12
-42.03399,-20.6873,48,38,5,-10
-42.03354,-20.6873,41,36,5,-5
-42.03331,-20.6873,40,33,5,-7
-42.03309,-20.6873,40,33,5,-7
-42.03286,-20.6873,40,32,5,-8
-42.03241,-20.6873,41,32,5,-9
-42.03219,-20.6873,42,32,5,-10
-42.03196,-20.6873,41,32,5,-9
-42.03174,-20.6873,42,32,5,-10
-42.03129,-20.6873,42,32,5,-10
-42.03106,-20.6873,42,33,5,-9
-42.03084,-20.6873,45,33,5,-12
-42.03062,-20.6873,43,33,5,-10
-42.03017,-20.6873,42,32,5,-10
-42.02994,-20.6873,41,32,5,-9
-42.02972,-20.6873,41,32,5,-9
-42.02949,-20.6873,41,32,5,-9
-42.02927,-20.6873,41,33,5,-8
-42.02882,-20.6873,41,34,5,-7
-42.02859,-20.6873,43,34,0,-9
-42.02837,-20.6873,45,34,0,-11
-42.02814,-20.6873,46,34,0,-12
-42.02769,-20.6873,46,34,0,-12
-42.02747,-20.6873,47,34,0,-13
-42.02724,-20.6873,48,34,0,-14
-42.02702,-20.6873,48,34,0,-14
-42.02657,-20.6873,47,34,0,-13
-42.02635,-20.6873,47,34,0,-13
-42.02612,-20.6873,47,34,0,-13
-42.0259,-20.6873,46,34,0,-12
-42.02545,-20.6873,47,36,0,-11
-42.02522,-20.6873,48,36,0,-12
-42.025,-20.6873,49,35,0,-14
-42.02477,-20.6873,50,36,0,-14
-42.02455,-20.6873,50,42,0,-8
-42.0241,-20.6873,50,44,0,-6
-42.02387,-20.6873,50,44,0,-6
-42.02365,-20.6873,50,46,0,-4
-42.02342,-20.6873,50,47,0,-3
-42.02297,-20.6873,50,47,0,-3
-42.02275,-20.6873,49,46,5,-3
-42.02253,-20.6873,49,34,5,-15
-42.0223,-20.6873,48,32,5,-16
-42.02185,-20.6873,47,36,5,-11
-42.02163,-20.6873,46,40,11,-6
-42.0214,-20.6873,45,36,5,-9
-42.02118,-20.6873,45,36,5,-9
-42.02073,-20.6873,45,34,5,-11
-42.0205,-20.6873,46,32,5,-14
-42.02028,-20.6873,46,32,5,-14
-42.02005,-20.6873,46,32,5,-14
-42.01983,-20.6873,46,32,5,-14
-42.01938,-20.6873,46,36,5,-10
-42.01915,-20.6873,46,34,5,-12
-42.01893,-20.6873,45,37,5,-8
-42.01871,-20.6873,44,36,5,-8
-42.01826,-20.6873,43,42,5,-1
-42.01803,-20.6873,42,42,5,0
-42.01781,-20.6873,41,42,5,1
-42.01758,-20.6873,41,39,5,-2
-42.01713,-20.6873,48,45,5,-3
-42.01691,-20.6873,54,41,0,-13
-42.01668,-20.6873,54,41,0,-13
-42.01646,-20.6873,55,38,0,-17
-42.01601,-20.6873,56,38,0,-18
-42.01578,-20.6873,58,39,0,-19
-42.01556,-20.6873,59,40,0,-19
-42.01533,-20.6873,58,39,0,-19
-42.01511,-20.6873,58,39,0,-19
-42.01466,-20.6873,59,39,0,-20
-42.01444,-20.6873,59,39,0,-20
-42.01421,-20.6873,60,38,0,-22
-42.01399,-20.6873,59,38,5,-21
-42.01354,-20.6873,58,38,5,-20
-42.01331,-20.6873,57,36,5,-21
-42.01309,-20.6873,56,33,5,-23
-42.01286,-20.6873,55,36,5,-19
-42.01241,-20.6873,55,38,5,-17
-42.01219,-20.6873,57,47,5,-10
-42.01196,-20.6873,58,48,5,-10
-42.01174,-20.6873,58,48,5,-10
-42.01129,-20.6873,58,48,5,-10
-42.01106,-20.6873,58,43,5,-15
-42.01084,-20.6873,59,39,5,-20
-42.01062,-20.6873,59,39,5,-20
-42.01017,-20.6873,59,38,5,-21
-42.00994,-20.6873,59,36,5,-23
-42.00972,-20.6873,58,36,5,-22
-42.00949,-20.6873,58,36,5,-22
-42.00927,-20.6873,58,35,5,-23
-42.00882,-20.6873,58,36,5,-22
-42.00859,-20.6873,58,37,5,-21
-42.00837,-20.6873,58,37,5,-21
-42.00814,-20.6873,59,37,5,-22
-42.00769,-20.6873,60,37,0,-23
-42.00747,-20.6873,59,37,5,-22
-42.00724,-20.6873,60,35,5,-25
-42.00702,-20.6873,60,33,5,-27
-42.00657,-20.6873,61,34,5,-27
-42.00635,-20.6873,60,35,5,-25
-42.00612,-20.6873,60,37,5,-23
-42.0059,-20.6873,60,37,5,-23
-42.00545,-20.6873,60,37,5,-23
-42.00522,-20.6873,59,35,5,-24
-42.005,-20.6873,59,38,5,-21
-42.00477,-20.6873,59,45,5,-14
-42.00455,-20.6873,59,45,5,-14
-42.0041,-20.6873,59,45,5,-14
-42.00387,-20.6873,59,38,5,-21
-42.00365,-20.6873,58,37,5,-21
-42.00342,-20.6873,58,36,5,-22
-42.00298,-20.6873,59,34,5,-25
-42.00275,-20.6873,56,34,5,-22
-42.00253,-20.6873,56,34,5,-22
-42.0023,-20.6873,59,41,5,-18
-42.00185,-20.6873,61,41,5,-20
-42.00163,-20.6873,60,33,5,-27
-42.0014,-20.6873,60,34,5,-26
-42.00118,-20.6873,64,35,5,-29
-42.00073,-20.6873,64,35,5,-29
-42.0005,-20.6873,63,34,5,-29
-42.00028,-20.6873,60,34,5,-26
-42.00005,-20.6873,61,36,5,-25
-41.99983,-20.6873,57,36,5,-21
-41.99938,-20.6873,55,41,5,-14
-41.99916,-20.6873,62,38,5,-24
-41.99893,-20.6873,54,38,5,-16
-41.99871,-20.6873,57,33,5,-24
-41.99826,-20.6873,51,36,5,-15
-41.99803,-20.6873,51,38,5,-13
-41.99781,-20.6873,58,40,5,-18
-41.99758,-20.6873,63,42,5,-21
-41.99713,-20.6873,67,42,5,-25
-41.99691,-20.6873,64,42,5,-22
-41.99668,-20.6873,64,42,5,-22
-41.99646,-20.6873,67,42,5,-25
-41.99601,-20.6873,68,41,5,-27
-41.99578,-20.6873,67,36,5,-31
-41.99556,-20.6873,68,35,5,-33
-41.99533,-20.6873,68,36,5,-32
-41.99511,-20.6873,69,40,0,-29
-41.99466,-20.6873,67,40,0,-27
-41.99444,-20.6873,67,37,5,-30
-41.99421,-20.6873,72,31,5,-41
-41.99399,-20.6873,69,30,5,-39
-41.99354,-20.6873,64,33,5,-31
-41.99331,-20.6873,63,36,0,-27
-41.99309,-20.6873,63,39,0,-24
-41.99286,-20.6873,62,41,0,-21
-41.99241,-20.6873,61,41,5,-20
-41.99219,-20.6873,62,41,5,-21
-41.99196,-20.6873,63,38,5,-25
-41.99174,-20.6873,62,34,5,-28
-41.99129,-20.6873,61,33,0,-28
-41.99107,-20.6873,61,34,0,-27
-41.99084,-20.6873,58,33,0,-25
-41.99062,-20.6873,58,34,0,-24
-41.99017,-20.6873,58,33,0,-25
-41.98994,-20.6873,65,33,0,-32
-41.98972,-20.6873,66,33,0,-33
-41.98949,-20.6873,68,33,0,-35
-41.98927,-20.6873,67,33,0,-34
-41.98882,-20.6873,66,34,0,-32
-41.98859,-20.6873,65,34,0,-31
-41.98837,-20.6873,62,36,0,-26
-41.98814,-20.6873,60,38,0,-22
-41.98769,-20.6873,59,40,0,-19
-41.98747,-20.6873,63,40,0,-23
-41.98725,-20.6873,62,40,0,-22
-41.98702,-20.6873,64,40,0,-24
-41.98657,-20.6873,62,40,0,-22
-41.98635,-20.6873,59,40,0,-19
-41.98612,-20.6873,57,40,0,-17
-41.9859,-20.6873,61,40,0,-21
-41.98545,-20.6873,64,40,0,-24
-41.98522,-20.6873,65,41,0,-24
-41.985,-20.6873,64,41,0,-23
-41.98477,-20.6873,65,41,5,-24
-41.98455,-20.6873,65,41,5,-24
-41.9841,-20.6873,67,39,5,-28
-41.98387,-20.6873,66,41,5,-25
-41.98365,-20.6873,66,41,0,-25
-41.98343,-20.6873,67,41,0,-26
-41.98298,-20.6873,67,41,0,-26
-41.98275,-20.6873,66,41,0,-25
-41.98253,-20.6873,65,41,0,-24
-41.9823,-20.6873,64,42,0,-22
-41.98185,-20.6873,63,42,0,-21
-41.98163,-20.6873,56,42,0,-14
-41.9814,-20.6873,53,42,0,-11
-41.98118,-20.6873,48,42,0,-6
-41.98073,-20.6873,52,42,5,-10
-41.9805,-20.6873,48,29,5,-19
-41.98028,-20.6873,48,30,5,-18
-41.98005,-20.6873,48,42,5,-6
-41.97983,-20.6873,48,42,0,-6
-41.97938,-20.6873,60,42,5,-18
-41.97916,-20.6873,59,42,5,-17
-41.97893,-20.6873,49,33,5,-16
-41.97871,-20.6873,49,29,5,-20
-41.97826,-20.6873,49,29,5,-20
-41.97803,-20.6873,49,29,5,-20
-41.97781,-20.6873,49,32,5,-17
-41.97758,-20.6873,48,32,5,-16
-41.97713,-20.6873,49,30,5,-19
-41.97691,-20.6873,49,32,5,-17
-41.97668,-20.6873,49,32,5,-17
-41.97646,-20.6873,63,32,5,-31
-41.97601,-20.6873,61,32,5,-29
-41.97578,-20.6873,62,32,5,-30
-41.97556,-20.6873,62,32,5,-30
-41.97534,-20.6873,62,34,5,-28
-41.97511,-20.6873,64,36,5,-28
-41.97466,-20.6873,63,37,5,-26
-41.97444,-20.6873,61,37,5,-24
-41.97421,-20.6873,58,34,5,-24
-41.97399,-20.6873,52,39,5,-13
-41.97354,-20.6873,49,43,5,-6
-41.97331,-20.6873,49,32,5,-17
-41.97309,-20.6873,49,28,5,-21
-41.97286,-20.6873,49,27,5,-22
-41.97241,-20.6873,49,26,5,-23
-41.97219,-20.6873,49,27,5,-22
-41.97196,-20.6873,49,26,5,-23
-41.97174,-20.6873,64,28,5,-36
-41.97129,-20.6873,64,31,5,-33
-41.97107,-20.6873,68,31,0,-37
-41.97084,-20.6873,70,32,0,-38
-41.97062,-20.6873,68,32,0,-36
-41.97017,-20.6873,67,32,5,-35
-41.96994,-20.6873,67,32,5,-35
-41.96972,-20.6873,67,33,5,-34
-41.96949,-20.6873,72,34,5,-38
-41.96927,-20.6873,70,35,5,-35
-42.1005,-20.68688,66,30,5,-36
-42.0978,-20.68688,67,35,5,-32
-42.09511,-20.68688,69,32,5,-37
-42.09219,-20.68688,60,38,5,-22
-42.08949,-20.68688,65,31,5,-34
-42.08657,-20.68688,64,32,5,-32
-42.08387,-20.68688,67,37,5,-30
-42.08118,-20.68688,64,35,5,-29
-42.07825,-20.68688,60,35,5,-25
-42.07556,-20.68688,60,34,5,-26
-42.07286,-20.68688,62,44,0,-18
-42.06994,-20.68688,65,39,0,-26
-42.06724,-20.68688,64,44,5,-20
-42.06455,-20.68688,74,45,0,-29
-42.06163,-20.68688,64,45,11,-19
-42.05893,-20.68688,63,36,5,-27
-42.05601,-20.68688,61,34,5,-27
-42.05331,-20.68688,62,43,0,-19
-42.05061,-20.68688,57,47,5,-10
-42.04769,-20.68688,77,35,5,-42
-42.045,-20.68688,61,48,0,-13
-42.0423,-20.68688,56,42,0,-14
-42.03938,-20.68688,59,49,0,-10
-42.03668,-20.68688,58,34,5,-24
-42.03399,-20.68688,48,34,5,-14
-42.03106,-20.68688,43,32,5,-11
-42.02837,-20.68688,43,35,0,-8
-42.02545,-20.68688,45,36,0,-9
-42.02275,-20.68688,49,45,5,-4
-42.02005,-20.68688,45,35,5,-10
-42.01713,-20.68688,50,35,5,-15
-42.01444,-20.68688,58,40,0,-18
-42.01174,-20.68688,57,48,5,-9
-42.00882,-20.68688,58,35,5,-23
-42.00612,-20.68688,60,37,5,-23
-42.00342,-20.68688,58,35,5,-23
-42.0005,-20.68688,63,34,5,-29
-41.99781,-20.68688,58,40,5,-18
-41.99511,-20.68688,67,33,0,-34
-41.99219,-20.68688,61,41,5,-20
-41.98949,-20.68688,67,33,0,-34
-41.98657,-20.68688,62,40,0,-22
-41.98387,-20.68688,67,41,0,-26
-41.98118,-20.68688,54,42,0,-12
-41.97826,-20.68688,49,29,5,-20
-41.97556,-20.68688,64,40,5,-24
-41.97286,-20.68688,49,29,5,-20
-41.96994,-20.68688,67,33,0,-34
-42.1005,-20.68667,67,30,5,-37
-42.0978,-20.68667,68,32,5,-36
-42.09511,-20.68667,69,31,5,-38
-42.09219,-20.68667,60,36,5,-24
-42.08949,-20.68667,65,32,5,-33
-42.08657,-20.68667,64,32,5,-32
-42.08387,-20.68667,68,35,5,-33
-42.08118,-20.68667,68,35,5,-33
-42.07825,-20.68667,60,34,5,-26
-42.07556,-20.68667,60,34,5,-26
-42.07286,-20.68667,62,44,0,-18
-42.06994,-20.68667,65,40,0,-25
-42.06724,-20.68667,63,44,5,-19
-42.06455,-20.68667,82,45,0,-37
-42.06163,-20.68667,64,45,0,-19
-42.05893,-20.68667,65,36,5,-29
-42.05601,-20.68667,63,35,5,-28
-42.05331,-20.68667,61,43,0,-18
-42.05061,-20.68667,61,47,5,-14
-42.04769,-20.68667,76,35,5,-41
-42.045,-20.68667,59,48,0,-11
-42.0423,-20.68667,56,42,0,-14
-42.03938,-20.68667,59,49,0,-10
-42.03668,-20.68667,57,34,5,-23
-42.03399,-20.68667,62,34,5,-28
-42.03106,-20.68667,43,34,5,-9
-42.02837,-20.68667,42,35,5,-7
-42.02545,-20.68667,45,38,0,-7
-42.02275,-20.68667,49,47,5,-2
-42.02005,-20.68667,45,37,5,-8
-42.01713,-20.68667,52,35,5,-17
-42.01444,-20.68667,58,41,0,-17
-42.01174,-20.68667,56,48,5,-8
-42.00882,-20.68667,57,35,5,-22
-42.00612,-20.68667,59,36,5,-23
-42.00342,-20.68667,58,34,5,-24
-42.0005,-20.68667,61,34,5,-27
-41.99781,-20.68667,60,36,5,-24
-41.99511,-20.68667,65,33,0,-32
-41.99219,-20.68667,59,41,5,-18
-41.98949,-20.68667,57,33,0,-24
-41.98657,-20.68667,61,40,0,-21
-41.98387,-20.68667,69,41,0,-28
-41.98118,-20.68667,56,42,0,-14
-41.97826,-20.68667,61,28,5,-33
-41.97556,-20.68667,68,36,5,-32
-41.97286,-20.68667,49,29,5,-20
-41.96994,-20.68667,69,33,0,-36
-42.1005,-20.68646,67,33,5,-34
-42.0978,-20.68646,67,32,5,-35
-42.09511,-20.68646,70,32,5,-38
-42.09219,-20.68646,60,40,5,-20
-42.08949,-20.68646,65,32,5,-33
-42.08657,-20.68646,64,32,5,-32
-42.08387,-20.68646,67,38,5,-29
-42.08118,-20.68646,67,35,5,-32
-42.07825,-20.68646,60,33,5,-27
-42.07556,-20.68646,60,34,5,-26
-42.07286,-20.68646,62,44,0,-18
-42.06994,-20.68646,66,43,5,-23
-42.06724,-20.68646,62,44,5,-18
-42.06455,-20.68646,82,45,0,-37
-42.06163,-20.68646,64,45,0,-19
-42.05893,-20.68646,64,37,5,-27
-42.05601,-20.68646,61,36,5,-25
-42.05331,-20.68646,61,44,0,-17
-42.05061,-20.68646,62,37,5,-25
-42.04769,-20.68646,76,36,5,-40
-42.045,-20.68646,59,48,0,-11
-42.0423,-20.68646,56,42,0,-14
-42.03938,-20.68646,58,49,0,-9
-42.03668,-20.68646,57,35,5,-22
-42.03399,-20.68646,60,38,0,-22
-42.03106,-20.68646,53,35,5,-18
-42.02837,-20.68646,42,36,5,-6
-42.02545,-20.68646,54,39,0,-15
-42.02275,-20.68646,49,46,5,-3
-42.02005,-20.68646,44,43,5,-1
-42.01713,-20.68646,55,35,5,-20
-42.01444,-20.68646,57,42,0,-15
-42.01174,-20.68646,55,47,5,-8
-42.00882,-20.68646,57,35,5,-22
-42.00612,-20.68646,58,37,5,-21
-42.00342,-20.68646,59,34,5,-25
-42.0005,-20.68646,61,34,5,-27
-41.99781,-20.68646,60,35,5,-25
-41.99511,-20.68646,64,33,0,-31
-41.99219,-20.68646,58,33,5,-25
-41.98949,-20.68646,56,33,0,-23
-41.98657,-20.68646,56,40,0,-16
-41.98387,-20.68646,69,41,0,-28
-41.98118,-20.68646,57,42,0,-15
-41.97826,-20.68646,66,28,5,-38
-41.97556,-20.68646,67,36,5,-31
-41.97286,-20.68646,49,30,5,-19
-41.96994,-20.68646,70,34,0,-36
-42.1005,-20.68603,67,33,5,-34
-42.0978,-20.68603,67,31,5,-36
-42.09511,-20.68603,70,33,5,-37
-42.09219,-20.68603,62,40,5,-22
-42.08949,-20.68603,64,32,5,-32
-42.08657,-20.68603,64,32,5,-32
-42.08387,-20.68603,68,42,0,-26
-42.08118,-20.68603,67,35,5,-32
-42.07825,-20.68603,60,32,5,-28
-42.07556,-20.68603,60,33,5,-27
-42.07286,-20.68603,61,44,0,-17
-42.06994,-20.68603,67,38,5,-29
-42.06724,-20.68603,63,45,5,-18
-42.06455,-20.68603,78,45,0,-33
-42.06163,-20.68603,63,45,11,-18
-42.05893,-20.68603,65,37,5,-28
-42.05601,-20.68603,59,43,5,-16
-42.05331,-20.68603,61,44,0,-17
-42.05061,-20.68603,62,35,5,-27
-42.04769,-20.68603,76,36,5,-40
-42.045,-20.68603,59,48,0,-11
-42.0423,-20.68603,56,41,0,-15
-42.03938,-20.68603,58,49,0,-9
-42.03668,-20.68603,57,33,5,-24
-42.03399,-20.68603,59,38,5,-21
-42.03106,-20.68603,52,36,5,-16
-42.02837,-20.68603,52,37,5,-15
-42.02545,-20.68603,46,42,0,-4
-42.02275,-20.68603,49,47,0,-2
-42.02005,-20.68603,44,43,5,-1
-42.01713,-20.68603,56,36,5,-20
-42.01444,-20.68603,57,45,0,-12
-42.01174,-20.68603,55,47,5,-8
-42.00882,-20.68603,56,38,5,-18
-42.00612,-20.68603,58,37,5,-21
-42.00342,-20.68603,58,34,5,-24
-42.0005,-20.68603,60,37,5,-23
-41.99781,-20.68603,62,37,5,-25
-41.99511,-20.68603,64,32,0,-32
-41.99219,-20.68603,59,34,5,-25
-41.98949,-20.68603,66,34,0,-32
-41.98657,-20.68603,56,40,0,-16
-41.98387,-20.68603,67,41,0,-26
-41.98118,-20.68603,57,42,0,-15
-41.97826,-20.68603,68,30,5,-38
-41.97556,-20.68603,67,33,5,-34
-41.97286,-20.68603,49,31,5,-18
-41.96994,-20.68603,68,34,5,-34
-42.1005,-20.68582,67,33,5,-34
-42.0978,-20.68582,69,31,5,-38
-42.09511,-20.68582,70,34,5,-36
-42.09219,-20.68582,61,38,5,-23
-42.08949,-20.68582,64,33,5,-31
-42.08657,-20.68582,64,32,5,-32
-42.08387,-20.68582,67,42,0,-25
-42.08118,-20.68582,67,37,5,-30
-42.07825,-20.68582,60,34,5,-26
-42.07556,-20.68582,60,33,5,-27
-42.07286,-20.68582,60,43,0,-17
-42.06994,-20.68582,67,35,5,-32
-42.06724,-20.68582,62,45,0,-17
-42.06455,-20.68582,70,45,0,-25
-42.06163,-20.68582,63,45,11,-18
-42.05893,-20.68582,65,37,5,-28
-42.05601,-20.68582,59,43,5,-16
-42.05331,-20.68582,61,44,0,-17
-42.05061,-20.68582,62,35,5,-27
-42.04769,-20.68582,76,36,5,-40
-42.045,-20.68582,60,42,0,-18
-42.0423,-20.68582,55,40,0,-15
-42.03938,-20.68582,58,49,0,-9
-42.03668,-20.68582,56,33,5,-23
-42.03399,-20.68582,59,36,5,-23
-42.03106,-20.68582,60,36,5,-24
-42.02837,-20.68582,54,38,5,-16
-42.02545,-20.68582,45,39,0,-6
-42.02275,-20.68582,48,47,0,-1
-42.02005,-20.68582,43,39,5,-4
-42.01713,-20.68582,57,37,5,-20
-42.01444,-20.68582,58,45,0,-13
-42.01174,-20.68582,55,47,5,-8
-42.00882,-20.68582,55,38,5,-17
-42.00612,-20.68582,58,36,5,-22
-42.00342,-20.68582,58,33,5,-25
-42.0005,-20.68582,60,36,5,-24
-41.99781,-20.68582,62,37,5,-25
-41.99511,-20.68582,64,31,5,-33
-41.99219,-20.68582,60,33,5,-27
-41.98949,-20.68582,66,36,0,-30
-41.98657,-20.68582,56,40,0,-16
-41.98387,-20.68582,63,41,0,-22
-41.98118,-20.68582,57,42,0,-15
-41.97826,-20.68582,67,28,5,-39
-41.97556,-20.68582,67,33,5,-34
-41.97286,-20.68582,49,30,5,-19
-41.96994,-20.68582,67,30,5,-37
-42.1005,-20.68561,67,31,5,-36
-42.0978,-20.68561,68,31,5,-37
-42.09511,-20.68561,70,32,5,-38
-42.09219,-20.68561,61,42,5,-19
-42.08949,-20.68561,64,33,5,-31
-42.08657,-20.68561,64,32,5,-32
-42.08387,-20.68561,67,42,0,-25
-42.08118,-20.68561,65,37,0,-28
-42.07825,-20.68561,60,34,11,-26
-42.07556,-20.68561,60,35,0,-25
-42.07286,-20.68561,60,41,0,-19
-42.06994,-20.68561,67,37,5,-30
-42.06724,-20.68561,61,45,0,-16
-42.06455,-20.68561,69,41,5,-28
-42.06163,-20.68561,63,45,5,-18
-42.05893,-20.68561,65,36,5,-29
-42.05601,-20.68561,58,43,5,-15
-42.05331,-20.68561,62,44,0,-18
-42.05061,-20.68561,64,35,5,-29
-42.04769,-20.68561,75,39,5,-36
-42.045,-20.68561,61,42,0,-19
-42.0423,-20.68561,58,40,0,-18
-42.03938,-20.68561,58,48,0,-10
-42.03668,-20.68561,56,34,5,-22
-42.03399,-20.68561,59,34,5,-25
-42.03106,-20.68561,64,38,5,-26
-42.02837,-20.68561,59,39,5,-20
-42.02545,-20.68561,44,44,0,0
-42.02275,-20.68561,48,46,0,-2
-42.02005,-20.68561,48,39,5,-9
-42.01713,-20.68561,57,39,0,-18
-42.01444,-20.68561,59,46,0,-13
-42.01174,-20.68561,55,48,5,-7
-42.00882,-20.68561,55,39,5,-16
-42.00612,-20.68561,58,36,5,-22
-42.00342,-20.68561,58,33,5,-25
-42.0005,-20.68561,60,36,5,-24
-41.99781,-20.68561,65,37,5,-28
-41.99511,-20.68561,63,30,5,-33
-41.99219,-20.68561,61,32,5,-29
-41.98949,-20.68561,65,36,0,-29
-41.98657,-20.68561,55,40,0,-15
-41.98387,-20.68561,60,41,0,-19
-41.98118,-20.68561,57,42,0,-15
-41.97826,-20.68561,67,27,5,-40
-41.97556,-20.68561,68,32,5,-36
-41.97286,-20.68561,49,32,5,-17
-41.96994,-20.68561,66,32,5,-34
-42.1005,-20.68519,66,30,5,-36
-42.0978,-20.68519,67,30,5,-37
-42.09511,-20.68519,69,35,5,-34
-42.09219,-20.68519,61,43,5,-18
-42.08949,-20.68519,63,33,5,-30
-42.08657,-20.68519,64,32,5,-32
-42.08387,-20.68519,68,41,0,-27
-42.08118,-20.68519,65,38,0,-27
-42.07825,-20.68519,60,35,5,-25
-42.07556,-20.68519,60,36,0,-24
-42.07286,-20.68519,60,39,0,-21
-42.06994,-20.68519,67,44,5,-23
-42.06724,-20.68519,61,44,0,-17
-42.06455,-20.68519,68,35,5,-33
-42.06163,-20.68519,63,39,5,-24
-42.05893,-20.68519,64,36,5,-28
-42.05601,-20.68519,57,44,5,-13
-42.05331,-20.68519,62,44,5,-18
-42.05061,-20.68519,65,48,0,-17
-42.04769,-20.68519,74,41,0,-33
-42.045,-20.68519,59,39,0,-20
-42.0423,-20.68519,58,39,0,-19
-42.03938,-20.68519,58,48,0,-10
-42.03668,-20.68519,56,33,5,-23
-42.03399,-20.68519,58,35,5,-23
-42.03106,-20.68519,64,39,5,-25
-42.02837,-20.68519,61,39,5,-22
-42.02545,-20.68519,44,44,0,0
-42.02275,-20.68519,47,47,0,0
-42.02005,-20.68519,50,44,5,-6
-42.01713,-20.68519,55,47,0,-8
-42.01444,-20.68519,58,46,0,-12
-42.01174,-20.68519,57,48,5,-9
-42.00882,-20.68519,54,46,5,-8
-42.00612,-20.68519,58,37,5,-21
-42.00342,-20.68519,58,33,5,-25
-42.0005,-20.68519,60,40,5,-20
-41.99781,-20.68519,66,34,5,-32
-41.99511,-20.68519,63,30,5,-33
-41.99219,-20.68519,59,30,5,-29
-41.98949,-20.68519,66,36,0,-30
-41.98657,-20.68519,54,40,0,-14
-41.98387,-20.68519,58,41,0,-17
-41.98118,-20.68519,55,42,0,-13
-41.97826,-20.68519,68,30,5,-38
-41.97556,-20.68519,68,32,5,-36
-41.97286,-20.68519,49,32,5,-17
-41.96994,-20.68519,68,34,5,-34
-42.1005,-20.68498,66,29,5,-37
-42.0978,-20.68498,67,32,5,-35
-42.09511,-20.68498,68,35,5,-33
-42.09219,-20.68498,61,43,5,-18
-42.08949,-20.68498,63,33,5,-30
-42.08657,-20.68498,64,32,5,-32
-42.08387,-20.68498,67,41,0,-26
-42.08118,-20.68498,64,37,0,-27
-42.07825,-20.68498,60,35,5,-25
-42.07556,-20.68498,60,37,0,-23
-42.07286,-20.68498,61,39,0,-22
-42.06994,-20.68498,67,41,5,-26
-42.06724,-20.68498,61,44,0,-17
-42.06455,-20.68498,67,35,5,-32
-42.06163,-20.68498,67,37,5,-30
-42.05893,-20.68498,65,36,5,-29
-42.05601,-20.68498,57,44,5,-13
-42.05331,-20.68498,62,45,5,-17
-42.05061,-20.68498,65,49,0,-16
-42.04769,-20.68498,75,40,0,-35
-42.045,-20.68498,59,37,0,-22
-42.0423,-20.68498,58,39,0,-19
-42.03938,-20.68498,58,48,0,-10
-42.03668,-20.68498,56,32,5,-24
-42.03399,-20.68498,58,35,5,-23
-42.03106,-20.68498,62,39,5,-23
-42.02837,-20.68498,60,38,5,-22
-42.02545,-20.68498,58,46,0,-12
-42.02275,-20.68498,47,47,0,0
-42.02005,-20.68498,51,38,5,-13
-42.01713,-20.68498,55,47,0,-8
-42.01444,-20.68498,58,44,0,-14
-42.01174,-20.68498,56,48,5,-8
-42.00882,-20.68498,54,44,5,-10
-42.00612,-20.68498,57,37,5,-20
-42.00342,-20.68498,58,33,5,-25
-42.0005,-20.68498,59,45,11,-14
-41.99781,-20.68498,63,35,5,-28
-41.99511,-20.68498,62,30,5,-32
-41.99219,-20.68498,57,32,5,-25
-41.98949,-20.68498,67,36,0,-31
-41.98657,-20.68498,53,40,0,-13
-41.98387,-20.68498,55,41,0,-14
-41.98118,-20.68498,54,42,0,-12
-41.97826,-20.68498,67,31,5,-36
-41.97556,-20.68498,68,28,5,-40
-41.97286,-20.68498,49,34,0,-15
-41.96994,-20.68498,68,35,0,-33
-42.1005,-20.68476,66,29,5,-37
-42.0978,-20.68476,67,32,0,-35
-42.09511,-20.68476,66,33,5,-33
-42.09219,-20.68476,61,35,5,-26
-42.08949,-20.68476,64,33,5,-31
-42.08657,-20.68476,65,32,5,-33
-42.08387,-20.68476,67,41,0,-26
-42.08118,-20.68476,65,38,5,-27
-42.07825,-20.68476,60,35,5,-25
-42.07556,-20.68476,60,37,0,-23
-42.07286,-20.68476,66,39,0,-27
-42.06994,-20.68476,67,36,5,-31
-42.06724,-20.68476,60,44,0,-16
-42.06455,-20.68476,67,35,5,-32
-42.06163,-20.68476,68,45,5,-23
-42.05893,-20.68476,66,36,5,-30
-42.05601,-20.68476,56,37,5,-19
-42.05331,-20.68476,62,37,5,-25
-42.05061,-20.68476,64,49,0,-15
-42.04769,-20.68476,74,40,0,-34
-42.045,-20.68476,60,37,0,-23
-42.0423,-20.68476,57,39,0,-18
-42.03938,-20.68476,58,48,0,-10
-42.03668,-20.68476,55,33,5,-22
-42.03399,-20.68476,58,36,5,-22
-42.03106,-20.68476,65,36,5,-29
-42.02837,-20.68476,61,35,5,-26
-42.02545,-20.68476,64,47,0,-17
-42.02275,-20.68476,48,46,0,-2
-42.02005,-20.68476,54,38,5,-16
-42.01713,-20.68476,55,47,0,-8
-42.01444,-20.68476,58,39,0,-19
-42.01174,-20.68476,61,44,5,-17
-42.00882,-20.68476,54,48,5,-6
-42.00612,-20.68476,56,41,5,-15
-42.00342,-20.68476,58,33,5,-25
-42.0005,-20.68476,57,41,5,-16
-41.99781,-20.68476,65,42,5,-23
-41.99511,-20.68476,62,30,5,-32
-41.99219,-20.68476,57,36,0,-21
-41.98949,-20.68476,53,36,0,-17
-41.98657,-20.68476,53,40,0,-13
-41.98387,-20.68476,53,41,0,-12
-41.98118,-20.68476,54,42,0,-12
-41.97826,-20.68476,70,33,5,-37
-41.97556,-20.68476,66,28,5,-38
-41.97286,-20.68476,55,34,0,-21
-41.96994,-20.68476,67,35,0,-32
-42.10297,-20.68434,65,33,0,-32
-42.10275,-20.68434,65,32,0,-33
-42.10252,-20.68434,66,31,0,-35
-42.1023,-20.68434,66,31,0,-35
-42.10185,-20.68434,65,31,5,-34
-42.10163,-20.68434,65,30,5,-35
-42.1014,-20.68434,65,30,5,-35
-42.10118,-20.68434,66,30,5,-36
-42.10073,-20.68434,65,30,0,-35
-42.1005,-20.68434,66,30,0,-36
-42.10028,-20.68434,66,30,0,-36
-42.10005,-20.68434,66,30,0,-36
-42.09983,-20.68434,66,30,0,-36
-42.09938,-20.68434,66,29,0,-37
-42.09915,-20.68434,66,29,0,-37
-42.09893,-20.68434,66,29,0,-37
-42.0987,-20.68434,66,29,0,-37
-42.09825,-20.68434,67,32,0,-35
-42.09803,-20.68434,67,32,0,-35
-42.0978,-20.68434,67,32,0,-35
-42.09758,-20.68434,67,33,0,-34
-42.09713,-20.68434,67,32,0,-35
-42.09691,-20.68434,67,33,0,-34
-42.09668,-20.68434,67,33,0,-34
-42.09646,-20.68434,67,33,0,-34
-42.09601,-20.68434,69,32,0,-37
-42.09578,-20.68434,71,32,0,-39
-42.09556,-20.68434,67,31,5,-36
-42.09533,-20.68434,69,32,5,-37
-42.09511,-20.68434,65,32,5,-33
-42.09466,-20.68434,67,32,5,-35
-42.09443,-20.68434,71,32,5,-39
-42.09421,-20.68434,61,32,5,-29
-42.09398,-20.68434,61,33,5,-28
-42.09354,-20.68434,61,32,5,-29
-42.09331,-20.68434,61,33,5,-28
-42.09309,-20.68434,61,32,5,-29
-42.09286,-20.68434,61,32,5,-29
-42.09241,-20.68434,61,33,5,-28
-42.09219,-20.68434,61,34,5,-27
-42.09196,-20.68434,61,36,5,-25
-42.09174,-20.68434,61,34,5,-27
-42.09129,-20.68434,61,37,5,-24
-42.09106,-20.68434,62,36,5,-26
-42.09084,-20.68434,62,36,5,-26
-42.09061,-20.68434,63,33,5,-30
-42.09039,-20.68434,63,33,5,-30
-42.08994,-20.68434,63,33,5,-30
-42.08972,-20.68434,63,35,5,-28
-42.08949,-20.68434,63,33,5,-30
-42.08927,-20.68434,63,32,5,-31
-42.08882,-20.68434,63,32,5,-31
-42.08859,-20.68434,63,31,5,-32
-42.08837,-20.68434,63,31,5,-32
-42.08814,-20.68434,64,32,5,-32
-42.08769,-20.68434,64,32,5,-32
-42.08747,-20.68434,64,32,5,-32
-42.08724,-20.68434,64,32,5,-32
-42.08702,-20.68434,65,31,5,-34
-42.08657,-20.68434,65,34,0,-31
-42.08634,-20.68434,65,38,0,-27
-42.08612,-20.68434,65,37,0,-28
-42.08589,-20.68434,66,39,0,-27
-42.08545,-20.68434,66,37,0,-29
-42.08522,-20.68434,66,36,0,-30
-42.085,-20.68434,66,33,5,-33
-42.08477,-20.68434,66,35,5,-31
-42.08455,-20.68434,67,34,5,-33
-42.0841,-20.68434,67,40,5,-27
-42.08387,-20.68434,67,41,5,-26
-42.08365,-20.68434,68,40,5,-28
-42.08342,-20.68434,69,40,5,-29
-42.08297,-20.68434,69,40,5,-29
-42.08275,-20.68434,69,39,5,-30
-42.08252,-20.68434,68,39,5,-29
-42.0823,-20.68434,68,39,5,-29
-42.08185,-20.68434,67,39,5,-28
-42.08163,-20.68434,66,38,5,-28
-42.0814,-20.68434,64,37,0,-27
-42.08118,-20.68434,67,36,5,-31
-42.08073,-20.68434,67,35,5,-32
-42.0805,-20.68434,69,35,5,-34
-42.08028,-20.68434,69,35,5,-34
-42.08005,-20.68434,66,35,5,-31
-42.07983,-20.68434,66,35,5,-31
-42.07938,-20.68434,65,36,5,-29
-42.07915,-20.68434,64,35,5,-29
-42.07893,-20.68434,60,35,5,-25
-42.0787,-20.68434,60,34,5,-26
-42.07825,-20.68434,60,35,5,-25
-42.07803,-20.68434,60,35,11,-25
-42.07781,-20.68434,60,35,5,-25
-42.07758,-20.68434,60,35,5,-25
-42.07713,-20.68434,60,37,5,-23
-42.07691,-20.68434,60,37,0,-23
-42.07668,-20.68434,60,37,0,-23
-42.07646,-20.68434,60,37,0,-23
-42.07601,-20.68434,60,37,0,-23
-42.07578,-20.68434,59,37,0,-22
-42.07556,-20.68434,60,37,0,-23
-42.07533,-20.68434,60,37,0,-23
-42.07511,-20.68434,63,38,0,-25
-42.07466,-20.68434,63,37,0,-26
-42.07443,-20.68434,60,37,0,-23
-42.07421,-20.68434,60,38,0,-22
-42.07399,-20.68434,60,38,0,-22
-42.07354,-20.68434,60,37,0,-23
-42.07331,-20.68434,60,36,0,-24
-42.07309,-20.68434,60,36,0,-24
-42.07286,-20.68434,61,38,0,-23
-42.07241,-20.68434,62,36,0,-26
-42.07219,-20.68434,62,36,0,-26
-42.07196,-20.68434,63,38,0,-25
-42.07174,-20.68434,64,40,0,-24
-42.07129,-20.68434,66,44,0,-22
-42.07106,-20.68434,67,44,0,-23
-42.07084,-20.68434,67,44,5,-23
-42.07061,-20.68434,67,36,5,-31
-42.07039,-20.68434,67,35,5,-32
-42.06994,-20.68434,67,36,5,-31
-42.06972,-20.68434,67,35,5,-32
-42.06949,-20.68434,67,36,5,-31
-42.06927,-20.68434,67,36,5,-31
-42.06882,-20.68434,67,37,5,-30
-42.06859,-20.68434,67,35,5,-32
-42.06837,-20.68434,68,35,5,-33
-42.06814,-20.68434,69,45,5,-24
-42.06769,-20.68434,67,45,0,-22
-42.06747,-20.68434,66,45,0,-21
-42.06724,-20.68434,60,45,0,-15
-42.06702,-20.68434,61,44,0,-17
-42.06657,-20.68434,61,45,0,-16
-42.06634,-20.68434,61,45,0,-16
-42.06612,-20.68434,61,45,0,-16
-42.0659,-20.68434,62,44,0,-18
-42.06545,-20.68434,62,44,0,-18
-42.06522,-20.68434,62,44,0,-18
-42.065,-20.68434,63,43,0,-20
-42.06477,-20.68434,64,43,5,-21
-42.06455,-20.68434,66,34,5,-32
-42.0641,-20.68434,68,35,5,-33
-42.06387,-20.68434,81,36,5,-45
-42.06365,-20.68434,81,36,5,-45
-42.06342,-20.68434,81,37,5,-44
-42.06297,-20.68434,70,45,5,-25
-42.06275,-20.68434,70,45,0,-25
-42.06252,-20.68434,71,45,5,-26
-42.0623,-20.68434,70,37,5,-33
-42.06185,-20.68434,69,45,5,-24
-42.06163,-20.68434,68,37,5,-31
-42.0614,-20.68434,68,35,5,-33
-42.06118,-20.68434,67,36,5,-31
-42.06073,-20.68434,66,37,5,-29
-42.0605,-20.68434,67,37,5,-30
-42.06028,-20.68434,67,38,5,-29
-42.06005,-20.68434,66,38,5,-28
-42.05983,-20.68434,62,37,5,-25
-42.05938,-20.68434,63,37,5,-26
-42.05915,-20.68434,65,38,5,-27
-42.05893,-20.68434,65,40,5,-25
-42.0587,-20.68434,64,37,5,-27
-42.05826,-20.68434,62,37,5,-25
-42.05803,-20.68434,62,36,5,-26
-42.05781,-20.68434,64,43,5,-21
-42.05758,-20.68434,65,43,5,-22
-42.05713,-20.68434,63,44,5,-19
-42.05691,-20.68434,63,44,5,-19
-42.05668,-20.68434,57,44,5,-13
-42.05646,-20.68434,56,44,5,-12
-42.05601,-20.68434,56,44,5,-12
-42.05578,-20.68434,56,45,5,-11
-42.05556,-20.68434,55,45,5,-10
-42.05533,-20.68434,55,45,5,-10
-42.05511,-20.68434,55,36,5,-19
-42.05466,-20.68434,56,35,5,-21
-42.05443,-20.68434,57,34,5,-23
-42.05421,-20.68434,58,33,5,-25
-42.05399,-20.68434,59,33,5,-26
-42.05354,-20.68434,60,35,5,-25
-42.05331,-20.68434,62,37,5,-25
-42.05309,-20.68434,63,37,5,-26
-42.05286,-20.68434,63,37,5,-26
-42.05241,-20.68434,64,35,5,-29
-42.05219,-20.68434,64,37,5,-27
-42.05196,-20.68434,65,41,5,-24
-42.05174,-20.68434,64,47,5,-17
-42.05129,-20.68434,64,43,5,-21
-42.05106,-20.68434,64,39,5,-25
-42.05084,-20.68434,64,50,5,-14
-42.05061,-20.68434,65,50,0,-15
-42.05039,-20.68434,65,50,0,-15
-42.04994,-20.68434,65,50,0,-15
-42.04972,-20.68434,65,50,0,-15
-42.04949,-20.68434,65,50,0,-15
-42.04927,-20.68434,64,43,0,-21
-42.04882,-20.68434,72,40,0,-32
-42.04859,-20.68434,73,40,0,-33
-42.04837,-20.68434,74,39,0,-35
-42.04814,-20.68434,74,38,0,-36
-42.04769,-20.68434,74,36,0,-38
-42.04747,-20.68434,74,36,0,-38
-42.04724,-20.68434,74,37,0,-37
-42.04702,-20.68434,67,37,0,-30
-42.04657,-20.68434,65,37,0,-28
-42.04635,-20.68434,66,36,0,-30
-42.04612,-20.68434,66,36,0,-30
-42.0459,-20.68434,65,35,0,-30
-42.04545,-20.68434,63,35,0,-28
-42.04522,-20.68434,60,37,0,-23
-42.045,-20.68434,59,37,0,-22
-42.04477,-20.68434,57,35,0,-22
-42.04455,-20.68434,56,36,0,-20
-42.0441,-20.68434,53,36,0,-17
-42.04387,-20.68434,54,36,0,-18
-42.04365,-20.68434,55,37,0,-18
-42.04342,-20.68434,58,37,0,-21
-42.04297,-20.68434,56,38,0,-18
-42.04275,-20.68434,57,39,0,-18
-42.04253,-20.68434,56,40,0,-16
-42.0423,-20.68434,57,40,0,-17
-42.04185,-20.68434,57,40,0,-17
-42.04163,-20.68434,57,39,0,-18
-42.0414,-20.68434,58,38,0,-20
-42.04118,-20.68434,58,39,0,-19
-42.04073,-20.68434,58,38,0,-20
-42.0405,-20.68434,58,38,0,-20
-42.04028,-20.68434,58,41,0,-17
-42.04005,-20.68434,58,41,0,-17
-42.03983,-20.68434,58,42,0,-16
-42.03938,-20.68434,58,48,0,-10
-42.03915,-20.68434,58,46,0,-12
-42.03893,-20.68434,58,43,0,-15
-42.0387,-20.68434,57,46,0,-11
-42.03826,-20.68434,57,47,0,-10
-42.03803,-20.68434,57,47,0,-10
-42.03781,-20.68434,57,46,0,-11
-42.03758,-20.68434,56,45,0,-11
-42.03713,-20.68434,56,40,0,-16
-42.03691,-20.68434,56,40,0,-16
-42.03668,-20.68434,55,37,0,-18
-42.03646,-20.68434,55,39,0,-16
-42.03601,-20.68434,54,39,0,-15
-42.03578,-20.68434,54,39,0,-15
-42.03556,-20.68434,54,39,0,-15
-42.03533,-20.68434,54,39,5,-15
-42.03511,-20.68434,54,33,5,-21
-42.03466,-20.68434,54,33,5,-21
-42.03444,-20.68434,55,32,5,-23
-42.03421,-20.68434,56,32,5,-24
-42.03399,-20.68434,58,34,5,-24
-42.03354,-20.68434,58,37,5,-21
-42.03331,-20.68434,59,39,5,-20
-42.03309,-20.68434,60,34,5,-26
-42.03286,-20.68434,61,34,5,-27
-42.03241,-20.68434,63,35,5,-28
-42.03219,-20.68434,63,34,5,-29
-42.03196,-20.68434,64,36,5,-28
-42.03174,-20.68434,63,38,5,-25
-42.03129,-20.68434,63,38,5,-25
-42.03106,-20.68434,63,36,5,-27
-42.03084,-20.68434,62,35,5,-27
-42.03062,-20.68434,62,35,5,-27
-42.03017,-20.68434,61,35,5,-26
-42.02994,-20.68434,62,34,5,-28
-42.02972,-20.68434,62,33,5,-29
-42.02949,-20.68434,62,34,5,-28
-42.02927,-20.68434,61,33,5,-28
-42.02882,-20.68434,63,33,5,-30
-42.02859,-20.68434,63,33,5,-30
-42.02837,-20.68434,63,33,5,-30
-42.02814,-20.68434,61,32,5,-29
-42.02769,-20.68434,60,32,5,-28
-42.02747,-20.68434,61,32,5,-29
-42.02724,-20.68434,61,33,5,-28
-42.02702,-20.68434,63,36,0,-27
-42.02657,-20.68434,66,43,0,-23
-42.02635,-20.68434,66,41,0,-25
-42.02612,-20.68434,67,46,0,-21
-42.0259,-20.68434,65,47,0,-18
-42.02545,-20.68434,64,47,0,-17
-42.02522,-20.68434,63,47,0,-16
-42.025,-20.68434,63,43,0,-20
-42.02477,-20.68434,64,45,0,-19
-42.02455,-20.68434,63,45,0,-18
-42.0241,-20.68434,61,45,0,-16
-42.02387,-20.68434,58,35,0,-23
-42.02365,-20.68434,57,43,0,-14
-42.02342,-20.68434,54,44,0,-10
-42.02297,-20.68434,52,44,0,-8
-42.02275,-20.68434,52,45,0,-7
-42.02253,-20.68434,48,47,0,-1
-42.0223,-20.68434,48,47,0,-1
-42.02185,-20.68434,43,33,5,-10
-42.02163,-20.68434,50,31,5,-19
-42.0214,-20.68434,51,41,5,-10
-42.02118,-20.68434,48,44,11,-4
-42.02073,-20.68434,50,36,5,-14
-42.0205,-20.68434,53,34,5,-19
-42.02028,-20.68434,53,35,5,-18
-42.02005,-20.68434,55,36,5,-19
-42.01983,-20.68434,56,40,5,-16
-42.01938,-20.68434,58,47,0,-11
-42.01915,-20.68434,57,47,0,-10
-42.01893,-20.68434,58,42,0,-16
-42.01871,-20.68434,58,39,0,-19
-42.01826,-20.68434,56,37,0,-19
-42.01803,-20.68434,58,45,0,-13
-42.01781,-20.68434,58,35,5,-23
-42.01758,-20.68434,57,36,5,-21
-42.01713,-20.68434,59,37,5,-22
-42.01691,-20.68434,58,38,5,-20
-42.01668,-20.68434,58,34,5,-24
-42.01646,-20.68434,58,33,5,-25
-42.01601,-20.68434,59,32,5,-27
-42.01578,-20.68434,59,32,5,-27
-42.01556,-20.68434,58,32,5,-26
-42.01533,-20.68434,57,36,5,-21
-42.01511,-20.68434,57,46,0,-11
-42.01466,-20.68434,57,46,0,-11
-42.01444,-20.68434,58,42,0,-16
-42.01421,-20.68434,59,42,0,-17
-42.01399,-20.68434,60,42,0,-18
-42.01354,-20.68434,61,36,5,-25
-42.01331,-20.68434,60,38,5,-22
-42.01309,-20.68434,59,39,5,-20
-42.01286,-20.68434,59,42,5,-17
-42.01241,-20.68434,60,42,5,-18
-42.01219,-20.68434,62,41,5,-21
-42.01196,-20.68434,62,46,5,-16
-42.01174,-20.68434,62,46,5,-16
-42.01129,-20.68434,61,44,5,-17
-42.01106,-20.68434,60,48,5,-12
-42.01084,-20.68434,60,45,5,-15
-42.01062,-20.68434,60,42,5,-18
-42.01017,-20.68434,57,39,5,-18
-42.00994,-20.68434,57,39,5,-18
-42.00972,-20.68434,56,39,5,-17
-42.00949,-20.68434,56,39,5,-17
-42.00927,-20.68434,54,37,5,-17
-42.00882,-20.68434,54,48,5,-6
-42.00859,-20.68434,54,48,5,-6
-42.00837,-20.68434,54,47,5,-7
-42.00814,-20.68434,54,42,5,-12
-42.00769,-20.68434,55,41,5,-14
-42.00747,-20.68434,54,40,5,-14
-42.00724,-20.68434,55,37,5,-18
-42.00702,-20.68434,55,35,5,-20
-42.00657,-20.68434,55,35,5,-20
-42.00635,-20.68434,55,39,5,-16
-42.00612,-20.68434,56,47,5,-9
-42.0059,-20.68434,56,47,5,-9
-42.00545,-20.68434,57,47,5,-10
-42.00522,-20.68434,57,47,5,-10
-42.005,-20.68434,57,47,5,-10
-42.00477,-20.68434,57,47,5,-10
-42.00455,-20.68434,58,39,5,-19
-42.0041,-20.68434,57,34,5,-23
-42.00387,-20.68434,57,32,5,-25
-42.00365,-20.68434,57,33,5,-24
-42.00342,-20.68434,57,33,5,-24
-42.00298,-20.68434,57,32,5,-25
-42.00275,-20.68434,58,33,5,-25
-42.00253,-20.68434,57,34,5,-23
-42.0023,-20.68434,57,34,5,-23
-42.00185,-20.68434,56,34,5,-22
-42.00163,-20.68434,56,34,5,-22
-42.0014,-20.68434,56,37,5,-19
-42.00118,-20.68434,56,38,5,-18
-42.00073,-20.68434,56,38,5,-18
-42.0005,-20.68434,55,38,5,-17
-42.00028,-20.68434,55,36,5,-19
-42.00005,-20.68434,56,35,5,-21
-41.99983,-20.68434,57,35,5,-22
-41.99938,-20.68434,58,35,5,-23
-41.99916,-20.68434,60,35,5,-25
-41.99893,-20.68434,60,40,11,-20
-41.99871,-20.68434,60,38,5,-22
-41.99826,-20.68434,60,44,5,-16
-41.99803,-20.68434,60,44,5,-16
-41.99781,-20.68434,62,44,11,-18
-41.99758,-20.68434,63,44,11,-19
-41.99713,-20.68434,62,44,5,-18
-41.99691,-20.68434,63,44,5,-19
-41.99668,-20.68434,65,44,0,-21
-41.99646,-20.68434,67,44,0,-23
-41.99601,-20.68434,65,43,11,-22
-41.99578,-20.68434,66,43,5,-23
-41.99556,-20.68434,65,32,5,-33
-41.99533,-20.68434,63,32,5,-31
-41.99511,-20.68434,62,32,5,-30
-41.99466,-20.68434,60,32,5,-28
-41.99444,-20.68434,59,34,5,-25
-41.99421,-20.68434,59,35,5,-24
-41.99399,-20.68434,59,35,5,-24
-41.99354,-20.68434,59,38,0,-21
-41.99331,-20.68434,58,38,0,-20
-41.99309,-20.68434,58,39,0,-19
-41.99286,-20.68434,57,39,0,-18
-41.99241,-20.68434,57,39,0,-18
-41.99219,-20.68434,56,39,0,-17
-41.99196,-20.68434,54,38,0,-16
-41.99174,-20.68434,52,37,0,-15
-41.99129,-20.68434,51,36,0,-15
-41.99107,-20.68434,49,36,0,-13
-41.99084,-20.68434,48,36,0,-12
-41.99062,-20.68434,47,36,0,-11
-41.99017,-20.68434,47,37,0,-10
-41.98994,-20.68434,45,37,0,-8
-41.98972,-20.68434,45,36,0,-9
-41.98949,-20.68434,45,36,0,-9
-41.98927,-20.68434,52,36,0,-16
-41.98882,-20.68434,63,35,0,-28
-41.98859,-20.68434,49,35,0,-14
-41.98837,-20.68434,68,36,0,-32
-41.98814,-20.68434,51,36,0,-15
-41.98769,-20.68434,50,37,0,-13
-41.98747,-20.68434,47,38,0,-9
-41.98725,-20.68434,47,39,0,-8
-41.98702,-20.68434,47,39,0,-8
-41.98657,-20.68434,60,40,0,-20
-41.98635,-20.68434,47,40,0,-7
-41.98612,-20.68434,62,40,0,-22
-41.9859,-20.68434,50,40,0,-10
-41.98545,-20.68434,51,41,0,-10
-41.98522,-20.68434,67,41,0,-26
-41.985,-20.68434,64,41,0,-23
-41.98477,-20.68434,55,41,0,-14
-41.98455,-20.68434,53,41,0,-12
-41.9841,-20.68434,52,41,0,-11
-41.98387,-20.68434,52,41,0,-11
-41.98365,-20.68434,52,41,0,-11
-41.98343,-20.68434,53,41,0,-12
-41.98298,-20.68434,52,41,0,-11
-41.98275,-20.68434,52,41,0,-11
-41.98253,-20.68434,52,41,0,-11
-41.9823,-20.68434,52,41,0,-11
-41.98185,-20.68434,52,41,0,-11
-41.98163,-20.68434,51,42,0,-9
-41.9814,-20.68434,50,42,0,-8
-41.98118,-20.68434,50,42,0,-8
-41.98073,-20.68434,49,42,0,-7
-41.9805,-20.68434,48,42,0,-6
-41.98028,-20.68434,48,42,0,-6
-41.98005,-20.68434,47,42,0,-5
-41.97983,-20.68434,46,42,0,-4
-41.97938,-20.68434,46,42,0,-4
-41.97916,-20.68434,59,42,0,-17
-41.97893,-20.68434,62,42,5,-20
-41.97871,-20.68434,65,42,5,-23
-41.97826,-20.68434,68,34,5,-34
-41.97803,-20.68434,66,34,5,-32
-41.97781,-20.68434,71,29,5,-42
-41.97758,-20.68434,68,28,5,-40
-41.97713,-20.68434,69,31,5,-38
-41.97691,-20.68434,70,28,5,-42
-41.97668,-20.68434,67,29,5,-38
-41.97646,-20.68434,67,29,5,-38
-41.97601,-20.68434,66,30,5,-36
-41.97578,-20.68434,66,28,5,-38
-41.97556,-20.68434,68,27,5,-41
-41.97534,-20.68434,65,27,5,-38
-41.97511,-20.68434,65,30,5,-35
-41.97466,-20.68434,66,39,5,-27
-41.97444,-20.68434,65,39,5,-26
-41.97421,-20.68434,64,31,5,-33
-41.97399,-20.68434,63,29,5,-34
-41.97354,-20.68434,62,29,5,-33
-41.97331,-20.68434,61,29,5,-32
-41.97309,-20.68434,60,27,5,-33
-41.97286,-20.68434,58,28,5,-30
-41.97241,-20.68434,49,34,5,-15
-41.97219,-20.68434,60,34,5,-26
-41.97196,-20.68434,66,30,5,-36
-41.97174,-20.68434,69,27,5,-42
-41.97129,-20.68434,68,27,5,-41
-41.97107,-20.68434,69,33,5,-36
-41.97084,-20.68434,68,35,0,-33
-41.97062,-20.68434,67,35,0,-32
-41.97017,-20.68434,66,36,0,-30
-41.96994,-20.68434,65,37,0,-28
-41.96972,-20.68434,66,39,0,-27
-41.96949,-20.68434,70,40,0,-30
-41.96927,-20.68434,68,40,0,-28
-42.1005,-20.68413,66,30,0,-36
-42.0978,-20.68413,66,31,0,-35
-42.09511,-20.68413,68,31,5,-37
-42.09219,-20.68413,61,33,5,-28
-42.08949,-20.68413,63,34,5,-29
-42.08657,-20.68413,65,38,0,-27
-42.08387,-20.68413,67,40,5,-27
-42.08118,-20.68413,66,37,5,-29
-42.07825,-20.68413,60,35,5,-25
-42.07556,-20.68413,59,37,0,-22
-42.07286,-20.68413,60,36,0,-24
-42.06994,-20.68413,68,36,5,-32
-42.06724,-20.68413,60,45,0,-15
-42.06455,-20.68413,66,34,5,-32
-42.06163,-20.68413,69,35,5,-34
-42.05893,-20.68413,66,40,5,-26
-42.05601,-20.68413,55,45,5,-10
-42.05331,-20.68413,62,35,5,-27
-42.05061,-20.68413,65,50,0,-15
-42.04769,-20.68413,74,36,0,-38
-42.045,-20.68413,61,35,0,-26
-42.0423,-20.68413,57,40,11,-17
-42.03938,-20.68413,58,38,0,-20
-42.03668,-20.68413,55,38,0,-17
-42.03399,-20.68413,58,34,5,-24
-42.03106,-20.68413,62,33,5,-29
-42.02837,-20.68413,61,31,5,-30
-42.02545,-20.68413,64,47,0,-17
-42.02275,-20.68413,52,45,0,-7
-42.02005,-20.68413,56,38,5,-18
-42.01713,-20.68413,58,33,5,-25
-42.01444,-20.68413,58,38,0,-20
-42.01174,-20.68413,59,46,5,-13
-42.00882,-20.68413,55,48,5,-7
-42.00612,-20.68413,55,47,5,-8
-42.00342,-20.68413,57,33,5,-24
-42.0005,-20.68413,55,36,5,-19
-41.99781,-20.68413,61,44,11,-17
-41.99511,-20.68413,62,32,5,-30
-41.99219,-20.68413,54,39,0,-15
-41.98949,-20.68413,45,36,0,-9
-41.98657,-20.68413,46,40,0,-6
-41.98387,-20.68413,52,41,0,-11
-41.98118,-20.68413,48,42,0,-6
-41.97826,-20.68413,65,34,5,-31
-41.97556,-20.68413,66,27,5,-39
-41.97286,-20.68413,59,27,5,-32
-41.96994,-20.68413,65,39,0,-26
-42.1005,-20.68392,66,31,0,-35
-42.0978,-20.68392,66,30,0,-36
-42.09511,-20.68392,69,30,5,-39
-42.09219,-20.68392,61,33,5,-28
-42.08949,-20.68392,63,36,5,-27
-42.08657,-20.68392,65,38,0,-27
-42.08387,-20.68392,67,36,5,-31
-42.08118,-20.68392,66,38,5,-28
-42.07825,-20.68392,60,36,5,-24
-42.07556,-20.68392,60,38,0,-22
-42.07286,-20.68392,60,37,0,-23
-42.06994,-20.68392,68,34,5,-34
-42.06724,-20.68392,67,45,0,-22
-42.06455,-20.68392,67,34,5,-33
-42.06163,-20.68392,69,35,5,-34
-42.05893,-20.68392,66,40,5,-26
-42.05601,-20.68392,55,45,5,-10
-42.05331,-20.68392,63,33,5,-30
-42.05061,-20.68392,65,50,0,-15
-42.04769,-20.68392,74,36,0,-38
-42.045,-20.68392,59,36,0,-23
-42.0423,-20.68392,57,40,11,-17
-42.03938,-20.68392,58,39,0,-19
-42.03668,-20.68392,55,39,0,-16
-42.03399,-20.68392,57,35,5,-22
-42.03106,-20.68392,62,31,5,-31
-42.02837,-20.68392,61,32,5,-29
-42.02545,-20.68392,64,43,0,-21
-42.02275,-20.68392,50,44,0,-6
-42.02005,-20.68392,55,37,5,-18
-42.01713,-20.68392,58,33,5,-25
-42.01444,-20.68392,58,34,0,-24
-42.01174,-20.68392,60,42,5,-18
-42.00882,-20.68392,58,48,5,-10
-42.00612,-20.68392,55,47,5,-8
-42.00342,-20.68392,56,33,5,-23
-42.0005,-20.68392,54,36,5,-18
-41.99781,-20.68392,61,44,5,-17
-41.99511,-20.68392,63,33,5,-30
-41.99219,-20.68392,52,39,0,-13
-41.98949,-20.68392,52,36,0,-16
-41.98657,-20.68392,46,40,0,-6
-41.98387,-20.68392,52,41,0,-11
-41.98118,-20.68392,48,42,0,-6
-41.97826,-20.68392,67,42,5,-25
-41.97556,-20.68392,66,27,5,-39
-41.97286,-20.68392,60,27,5,-33
-41.96994,-20.68392,65,40,0,-25
-42.1005,-20.68371,65,31,0,-34
-42.0978,-20.68371,65,30,0,-35
-42.09511,-20.68371,65,30,5,-35
-42.09219,-20.68371,61,33,5,-28
-42.08949,-20.68371,63,32,5,-31
-42.08657,-20.68371,65,38,5,-27
-42.08387,-20.68371,67,37,5,-30
-42.08118,-20.68371,66,34,5,-32
-42.07825,-20.68371,60,36,5,-24
-42.07556,-20.68371,63,38,0,-25
-42.07286,-20.68371,60,37,0,-23
-42.06994,-20.68371,67,33,5,-34
-42.06724,-20.68371,68,45,0,-23
-42.06455,-20.68371,65,34,5,-31
-42.06163,-20.68371,69,35,5,-34
-42.05893,-20.68371,63,36,5,-27
-42.05601,-20.68371,55,40,5,-15
-42.05331,-20.68371,62,33,5,-29
-42.05061,-20.68371,66,49,0,-17
-42.04769,-20.68371,75,37,0,-38
-42.045,-20.68371,58,36,0,-22
-42.0423,-20.68371,57,40,0,-17
-42.03938,-20.68371,60,39,0,-21
-42.03668,-20.68371,59,40,0,-19
-42.03399,-20.68371,58,34,5,-24
-42.03106,-20.68371,62,31,5,-31
-42.02837,-20.68371,61,32,0,-29
-42.02545,-20.68371,64,36,0,-28
-42.02275,-20.68371,52,44,0,-8
-42.02005,-20.68371,57,36,5,-21
-42.01713,-20.68371,60,33,5,-27
-42.01444,-20.68371,58,35,0,-23
-42.01174,-20.68371,61,45,5,-16
-42.00882,-20.68371,59,48,5,-11
-42.00612,-20.68371,57,47,5,-10
-42.00342,-20.68371,57,34,5,-23
-42.0005,-20.68371,53,36,5,-17
-41.99781,-20.68371,60,44,5,-16
-41.99511,-20.68371,63,34,5,-29
-41.99219,-20.68371,51,40,0,-11
-41.98949,-20.68371,45,37,0,-8
-41.98657,-20.68371,45,40,0,-5
-41.98387,-20.68371,51,41,0,-10
-41.98118,-20.68371,48,41,0,-7
-41.97826,-20.68371,67,42,5,-25
-41.97556,-20.68371,67,28,5,-39
-41.97286,-20.68371,64,27,5,-37
-41.96994,-20.68371,68,42,0,-26
-42.1005,-20.68328,66,29,5,-37
-42.0978,-20.68328,65,30,5,-35
-42.09511,-20.68328,66,30,5,-36
-42.09219,-20.68328,61,31,5,-30
-42.08949,-20.68328,63,35,5,-28
-42.08657,-20.68328,65,36,5,-29
-42.08387,-20.68328,68,38,5,-30
-42.08118,-20.68328,65,37,5,-28
-42.07825,-20.68328,60,33,5,-27
-42.07556,-20.68328,62,38,5,-24
-42.07286,-20.68328,60,37,0,-23
-42.06994,-20.68328,67,36,5,-31
-42.06724,-20.68328,67,45,0,-22
-42.06455,-20.68328,63,35,5,-28
-42.06163,-20.68328,69,35,5,-34
-42.05893,-20.68328,65,36,5,-29
-42.05601,-20.68328,55,42,5,-13
-42.05331,-20.68328,62,34,5,-28
-42.05061,-20.68328,67,42,0,-25
-42.04769,-20.68328,74,37,0,-37
-42.045,-20.68328,58,36,0,-22
-42.0423,-20.68328,57,40,0,-17
-42.03938,-20.68328,58,36,0,-22
-42.03668,-20.68328,57,41,5,-16
-42.03399,-20.68328,59,34,5,-25
-42.03106,-20.68328,61,31,5,-30
-42.02837,-20.68328,61,34,0,-27
-42.02545,-20.68328,63,35,0,-28
-42.02275,-20.68328,56,44,0,-12
-42.02005,-20.68328,59,40,0,-19
-42.01713,-20.68328,59,33,5,-26
-42.01444,-20.68328,59,31,0,-28
-42.01174,-20.68328,62,38,5,-24
-42.00882,-20.68328,59,48,5,-11
-42.00612,-20.68328,58,47,5,-11
-42.00342,-20.68328,57,34,5,-23
-42.0005,-20.68328,52,36,5,-16
-41.99781,-20.68328,59,43,5,-16
-41.99511,-20.68328,63,41,5,-22
-41.99219,-20.68328,50,41,0,-9
-41.98949,-20.68328,45,34,0,-11
-41.98657,-20.68328,45,39,0,-6
-41.98387,-20.68328,49,41,0,-8
-41.98118,-20.68328,47,41,0,-6
-41.97826,-20.68328,65,42,5,-23
-41.97556,-20.68328,66,29,5,-37
-41.97286,-20.68328,62,26,5,-36
-41.96994,-20.68328,65,42,0,-23
-42.1005,-20.68307,66,28,5,-38
-42.0978,-20.68307,64,28,5,-36
-42.09511,-20.68307,66,30,0,-36
-42.09219,-20.68307,61,33,5,-28
-42.08949,-20.68307,63,34,5,-29
-42.08657,-20.68307,65,36,5,-29
-42.08387,-20.68307,66,39,5,-27
-42.08118,-20.68307,65,37,5,-28
-42.07825,-20.68307,60,33,5,-27
-42.07556,-20.68307,60,36,5,-24
-42.07286,-20.68307,60,38,0,-22
-42.06994,-20.68307,66,37,5,-29
-42.06724,-20.68307,67,45,0,-22
-42.06455,-20.68307,62,35,5,-27
-42.06163,-20.68307,70,35,5,-35
-42.05893,-20.68307,64,36,5,-28
-42.05601,-20.68307,55,42,5,-13
-42.05331,-20.68307,59,33,5,-26
-42.05061,-20.68307,67,40,0,-27
-42.04769,-20.68307,73,37,0,-36
-42.045,-20.68307,58,36,0,-22
-42.0423,-20.68307,57,40,0,-17
-42.03938,-20.68307,59,36,0,-23
-42.03668,-20.68307,57,41,5,-16
-42.03399,-20.68307,58,37,5,-21
-42.03106,-20.68307,61,31,5,-30
-42.02837,-20.68307,60,34,0,-26
-42.02545,-20.68307,63,34,0,-29
-42.02275,-20.68307,54,44,0,-10
-42.02005,-20.68307,59,40,0,-19
-42.01713,-20.68307,58,33,5,-25
-42.01444,-20.68307,58,30,0,-28
-42.01174,-20.68307,61,37,5,-24
-42.00882,-20.68307,60,48,5,-12
-42.00612,-20.68307,58,47,5,-11
-42.00342,-20.68307,57,33,5,-24
-42.0005,-20.68307,52,36,5,-16
-41.99781,-20.68307,58,35,5,-23
-41.99511,-20.68307,61,41,11,-20
-41.99219,-20.68307,50,40,0,-10
-41.98949,-20.68307,45,34,0,-11
-41.98657,-20.68307,45,39,0,-6
-41.98387,-20.68307,60,41,0,-19
-41.98118,-20.68307,47,41,0,-6
-41.97826,-20.68307,65,42,5,-23
-41.97556,-20.68307,65,27,5,-38
-41.97286,-20.68307,62,26,5,-36
-41.96994,-20.68307,65,42,0,-23
-42.1005,-20.68286,68,27,5,-41
-42.0978,-20.68286,63,29,5,-34
-42.09511,-20.68286,65,31,5,-34
-42.09219,-20.68286,61,32,5,-29
-42.08949,-20.68286,63,33,5,-30
-42.08657,-20.68286,65,41,5,-24
-42.08387,-20.68286,67,40,5,-27
-42.08118,-20.68286,66,37,5,-29
-42.07825,-20.68286,66,36,5,-30
-42.07556,-20.68286,60,35,5,-25
-42.07286,-20.68286,60,39,0,-21
-42.06994,-20.68286,64,35,5,-29
-42.06724,-20.68286,63,45,0,-18
-42.06455,-20.68286,61,35,5,-26
-42.06163,-20.68286,70,35,5,-35
-42.05893,-20.68286,62,36,5,-26
-42.05601,-20.68286,55,38,5,-17
-42.05331,-20.68286,59,37,5,-22
-42.05061,-20.68286,68,40,0,-28
-42.04769,-20.68286,73,38,0,-35
-42.045,-20.68286,59,37,11,-22
-42.0423,-20.68286,58,40,0,-18
-42.03938,-20.68286,59,36,0,-23
-42.03668,-20.68286,56,41,5,-15
-42.03399,-20.68286,58,37,5,-21
-42.03106,-20.68286,61,31,5,-30
-42.02837,-20.68286,60,34,0,-26
-42.02545,-20.68286,63,33,0,-30
-42.02275,-20.68286,52,44,0,-8
-42.02005,-20.68286,57,38,0,-19
-42.01713,-20.68286,57,33,0,-24
-42.01444,-20.68286,58,31,0,-27
-42.01174,-20.68286,61,39,5,-22
-42.00882,-20.68286,62,39,5,-23
-42.00612,-20.68286,59,38,5,-21
-42.00342,-20.68286,57,33,5,-24
-42.0005,-20.68286,52,36,5,-16
-41.99781,-20.68286,57,36,5,-21
-41.99511,-20.68286,59,41,5,-18
-41.99219,-20.68286,51,41,0,-10
-41.98949,-20.68286,59,34,0,-25
-41.98657,-20.68286,45,39,0,-6
-41.98387,-20.68286,47,41,0,-6
-41.98118,-20.68286,46,41,0,-5
-41.97826,-20.68286,64,33,5,-31
-41.97556,-20.68286,65,28,5,-37
-41.97286,-20.68286,62,28,5,-34
-41.96994,-20.68286,65,42,0,-23
-42.1005,-20.68244,65,28,5,-37
-42.0978,-20.68244,65,31,5,-34
-42.09511,-20.68244,65,31,5,-34
-42.09219,-20.68244,61,35,5,-26
-42.08949,-20.68244,63,34,5,-29
-42.08657,-20.68244,65,42,5,-23
-42.08387,-20.68244,67,40,5,-27
-42.08118,-20.68244,68,38,5,-30
-42.07825,-20.68244,66,33,5,-33
-42.07556,-20.68244,65,35,5,-30
-42.07286,-20.68244,66,42,0,-24
-42.06994,-20.68244,63,38,0,-25
-42.06724,-20.68244,61,44,0,-17
-42.06455,-20.68244,61,40,5,-21
-42.06163,-20.68244,70,37,5,-33
-42.05893,-20.68244,66,38,5,-28
-42.05601,-20.68244,55,37,5,-18
-42.05331,-20.68244,58,47,5,-11
-42.05061,-20.68244,68,36,0,-32
-42.04769,-20.68244,73,38,0,-35
-42.045,-20.68244,65,37,5,-28
-42.0423,-20.68244,58,41,0,-17
-42.03938,-20.68244,59,34,0,-25
-42.03668,-20.68244,56,41,5,-15
-42.03399,-20.68244,59,43,5,-16
-42.03106,-20.68244,61,34,5,-27
-42.02837,-20.68244,60,34,0,-26
-42.02545,-20.68244,63,33,0,-30
-42.02275,-20.68244,51,44,0,-7
-42.02005,-20.68244,56,34,0,-22
-42.01713,-20.68244,57,31,0,-26
-42.01444,-20.68244,58,28,0,-30
-42.01174,-20.68244,60,37,5,-23
-42.00882,-20.68244,64,36,5,-28
-42.00612,-20.68244,59,34,5,-25
-42.00342,-20.68244,56,33,5,-23
-42.0005,-20.68244,53,36,5,-17
-41.99781,-20.68244,58,37,5,-21
-41.99511,-20.68244,58,32,5,-26
-41.99219,-20.68244,50,43,0,-7
-41.98949,-20.68244,66,38,0,-28
-41.98657,-20.68244,50,39,0,-11
-41.98387,-20.68244,47,41,0,-6
-41.98118,-20.68244,47,41,0,-6
-41.97826,-20.68244,68,34,5,-34
-41.97556,-20.68244,65,31,5,-34
-41.97286,-20.68244,63,26,5,-37
-41.96994,-20.68244,64,38,0,-26
-42.1005,-20.68223,65,28,5,-37
-42.0978,-20.68223,69,31,5,-38
-42.09511,-20.68223,66,32,5,-34
-42.09219,-20.68223,61,35,5,-26
-42.08949,-20.68223,63,34,5,-29
-42.08657,-20.68223,65,42,5,-23
-42.08387,-20.68223,66,40,5,-26
-42.08118,-20.68223,67,38,5,-29
-42.07825,-20.68223,63,33,5,-30
-42.07556,-20.68223,63,34,5,-29
-42.07286,-20.68223,63,42,0,-21
-42.06994,-20.68223,62,40,0,-22
-42.06724,-20.68223,60,44,0,-16
-42.06455,-20.68223,61,40,5,-21
-42.06163,-20.68223,66,40,5,-26
-42.05893,-20.68223,66,38,5,-28
-42.05601,-20.68223,55,34,5,-21
-42.05331,-20.68223,57,42,5,-15
-42.05061,-20.68223,69,36,0,-33
-42.04769,-20.68223,71,38,0,-33
-42.045,-20.68223,67,37,5,-30
-42.0423,-20.68223,61,41,0,-20
-42.03938,-20.68223,59,35,0,-24
-42.03668,-20.68223,56,41,5,-15
-42.03399,-20.68223,59,38,5,-21
-42.03106,-20.68223,61,34,0,-27
-42.02837,-20.68223,60,34,0,-26
-42.02545,-20.68223,63,33,0,-30
-42.02275,-20.68223,52,44,0,-8
-42.02005,-20.68223,57,33,0,-24
-42.01713,-20.68223,58,31,0,-27
-42.01444,-20.68223,58,27,0,-31
-42.01174,-20.68223,61,39,5,-22
-42.00882,-20.68223,63,34,5,-29
-42.00612,-20.68223,58,33,5,-25
-42.00342,-20.68223,56,33,5,-23
-42.0005,-20.68223,53,35,5,-18
-41.99781,-20.68223,61,34,5,-27
-41.99511,-20.68223,57,33,5,-24
-41.99219,-20.68223,51,43,0,-8
-41.98949,-20.68223,69,38,0,-31
-41.98657,-20.68223,63,39,0,-24
-41.98387,-20.68223,46,41,0,-5
-41.98118,-20.68223,60,42,0,-18
-41.97826,-20.68223,69,30,5,-39
-41.97556,-20.68223,65,31,5,-34
-41.97286,-20.68223,63,26,5,-37
-41.96994,-20.68223,63,34,0,-29
-42.1005,-20.68202,65,28,5,-37
-42.0978,-20.68202,68,31,5,-37
-42.09511,-20.68202,67,32,5,-35
-42.09219,-20.68202,61,36,5,-25
-42.08949,-20.68202,63,32,5,-31
-42.08657,-20.68202,65,42,5,-23
-42.08387,-20.68202,67,38,5,-29
-42.08118,-20.68202,66,38,5,-28
-42.07825,-20.68202,64,32,5,-32
-42.07556,-20.68202,60,34,5,-26
-42.07286,-20.68202,60,42,5,-18
-42.06994,-20.68202,62,43,0,-19
-42.06724,-20.68202,60,41,0,-19
-42.06455,-20.68202,60,35,5,-25
-42.06163,-20.68202,65,45,5,-20
-42.05893,-20.68202,67,36,5,-31
-42.05601,-20.68202,59,33,5,-26
-42.05331,-20.68202,55,33,5,-22
-42.05061,-20.68202,69,36,0,-33
-42.04769,-20.68202,66,38,0,-28
-42.045,-20.68202,67,37,5,-30
-42.0423,-20.68202,60,41,0,-19
-42.03938,-20.68202,59,36,0,-23
-42.03668,-20.68202,56,41,5,-15
-42.03399,-20.68202,60,34,5,-26
-42.03106,-20.68202,61,35,0,-26
-42.02837,-20.68202,60,34,0,-26
-42.02545,-20.68202,63,32,5,-31
-42.02275,-20.68202,54,43,0,-11
-42.02005,-20.68202,59,31,0,-28
-42.01713,-20.68202,58,31,0,-27
-42.01444,-20.68202,58,26,0,-32
-42.01174,-20.68202,60,39,5,-21
-42.00882,-20.68202,63,35,5,-28
-42.00612,-20.68202,58,33,5,-25
-42.00342,-20.68202,56,33,5,-23
-42.0005,-20.68202,53,36,5,-17
-41.99781,-20.68202,64,33,5,-31
-41.99511,-20.68202,56,33,5,-23
-41.99219,-20.68202,51,43,0,-8
-41.98949,-20.68202,67,39,0,-28
-41.98657,-20.68202,62,39,0,-23
-41.98387,-20.68202,45,41,0,-4
-41.98118,-20.68202,62,42,0,-20
-41.97826,-20.68202,68,28,5,-40
-41.97556,-20.68202,64,29,5,-35
-41.97286,-20.68202,63,26,5,-37
-41.96994,-20.68202,64,33,0,-31
-42.10297,-20.68159,65,33,5,-32
-42.10275,-20.68159,65,33,5,-32
-42.10252,-20.68159,65,33,5,-32
-42.1023,-20.68159,65,33,5,-32
-42.10185,-20.68159,65,32,5,-33
-42.10163,-20.68159,65,32,5,-33
-42.1014,-20.68159,67,32,5,-35
-42.10118,-20.68159,66,32,5,-34
-42.10073,-20.68159,65,30,5,-35
-42.1005,-20.68159,65,30,5,-35
-42.10028,-20.68159,66,28,5,-38
-42.10005,-20.68159,66,28,5,-38
-42.09983,-20.68159,67,29,5,-38
-42.09938,-20.68159,67,29,5,-38
-42.09915,-20.68159,67,29,5,-38
-42.09893,-20.68159,68,29,5,-39
-42.0987,-20.68159,68,31,5,-37
-42.09825,-20.68159,68,30,5,-38
-42.09803,-20.68159,68,30,5,-38
-42.0978,-20.68159,68,31,5,-37
-42.09758,-20.68159,69,30,5,-39
-42.09713,-20.68159,70,30,5,-40
-42.09691,-20.68159,70,29,5,-41
-42.09668,-20.68159,71,29,5,-42
-42.09646,-20.68159,72,29,5,-43
-42.09601,-20.68159,72,29,5,-43
-42.09578,-20.68159,70,30,5,-40
-42.09556,-20.68159,69,30,5,-39
-42.09533,-20.68159,67,30,5,-37
-42.09511,-20.68159,67,31,5,-36
-42.09466,-20.68159,67,31,5,-36
-42.09443,-20.68159,68,31,5,-37
-42.09421,-20.68159,68,29,5,-39
-42.09398,-20.68159,69,29,5,-40
-42.09354,-20.68159,70,29,5,-41
-42.09331,-20.68159,70,30,5,-40
-42.09309,-20.68159,69,30,5,-39
-42.09286,-20.68159,66,30,5,-36
-42.09241,-20.68159,64,32,5,-32
-42.09219,-20.68159,63,37,5,-26
-42.09196,-20.68159,62,37,5,-25
-42.09174,-20.68159,62,37,5,-25
-42.09129,-20.68159,62,37,5,-25
-42.09106,-20.68159,62,37,5,-25
-42.09084,-20.68159,62,34,5,-28
-42.09061,-20.68159,62,32,5,-30
-42.09039,-20.68159,62,33,5,-29
-42.08994,-20.68159,62,32,5,-30
-42.08972,-20.68159,62,32,5,-30
-42.08949,-20.68159,62,32,5,-30
-42.08927,-20.68159,62,32,5,-30
-42.08882,-20.68159,63,33,5,-30
-42.08859,-20.68159,63,35,5,-28
-42.08837,-20.68159,63,35,5,-28
-42.08814,-20.68159,63,36,5,-27
-42.08769,-20.68159,64,40,5,-24
-42.08747,-20.68159,64,38,5,-26
-42.08724,-20.68159,64,37,5,-27
-42.08702,-20.68159,64,36,5,-28
-42.08657,-20.68159,64,41,5,-23
-42.08634,-20.68159,65,39,5,-26
-42.08612,-20.68159,65,38,5,-27
-42.08589,-20.68159,65,37,5,-28
-42.08545,-20.68159,65,38,5,-27
-42.08522,-20.68159,66,37,5,-29
-42.085,-20.68159,66,37,5,-29
-42.08477,-20.68159,66,37,5,-29
-42.08455,-20.68159,67,36,5,-31
-42.0841,-20.68159,68,39,5,-29
-42.08387,-20.68159,66,38,5,-28
-42.08365,-20.68159,67,37,5,-30
-42.08342,-20.68159,69,36,5,-33
-42.08297,-20.68159,67,38,5,-29
-42.08275,-20.68159,65,37,5,-28
-42.08252,-20.68159,64,39,5,-25
-42.0823,-20.68159,65,36,5,-29
-42.08185,-20.68159,65,39,5,-26
-42.08163,-20.68159,65,39,5,-26
-42.0814,-20.68159,66,39,5,-27
-42.08118,-20.68159,66,39,5,-27
-42.08073,-20.68159,66,38,5,-28
-42.0805,-20.68159,65,38,5,-27
-42.08028,-20.68159,64,38,5,-26
-42.08005,-20.68159,63,38,5,-25
-42.07983,-20.68159,64,37,5,-27
-42.07938,-20.68159,64,36,5,-28
-42.07915,-20.68159,64,35,5,-29
-42.07893,-20.68159,63,35,5,-28
-42.0787,-20.68159,63,38,5,-25
-42.07825,-20.68159,63,38,0,-25
-42.07803,-20.68159,60,35,5,-25
-42.07781,-20.68159,62,33,5,-29
-42.07758,-20.68159,64,33,5,-31
-42.07713,-20.68159,60,36,11,-24
-42.07691,-20.68159,60,35,5,-25
-42.07668,-20.68159,60,32,5,-28
-42.07646,-20.68159,60,32,5,-28
-42.07601,-20.68159,60,32,5,-28
-42.07578,-20.68159,60,32,5,-28
-42.07556,-20.68159,60,33,5,-27
-42.07533,-20.68159,60,33,5,-27
-42.07511,-20.68159,60,35,5,-25
-42.07466,-20.68159,62,43,0,-19
-42.07443,-20.68159,67,43,0,-24
-42.07421,-20.68159,65,43,0,-22
-42.07399,-20.68159,67,43,5,-24
-42.07354,-20.68159,62,40,5,-22
-42.07331,-20.68159,60,44,5,-16
-42.07309,-20.68159,60,43,5,-17
-42.07286,-20.68159,60,43,5,-17
-42.07241,-20.68159,61,39,5,-22
-42.07219,-20.68159,61,39,5,-22
-42.07196,-20.68159,61,38,5,-23
-42.07174,-20.68159,62,37,5,-25
-42.07129,-20.68159,62,37,5,-25
-42.07106,-20.68159,61,37,5,-24
-42.07084,-20.68159,62,37,5,-25
-42.07061,-20.68159,66,37,5,-29
-42.07039,-20.68159,62,38,5,-24
-42.06994,-20.68159,62,44,0,-18
-42.06972,-20.68159,61,44,0,-17
-42.06949,-20.68159,61,45,0,-16
-42.06927,-20.68159,61,44,0,-17
-42.06882,-20.68159,61,44,0,-17
-42.06859,-20.68159,61,44,0,-17
-42.06837,-20.68159,61,44,0,-17
-42.06814,-20.68159,61,44,0,-17
-42.06769,-20.68159,60,44,0,-16
-42.06747,-20.68159,60,44,0,-16
-42.06724,-20.68159,60,44,0,-16
-42.06702,-20.68159,61,44,0,-17
-42.06657,-20.68159,63,43,0,-20
-42.06634,-20.68159,63,43,5,-20
-42.06612,-20.68159,65,35,5,-30
-42.0659,-20.68159,62,34,5,-28
-42.06545,-20.68159,63,35,5,-28
-42.06522,-20.68159,60,35,5,-25
-42.065,-20.68159,60,36,5,-24
-42.06477,-20.68159,60,36,5,-24
-42.06455,-20.68159,60,36,5,-24
-42.0641,-20.68159,61,36,5,-25
-42.06387,-20.68159,61,37,5,-24
-42.06365,-20.68159,61,39,5,-22
-42.06342,-20.68159,62,45,5,-17
-42.06297,-20.68159,62,45,5,-17
-42.06275,-20.68159,62,45,0,-17
-42.06252,-20.68159,62,46,0,-16
-42.0623,-20.68159,62,46,0,-16
-42.06185,-20.68159,63,43,0,-20
-42.06163,-20.68159,64,39,5,-25
-42.0614,-20.68159,64,40,5,-24
-42.06118,-20.68159,64,40,5,-24
-42.06073,-20.68159,64,35,5,-29
-42.0605,-20.68159,67,36,5,-31
-42.06028,-20.68159,64,36,5,-28
-42.06005,-20.68159,67,36,5,-31
-42.05983,-20.68159,67,36,5,-31
-42.05938,-20.68159,67,32,5,-35
-42.05915,-20.68159,68,33,5,-35
-42.05893,-20.68159,68,33,5,-35
-42.0587,-20.68159,67,35,5,-32
-42.05826,-20.68159,68,39,5,-29
-42.05803,-20.68159,66,39,5,-27
-42.05781,-20.68159,65,35,5,-30
-42.05758,-20.68159,64,32,5,-32
-42.05713,-20.68159,63,32,5,-31
-42.05691,-20.68159,64,32,5,-32
-42.05668,-20.68159,63,31,5,-32
-42.05646,-20.68159,62,33,5,-29
-42.05601,-20.68159,62,33,5,-29
-42.05578,-20.68159,59,31,5,-28
-42.05556,-20.68159,57,31,5,-26
-42.05533,-20.68159,54,31,5,-23
-42.05511,-20.68159,54,31,5,-23
-42.05466,-20.68159,54,32,5,-22
-42.05443,-20.68159,55,32,5,-23
-42.05421,-20.68159,55,32,5,-23
-42.05399,-20.68159,55,31,5,-24
-42.05354,-20.68159,55,32,5,-23
-42.05331,-20.68159,55,32,5,-23
-42.05309,-20.68159,55,32,5,-23
-42.05286,-20.68159,56,34,0,-22
-42.05241,-20.68159,58,33,0,-25
-42.05219,-20.68159,62,33,0,-29
-42.05196,-20.68159,63,32,0,-31
-42.05174,-20.68159,65,34,0,-31
-42.05129,-20.68159,66,34,0,-32
-42.05106,-20.68159,68,35,0,-33
-42.05084,-20.68159,69,35,0,-34
-42.05061,-20.68159,70,35,0,-35
-42.05039,-20.68159,71,36,0,-35
-42.04994,-20.68159,74,36,0,-38
-42.04972,-20.68159,72,35,0,-37
-42.04949,-20.68159,72,35,0,-37
-42.04927,-20.68159,71,36,0,-35
-42.04882,-20.68159,69,38,0,-31
-42.04859,-20.68159,68,38,0,-30
-42.04837,-20.68159,67,38,0,-29
-42.04814,-20.68159,67,39,0,-28
-42.04769,-20.68159,65,39,0,-26
-42.04747,-20.68159,72,39,0,-33
-42.04724,-20.68159,64,39,0,-25
-42.04702,-20.68159,61,38,0,-23
-42.04657,-20.68159,61,38,0,-23
-42.04635,-20.68159,63,38,11,-25
-42.04612,-20.68159,69,38,5,-31
-42.0459,-20.68159,70,35,5,-35
-42.04545,-20.68159,65,35,5,-30
-42.04522,-20.68159,66,35,5,-31
-42.045,-20.68159,68,34,5,-34
-42.04477,-20.68159,67,34,5,-33
-42.04455,-20.68159,67,35,5,-32
-42.0441,-20.68159,65,38,5,-27
-42.04387,-20.68159,62,38,5,-24
-42.04365,-20.68159,61,35,5,-26
-42.04342,-20.68159,61,39,5,-22
-42.04297,-20.68159,60,40,5,-20
-42.04275,-20.68159,60,41,5,-19
-42.04253,-20.68159,60,42,0,-18
-42.0423,-20.68159,60,42,0,-18
-42.04185,-20.68159,59,42,0,-17
-42.04163,-20.68159,58,42,0,-16
-42.0414,-20.68159,58,41,0,-17
-42.04118,-20.68159,59,41,0,-18
-42.04073,-20.68159,59,39,0,-20
-42.0405,-20.68159,59,39,0,-20
-42.04028,-20.68159,59,37,0,-22
-42.04005,-20.68159,59,37,0,-22
-42.03983,-20.68159,59,37,0,-22
-42.03938,-20.68159,58,37,0,-21
-42.03915,-20.68159,58,37,0,-21
-42.03893,-20.68159,58,38,0,-20
-42.0387,-20.68159,58,38,0,-20
-42.03826,-20.68159,58,40,0,-18
-42.03803,-20.68159,58,41,0,-17
-42.03781,-20.68159,57,42,0,-15
-42.03758,-20.68159,57,42,0,-15
-42.03713,-20.68159,57,42,0,-15
-42.03691,-20.68159,58,42,0,-16
-42.03668,-20.68159,59,42,0,-17
-42.03646,-20.68159,60,33,5,-27
-42.03601,-20.68159,62,32,5,-30
-42.03578,-20.68159,62,32,5,-30
-42.03556,-20.68159,63,32,5,-31
-42.03533,-20.68159,63,32,5,-31
-42.03511,-20.68159,62,33,5,-29
-42.03466,-20.68159,62,32,5,-30
-42.03444,-20.68159,61,33,5,-28
-42.03421,-20.68159,59,34,5,-25
-42.03399,-20.68159,62,34,5,-28
-42.03354,-20.68159,62,36,5,-26
-42.03331,-20.68159,59,36,5,-23
-42.03309,-20.68159,60,32,5,-28
-42.03286,-20.68159,60,34,5,-26
-42.03241,-20.68159,60,31,5,-29
-42.03219,-20.68159,61,32,5,-29
-42.03196,-20.68159,61,32,5,-29
-42.03174,-20.68159,61,33,5,-28
-42.03129,-20.68159,61,35,0,-26
-42.03106,-20.68159,61,35,0,-26
-42.03084,-20.68159,61,35,0,-26
-42.03062,-20.68159,61,35,0,-26
-42.03017,-20.68159,61,34,0,-27
-42.02994,-20.68159,60,34,0,-26
-42.02972,-20.68159,60,34,0,-26
-42.02949,-20.68159,60,34,0,-26
-42.02927,-20.68159,60,34,0,-26
-42.02882,-20.68159,60,34,0,-26
-42.02859,-20.68159,60,34,0,-26
-42.02837,-20.68159,60,34,0,-26
-42.02814,-20.68159,60,34,0,-26
-42.02769,-20.68159,60,34,0,-26
-42.02747,-20.68159,60,34,5,-26
-42.02724,-20.68159,60,34,5,-26
-42.02702,-20.68159,60,34,5,-26
-42.02657,-20.68159,61,35,5,-26
-42.02635,-20.68159,61,33,5,-28
-42.02612,-20.68159,62,32,5,-30
-42.0259,-20.68159,62,32,5,-30
-42.02545,-20.68159,63,31,5,-32
-42.02522,-20.68159,62,31,5,-31
-42.025,-20.68159,61,31,5,-30
-42.02477,-20.68159,61,34,5,-27
-42.02455,-20.68159,60,35,0,-25
-42.0241,-20.68159,59,37,0,-22
-42.02387,-20.68159,58,37,0,-21
-42.02365,-20.68159,57,37,0,-20
-42.02342,-20.68159,57,39,0,-18
-42.02297,-20.68159,56,43,0,-13
-42.02275,-20.68159,59,43,0,-16
-42.02253,-20.68159,58,44,0,-14
-42.0223,-20.68159,61,44,0,-17
-42.02185,-20.68159,61,45,0,-16
-42.02163,-20.68159,61,45,0,-16
-42.0214,-20.68159,59,40,0,-19
-42.02118,-20.68159,59,40,0,-19
-42.02073,-20.68159,59,39,0,-20
-42.0205,-20.68159,59,39,11,-20
-42.02028,-20.68159,59,39,0,-20
-42.02005,-20.68159,59,34,0,-25
-42.01983,-20.68159,60,33,0,-27
-42.01938,-20.68159,60,35,0,-25
-42.01915,-20.68159,59,34,5,-25
-42.01893,-20.68159,59,32,5,-27
-42.01871,-20.68159,58,32,5,-26
-42.01826,-20.68159,57,31,5,-26
-42.01803,-20.68159,57,31,5,-26
-42.01781,-20.68159,57,31,5,-26
-42.01758,-20.68159,57,30,5,-27
-42.01713,-20.68159,57,30,0,-27
-42.01691,-20.68159,57,30,0,-27
-42.01668,-20.68159,57,30,0,-27
-42.01646,-20.68159,57,29,0,-28
-42.01601,-20.68159,58,29,0,-29
-42.01578,-20.68159,58,29,0,-29
-42.01556,-20.68159,58,29,0,-29
-42.01533,-20.68159,58,28,0,-30
-42.01511,-20.68159,58,28,0,-30
-42.01466,-20.68159,59,27,0,-32
-42.01444,-20.68159,58,26,0,-32
-42.01421,-20.68159,57,26,0,-31
-42.01399,-20.68159,57,26,0,-31
-42.01354,-20.68159,57,27,0,-30
-42.01331,-20.68159,57,28,5,-29
-42.01309,-20.68159,57,26,5,-31
-42.01286,-20.68159,57,30,5,-27
-42.01241,-20.68159,58,31,5,-27
-42.01219,-20.68159,58,31,5,-27
-42.01196,-20.68159,58,34,5,-24
-42.01174,-20.68159,59,34,5,-25
-42.01129,-20.68159,60,33,5,-27
-42.01106,-20.68159,59,33,5,-26
-42.01084,-20.68159,60,35,5,-25
-42.01062,-20.68159,60,35,5,-25
-42.01017,-20.68159,61,38,0,-23
-42.00994,-20.68159,62,37,0,-25
-42.00972,-20.68159,64,38,0,-26
-42.00949,-20.68159,64,36,0,-28
-42.00927,-20.68159,65,35,5,-30
-42.00882,-20.68159,68,35,5,-33
-42.00859,-20.68159,64,34,5,-30
-42.00837,-20.68159,64,34,5,-30
-42.00814,-20.68159,62,33,5,-29
-42.00769,-20.68159,61,34,5,-27
-42.00747,-20.68159,60,34,5,-26
-42.00724,-20.68159,60,36,5,-24
-42.00702,-20.68159,60,35,5,-25
-42.00657,-20.68159,63,35,5,-28
-42.00635,-20.68159,60,34,0,-26
-42.00612,-20.68159,58,34,0,-24
-42.0059,-20.68159,56,35,0,-21
-42.00545,-20.68159,55,35,0,-20
-42.00522,-20.68159,55,35,0,-20
-42.005,-20.68159,55,35,0,-20
-42.00477,-20.68159,55,35,0,-20
-42.00455,-20.68159,55,36,0,-19
-42.0041,-20.68159,55,35,5,-20
-42.00387,-20.68159,55,35,5,-20
-42.00365,-20.68159,56,35,5,-21
-42.00342,-20.68159,56,34,5,-22
-42.00298,-20.68159,56,41,5,-15
-42.00275,-20.68159,56,44,5,-12
-42.00253,-20.68159,56,46,5,-10
-42.0023,-20.68159,56,46,5,-10
-42.00185,-20.68159,56,46,5,-10
-42.00163,-20.68159,55,46,5,-9
-42.0014,-20.68159,55,46,5,-9
-42.00118,-20.68159,55,36,5,-19
-42.00073,-20.68159,56,38,5,-18
-42.0005,-20.68159,54,38,5,-16
-42.00028,-20.68159,61,38,5,-23
-42.00005,-20.68159,61,37,5,-24
-41.99983,-20.68159,65,36,5,-29
-41.99938,-20.68159,65,35,5,-30
-41.99916,-20.68159,64,34,5,-30
-41.99893,-20.68159,65,35,5,-30
-41.99871,-20.68159,64,35,5,-29
-41.99826,-20.68159,64,37,5,-27
-41.99803,-20.68159,66,34,5,-32
-41.99781,-20.68159,63,32,5,-31
-41.99758,-20.68159,67,32,5,-35
-41.99713,-20.68159,69,34,5,-35
-41.99691,-20.68159,64,34,5,-30
-41.99668,-20.68159,62,35,5,-27
-41.99646,-20.68159,61,35,5,-26
-41.99601,-20.68159,59,34,5,-25
-41.99578,-20.68159,59,35,5,-24
-41.99556,-20.68159,58,34,5,-24
-41.99533,-20.68159,57,33,5,-24
-41.99511,-20.68159,56,33,5,-23
-41.99466,-20.68159,58,34,5,-24
-41.99444,-20.68159,53,34,5,-19
-41.99421,-20.68159,54,34,5,-20
-41.99399,-20.68159,62,38,5,-24
-41.99354,-20.68159,64,43,0,-21
-41.99331,-20.68159,67,44,11,-23
-41.99309,-20.68159,67,44,0,-23
-41.99286,-20.68159,62,44,0,-18
-41.99241,-20.68159,62,43,0,-19
-41.99219,-20.68159,51,43,0,-8
-41.99196,-20.68159,51,43,0,-8
-41.99174,-20.68159,50,43,0,-7
-41.99129,-20.68159,49,42,0,-7
-41.99107,-20.68159,48,42,0,-6
-41.99084,-20.68159,47,38,0,-9
-41.99062,-20.68159,46,39,0,-7
-41.99017,-20.68159,44,42,0,-2
-41.98994,-20.68159,53,42,0,-11
-41.98972,-20.68159,62,41,0,-21
-41.98949,-20.68159,68,41,0,-27
-41.98927,-20.68159,69,40,0,-29
-41.98882,-20.68159,69,40,0,-29
-41.98859,-20.68159,69,36,0,-33
-41.98837,-20.68159,69,35,0,-34
-41.98814,-20.68159,67,36,0,-31
-41.98769,-20.68159,66,37,0,-29
-41.98747,-20.68159,66,38,0,-28
-41.98725,-20.68159,65,38,0,-27
-41.98702,-20.68159,63,38,0,-25
-41.98657,-20.68159,62,40,0,-22
-41.98635,-20.68159,59,40,0,-19
-41.98612,-20.68159,54,40,0,-14
-41.9859,-20.68159,49,41,0,-8
-41.98545,-20.68159,45,41,0,-4
-41.98522,-20.68159,45,41,0,-4
-41.985,-20.68159,45,41,0,-4
-41.98477,-20.68159,45,41,0,-4
-41.98455,-20.68159,45,41,0,-4
-41.9841,-20.68159,45,41,0,-4
-41.98387,-20.68159,45,41,0,-4
-41.98365,-20.68159,45,41,0,-4
-41.98343,-20.68159,45,41,0,-4
-41.98298,-20.68159,45,41,0,-4
-41.98275,-20.68159,45,41,0,-4
-41.98253,-20.68159,59,41,0,-18
-41.9823,-20.68159,59,41,0,-18
-41.98185,-20.68159,55,41,0,-14
-41.98163,-20.68159,61,41,0,-20
-41.9814,-20.68159,61,41,0,-20
-41.98118,-20.68159,64,42,0,-22
-41.98073,-20.68159,66,42,0,-24
-41.9805,-20.68159,66,42,0,-24
-41.98028,-20.68159,64,42,0,-22
-41.98005,-20.68159,64,42,0,-22
-41.97983,-20.68159,66,42,0,-24
-41.97938,-20.68159,67,42,0,-25
-41.97916,-20.68159,68,42,5,-26
-41.97893,-20.68159,68,42,5,-26
-41.97871,-20.68159,68,31,5,-37
-41.97826,-20.68159,67,33,5,-34
-41.97803,-20.68159,67,33,5,-34
-41.97781,-20.68159,67,33,5,-34
-41.97758,-20.68159,67,27,5,-40
-41.97713,-20.68159,67,28,5,-39
-41.97691,-20.68159,66,28,5,-38
-41.97668,-20.68159,64,27,5,-37
-41.97646,-20.68159,64,27,5,-37
-41.97601,-20.68159,64,27,5,-37
-41.97578,-20.68159,63,28,5,-35
-41.97556,-20.68159,69,28,5,-41
-41.97534,-20.68159,67,28,5,-39
-41.97511,-20.68159,68,28,5,-40
-41.97466,-20.68159,72,31,5,-41
-41.97444,-20.68159,69,34,5,-35
-41.97421,-20.68159,65,34,5,-31
-41.97399,-20.68159,64,32,0,-32
-41.97354,-20.68159,64,29,5,-35
-41.97331,-20.68159,64,26,5,-38
-41.97309,-20.68159,64,26,5,-38
-41.97286,-20.68159,64,26,5,-38
-41.97241,-20.68159,63,26,5,-37
-41.97219,-20.68159,63,26,5,-37
-41.97196,-20.68159,62,26,5,-36
-41.97174,-20.68159,62,26,5,-36
-41.97129,-20.68159,62,26,5,-36
-41.97107,-20.68159,65,26,5,-39
-41.97084,-20.68159,66,25,5,-41
-41.97062,-20.68159,65,26,5,-39
-41.97017,-20.68159,64,28,0,-36
-41.96994,-20.68159,64,30,0,-34
-41.96972,-20.68159,63,31,0,-32
-41.96949,-20.68159,63,32,0,-31
-41.96927,-20.68159,63,35,0,-28
-42.1005,-20.68138,66,29,5,-37
-42.0978,-20.68138,68,29,5,-39
-42.09511,-20.68138,67,30,5,-37
-42.09219,-20.68138,67,34,5,-33
-42.08949,-20.68138,62,32,5,-30
-42.08657,-20.68138,64,37,5,-27
-42.08387,-20.68138,67,37,5,-30
-42.08118,-20.68138,64,39,5,-25
-42.07825,-20.68138,60,36,5,-24
-42.07556,-20.68138,60,33,5,-27
-42.07286,-20.68138,60,43,5,-17
-42.06994,-20.68138,67,44,0,-23
-42.06724,-20.68138,67,44,0,-23
-42.06455,-20.68138,60,35,5,-25
-42.06163,-20.68138,63,43,5,-20
-42.05893,-20.68138,68,34,5,-34
-42.05601,-20.68138,64,35,5,-29
-42.05331,-20.68138,55,33,0,-22
-42.05061,-20.68138,70,36,0,-34
-42.04769,-20.68138,65,39,0,-26
-42.045,-20.68138,70,33,5,-37
-42.0423,-20.68138,64,42,0,-22
-42.03938,-20.68138,58,37,0,-21
-42.03668,-20.68138,65,41,5,-24
-42.03399,-20.68138,61,34,5,-27
-42.03106,-20.68138,61,36,0,-25
-42.02837,-20.68138,60,34,0,-26
-42.02545,-20.68138,62,32,5,-30
-42.02275,-20.68138,63,43,0,-20
-42.02005,-20.68138,61,32,5,-29
-42.01713,-20.68138,57,31,0,-26
-42.01444,-20.68138,58,27,0,-31
-42.01174,-20.68138,58,32,5,-26
-42.00882,-20.68138,65,36,5,-29
-42.00612,-20.68138,58,35,0,-23
-42.00342,-20.68138,56,35,5,-21
-42.0005,-20.68138,59,38,5,-21
-41.99781,-20.68138,64,32,5,-32
-41.99511,-20.68138,62,36,5,-26
-41.99219,-20.68138,57,43,0,-14
-41.98949,-20.68138,66,41,0,-25
-41.98657,-20.68138,61,40,0,-21
-41.98387,-20.68138,44,41,0,-3
-41.98118,-20.68138,70,41,0,-29
-41.97826,-20.68138,68,33,5,-35
-41.97556,-20.68138,69,27,5,-42
-41.97286,-20.68138,66,30,5,-36
-41.96994,-20.68138,64,30,0,-34
-42.1005,-20.68117,65,31,5,-34
-42.0978,-20.68117,68,30,5,-38
-42.09511,-20.68117,69,30,5,-39
-42.09219,-20.68117,68,32,5,-36
-42.08949,-20.68117,62,33,5,-29
-42.08657,-20.68117,64,35,5,-29
-42.08387,-20.68117,68,35,5,-33
-42.08118,-20.68117,63,39,5,-24
-42.07825,-20.68117,60,35,5,-25
-42.07556,-20.68117,60,33,5,-27
-42.07286,-20.68117,60,36,5,-24
-42.06994,-20.68117,62,44,0,-18
-42.06724,-20.68117,67,44,0,-23
-42.06455,-20.68117,60,35,5,-25
-42.06163,-20.68117,62,40,5,-22
-42.05893,-20.68117,68,34,5,-34
-42.05601,-20.68117,67,37,0,-30
-42.05331,-20.68117,55,33,0,-22
-42.05061,-20.68117,70,36,0,-34
-42.04769,-20.68117,66,39,0,-27
-42.045,-20.68117,70,33,5,-37
-42.0423,-20.68117,63,42,0,-21
-42.03938,-20.68117,58,38,0,-20
-42.03668,-20.68117,65,41,5,-24
-42.03399,-20.68117,61,32,5,-29
-42.03106,-20.68117,61,36,0,-25
-42.02837,-20.68117,60,34,5,-26
-42.02545,-20.68117,62,34,5,-28
-42.02275,-20.68117,63,43,0,-20
-42.02005,-20.68117,61,39,5,-22
-42.01713,-20.68117,57,30,0,-27
-42.01444,-20.68117,58,28,0,-30
-42.01174,-20.68117,58,32,5,-26
-42.00882,-20.68117,63,39,0,-24
-42.00612,-20.68117,57,35,0,-22
-42.00342,-20.68117,55,35,5,-20
-42.0005,-20.68117,54,35,5,-19
-41.99781,-20.68117,63,33,5,-30
-41.99511,-20.68117,62,38,5,-24
-41.99219,-20.68117,57,43,0,-14
-41.98949,-20.68117,70,41,0,-29
-41.98657,-20.68117,62,40,0,-22
-41.98387,-20.68117,54,41,0,-13
-41.98118,-20.68117,71,41,0,-30
-41.97826,-20.68117,68,33,5,-35
-41.97556,-20.68117,71,30,5,-41
-41.97286,-20.68117,64,30,0,-34
-41.96994,-20.68117,63,30,0,-33
-42.1005,-20.68075,64,34,5,-30
-42.0978,-20.68075,68,30,5,-38
-42.09511,-20.68075,68,30,5,-38
-42.09219,-20.68075,67,35,5,-32
-42.08949,-20.68075,62,34,5,-28
-42.08657,-20.68075,63,35,5,-28
-42.08387,-20.68075,67,34,5,-33
-42.08118,-20.68075,68,35,5,-33
-42.07825,-20.68075,60,33,5,-27
-42.07556,-20.68075,60,31,5,-29
-42.07286,-20.68075,60,35,5,-25
-42.06994,-20.68075,61,45,0,-16
-42.06724,-20.68075,67,44,0,-23
-42.06455,-20.68075,60,34,5,-26
-42.06163,-20.68075,62,42,11,-20
-42.05893,-20.68075,68,36,5,-32
-42.05601,-20.68075,66,38,0,-28
-42.05331,-20.68075,54,35,0,-19
-42.05061,-20.68075,70,36,0,-34
-42.04769,-20.68075,67,39,5,-28
-42.045,-20.68075,71,34,5,-37
-42.0423,-20.68075,61,42,5,-19
-42.03938,-20.68075,58,39,0,-19
-42.03668,-20.68075,63,42,5,-21
-42.03399,-20.68075,70,31,5,-39
-42.03106,-20.68075,61,37,0,-24
-42.02837,-20.68075,60,31,5,-29
-42.02545,-20.68075,62,38,5,-24
-42.02275,-20.68075,62,44,0,-18
-42.02005,-20.68075,59,40,11,-19
-42.01713,-20.68075,57,30,0,-27
-42.01444,-20.68075,57,29,0,-28
-42.01174,-20.68075,57,32,5,-25
-42.00882,-20.68075,60,39,0,-21
-42.00612,-20.68075,55,36,0,-19
-42.00342,-20.68075,55,35,5,-20
-42.0005,-20.68075,54,36,5,-18
-41.99781,-20.68075,63,33,5,-30
-41.99511,-20.68075,57,38,5,-19
-41.99219,-20.68075,52,43,0,-9
-41.98949,-20.68075,68,39,0,-29
-41.98657,-20.68075,62,41,0,-21
-41.98387,-20.68075,58,41,0,-17
-41.98118,-20.68075,69,41,0,-28
-41.97826,-20.68075,67,29,5,-38
-41.97556,-20.68075,69,29,5,-40
-41.97286,-20.68075,64,30,0,-34
-41.96994,-20.68075,61,31,0,-30
-42.1005,-20.68054,64,34,5,-30
-42.0978,-20.68054,68,30,5,-38
-42.09511,-20.68054,70,30,5,-40
-42.09219,-20.68054,66,34,5,-32
-42.08949,-20.68054,64,34,5,-30
-42.08657,-20.68054,63,34,5,-29
-42.08387,-20.68054,67,34,5,-33
-42.08118,-20.68054,65,35,5,-30
-42.07825,-20.68054,60,34,5,-26
-42.07556,-20.68054,60,31,5,-29
-42.07286,-20.68054,60,35,5,-25
-42.06994,-20.68054,61,45,0,-16
-42.06724,-20.68054,67,44,0,-23
-42.06455,-20.68054,60,35,5,-25
-42.06163,-20.68054,62,42,11,-20
-42.05893,-20.68054,68,36,5,-32
-42.05601,-20.68054,67,38,0,-29
-42.05331,-20.68054,54,36,0,-18
-42.05061,-20.68054,62,36,0,-26
-42.04769,-20.68054,68,39,5,-29
-42.045,-20.68054,71,34,5,-37
-42.0423,-20.68054,60,35,5,-25
-42.03938,-20.68054,58,40,0,-18
-42.03668,-20.68054,63,42,5,-21
-42.03399,-20.68054,70,33,5,-37
-42.03106,-20.68054,61,36,0,-25
-42.02837,-20.68054,60,34,5,-26
-42.02545,-20.68054,62,38,5,-24
-42.02275,-20.68054,61,44,0,-17
-42.02005,-20.68054,59,40,11,-19
-42.01713,-20.68054,57,29,0,-28
-42.01444,-20.68054,57,30,0,-27
-42.01174,-20.68054,57,32,5,-25
-42.00882,-20.68054,58,40,0,-18
-42.00612,-20.68054,54,36,5,-18
-42.00342,-20.68054,55,37,5,-18
-42.0005,-20.68054,54,46,5,-8
-41.99781,-20.68054,62,33,5,-29
-41.99511,-20.68054,58,32,5,-26
-41.99219,-20.68054,52,43,0,-9
-41.98949,-20.68054,69,34,0,-35
-41.98657,-20.68054,62,41,0,-21
-41.98387,-20.68054,60,41,0,-19
-41.98118,-20.68054,68,41,0,-27
-41.97826,-20.68054,67,29,5,-38
-41.97556,-20.68054,70,30,0,-40
-41.97286,-20.68054,64,31,0,-33
-41.96994,-20.68054,61,31,0,-30
-42.1005,-20.68032,64,32,5,-32
-42.0978,-20.68032,67,30,5,-37
-42.09511,-20.68032,73,30,5,-43
-42.09219,-20.68032,66,35,5,-31
-42.08949,-20.68032,68,32,5,-36
-42.08657,-20.68032,63,35,5,-28
-42.08387,-20.68032,68,34,5,-34
-42.08118,-20.68032,63,37,5,-26
-42.07825,-20.68032,60,34,0,-26
-42.07556,-20.68032,66,34,5,-32
-42.07286,-20.68032,60,35,5,-25
-42.06994,-20.68032,61,45,0,-16
-42.06724,-20.68032,66,44,0,-22
-42.06455,-20.68032,67,35,5,-32
-42.06163,-20.68032,62,42,5,-20
-42.05893,-20.68032,68,33,5,-35
-42.05601,-20.68032,65,38,0,-27
-42.05331,-20.68032,59,36,0,-23
-42.05061,-20.68032,58,36,0,-22
-42.04769,-20.68032,68,39,5,-29
-42.045,-20.68032,70,33,5,-37
-42.0423,-20.68032,60,37,5,-23
-42.03938,-20.68032,58,41,0,-17
-42.03668,-20.68032,63,42,0,-21
-42.03399,-20.68032,72,33,5,-39
-42.03106,-20.68032,61,37,0,-24
-42.02837,-20.68032,60,32,5,-28
-42.02545,-20.68032,62,38,5,-24
-42.02275,-20.68032,60,45,0,-15
-42.02005,-20.68032,59,38,11,-21
-42.01713,-20.68032,57,29,0,-28
-42.01444,-20.68032,56,31,0,-25
-42.01174,-20.68032,56,34,5,-22
-42.00882,-20.68032,57,40,0,-17
-42.00612,-20.68032,53,36,5,-17
-42.00342,-20.68032,54,36,5,-18
-42.0005,-20.68032,54,38,5,-16
-41.99781,-20.68032,60,32,5,-28
-41.99511,-20.68032,63,32,5,-31
-41.99219,-20.68032,52,43,0,-9
-41.98949,-20.68032,70,34,0,-36
-41.98657,-20.68032,62,41,0,-21
-41.98387,-20.68032,64,41,0,-23
-41.98118,-20.68032,71,41,0,-30
-41.97826,-20.68032,68,29,5,-39
-41.97556,-20.68032,71,30,0,-41
-41.97286,-20.68032,64,31,0,-33
-41.96994,-20.68032,61,31,0,-30
